video;face_name;start_frame;end_frame;total_frame;start_time;end_time;duration
/net/per920a/export/das14a/satoh-lab/haolin/nhk/excerpts/2001_06_30_19_00_1.webm;Yukio HATOYAMA.jpg;3109;4137;4557;103;137;34
/net/per920a/export/das14a/satoh-lab/haolin/nhk/excerpts/2001_06_30_19_00_1.webm;Yukio HATOYAMA.jpg;4153;4553;4557;138;151;13
/net/per920a/export/das14a/satoh-lab/haolin/nhk/excerpts/2001_08_23_19_00_1.webm;Junichiro KOIZUMI.jpg;9;609;2825;0;20;20
/net/per920a/export/das14a/satoh-lab/haolin/nhk/excerpts/2001_08_23_19_00_1.webm;Junichiro KOIZUMI.jpg;685;705;2825;22;23;1
/net/per920a/export/das14a/satoh-lab/haolin/nhk/excerpts/2001_08_23_19_00_1.webm;Junichiro KOIZUMI.jpg;721;1317;2825;23;43;20
/net/per920a/export/das14a/satoh-lab/haolin/nhk/excerpts/2001_08_23_19_00_1.webm;Junichiro KOIZUMI.jpg;1333;1737;2825;44;57;13
/net/per920a/export/das14a/satoh-lab/haolin/nhk/excerpts/2001_08_23_19_00_1.webm;Junichiro KOIZUMI.jpg;1753;2237;2825;58;74;16
/net/per920a/export/das14a/satoh-lab/haolin/nhk/excerpts/2001_08_23_19_00_1.webm;Junichiro KOIZUMI.jpg;2253;2529;2825;74;84;10
/net/per920a/export/das14a/satoh-lab/haolin/nhk/excerpts/2001_08_23_19_00_1.webm;Junichiro KOIZUMI.jpg;2545;2821;2825;84;93;9
/net/per920a/export/das14a/satoh-lab/haolin/nhk/excerpts/2001_09_19_19_00_1.webm;Junichiro KOIZUMI.jpg;337;873;34053;11;29;18
/net/per920a/export/das14a/satoh-lab/haolin/nhk/excerpts/2001_09_19_19_00_1.webm;Junichiro KOIZUMI.jpg;1693;1745;34053;56;58;2
/net/per920a/export/das14a/satoh-lab/haolin/nhk/excerpts/2001_09_19_19_00_1.webm;Junichiro KOIZUMI.jpg;2045;2117;34053;68;70;2
/net/per920a/export/das14a/satoh-lab/haolin/nhk/excerpts/2001_09_19_19_00_1.webm;Junichiro KOIZUMI.jpg;2773;2889;34053;92;96;4
/net/per920a/export/das14a/satoh-lab/haolin/nhk/excerpts/2001_09_19_19_00_1.webm;Junichiro KOIZUMI.jpg;5589;6409;34053;186;213;27
/net/per920a/export/das14a/satoh-lab/haolin/nhk/excerpts/2001_09_19_19_00_1.webm;Junichiro KOIZUMI.jpg;6429;6441;34053;214;214;0
/net/per920a/export/das14a/satoh-lab/haolin/nhk/excerpts/2001_09_19_19_00_1.webm;Junichiro KOIZUMI.jpg;6473;6473;34053;215;215;0
/net/per920a/export/das14a/satoh-lab/haolin/nhk/excerpts/2001_09_19_19_00_1.webm;Junichiro KOIZUMI.jpg;6509;6609;34053;217;220;3
/net/per920a/export/das14a/satoh-lab/haolin/nhk/excerpts/2001_09_19_19_00_1.webm;Junichiro KOIZUMI.jpg;6621;6621;34053;220;220;0
/net/per920a/export/das14a/satoh-lab/haolin/nhk/excerpts/2001_09_19_19_00_1.webm;Junichiro KOIZUMI.jpg;6641;6641;34053;221;221;0
/net/per920a/export/das14a/satoh-lab/haolin/nhk/excerpts/2001_09_19_19_00_1.webm;Junichiro KOIZUMI.jpg;8357;8457;34053;278;282;4
/net/per920a/export/das14a/satoh-lab/haolin/nhk/excerpts/2001_09_19_19_00_1.webm;Junichiro KOIZUMI.jpg;8569;8633;34053;285;287;2
/net/per920a/export/das14a/satoh-lab/haolin/nhk/excerpts/2001_09_19_19_00_1.webm;Junichiro KOIZUMI.jpg;8649;8701;34053;288;290;2
/net/per920a/export/das14a/satoh-lab/haolin/nhk/excerpts/2001_09_19_19_00_1.webm;Junichiro KOIZUMI.jpg;8717;8725;34053;290;291;1
/net/per920a/export/das14a/satoh-lab/haolin/nhk/excerpts/2001_09_19_19_00_1.webm;Junichiro KOIZUMI.jpg;8753;8769;34053;291;292;1
/net/per920a/export/das14a/satoh-lab/haolin/nhk/excerpts/2001_09_19_19_00_1.webm;Junichiro KOIZUMI.jpg;8805;8865;34053;293;295;2
/net/per920a/export/das14a/satoh-lab/haolin/nhk/excerpts/2001_09_19_19_00_1.webm;Junichiro KOIZUMI.jpg;8893;8901;34053;296;296;0
/net/per920a/export/das14a/satoh-lab/haolin/nhk/excerpts/2001_09_19_19_00_1.webm;Junichiro KOIZUMI.jpg;8917;8921;34053;297;297;0
/net/per920a/export/das14a/satoh-lab/haolin/nhk/excerpts/2001_09_19_19_00_1.webm;Junichiro KOIZUMI.jpg;8937;8957;34053;298;298;0
/net/per920a/export/das14a/satoh-lab/haolin/nhk/excerpts/2001_09_19_19_00_1.webm;Junichiro KOIZUMI.jpg;8969;8969;34053;299;299;0
/net/per920a/export/das14a/satoh-lab/haolin/nhk/excerpts/2001_09_19_19_00_1.webm;Junichiro KOIZUMI.jpg;8981;9205;34053;299;307;8
/net/per920a/export/das14a/satoh-lab/haolin/nhk/excerpts/2001_09_19_19_00_1.webm;Junichiro KOIZUMI.jpg;9221;9221;34053;307;307;0
/net/per920a/export/das14a/satoh-lab/haolin/nhk/excerpts/2001_09_19_19_00_1.webm;Junichiro KOIZUMI.jpg;9269;9273;34053;309;309;0
/net/per920a/export/das14a/satoh-lab/haolin/nhk/excerpts/2001_09_19_19_00_1.webm;Takenori KANZAKI.jpg;1305;1313;34053;43;43;0
/net/per920a/export/das14a/satoh-lab/haolin/nhk/excerpts/2001_09_19_19_00_1.webm;Takenori KANZAKI.jpg;1325;1341;34053;44;44;0
/net/per920a/export/das14a/satoh-lab/haolin/nhk/excerpts/2001_09_19_19_00_1.webm;Takenori KANZAKI.jpg;1357;1373;34053;45;45;0
/net/per920a/export/das14a/satoh-lab/haolin/nhk/excerpts/2001_09_19_19_00_1.webm;Takenori KANZAKI.jpg;1913;1969;34053;63;65;2
/net/per920a/export/das14a/satoh-lab/haolin/nhk/excerpts/2001_10_13_19_00_3.webm;Yukio HATOYAMA.jpg;16253;16289;16669;542;543;1
/net/per920a/export/das14a/satoh-lab/haolin/nhk/excerpts/2001_10_13_19_00_3.webm;Yukio HATOYAMA.jpg;16305;16305;16669;543;543;0
/net/per920a/export/das14a/satoh-lab/haolin/nhk/excerpts/2001_10_13_19_00_3.webm;Yukio HATOYAMA.jpg;16321;16561;16669;544;552;8
/net/per920a/export/das14a/satoh-lab/haolin/nhk/excerpts/2001_10_13_19_00_3.webm;Yukio HATOYAMA.jpg;16645;16665;16669;555;555;0
/net/per920a/export/das14a/satoh-lab/haolin/nhk/excerpts/2001_10_20_19_00_3.webm;Junichiro KOIZUMI.jpg;7589;7589;17357;253;253;0
/net/per920a/export/das14a/satoh-lab/haolin/nhk/excerpts/2001_10_20_19_00_3.webm;Junichiro KOIZUMI.jpg;7673;7697;17357;255;256;1
/net/per920a/export/das14a/satoh-lab/haolin/nhk/excerpts/2001_10_20_19_00_3.webm;Junichiro KOIZUMI.jpg;10301;10305;17357;343;343;0
/net/per920a/export/das14a/satoh-lab/haolin/nhk/excerpts/2001_10_20_19_00_3.webm;Junichiro KOIZUMI.jpg;10321;10457;17357;344;348;4
/net/per920a/export/das14a/satoh-lab/haolin/nhk/excerpts/2001_10_20_19_00_3.webm;Junichiro KOIZUMI.jpg;11129;11417;17357;371;380;9
/net/per920a/export/das14a/satoh-lab/haolin/nhk/excerpts/2001_10_20_19_00_3.webm;Junichiro KOIZUMI.jpg;11433;11657;17357;381;388;7
/net/per920a/export/das14a/satoh-lab/haolin/nhk/excerpts/2001_10_20_19_00_3.webm;Junichiro KOIZUMI.jpg;11673;11713;17357;389;390;1
/net/per920a/export/das14a/satoh-lab/haolin/nhk/excerpts/2001_10_20_19_00_3.webm;Junichiro KOIZUMI.jpg;11729;11985;17357;391;399;8
/net/per920a/export/das14a/satoh-lab/haolin/nhk/excerpts/2001_10_20_19_00_3.webm;Junichiro KOIZUMI.jpg;12353;12369;17357;412;412;0
/net/per920a/export/das14a/satoh-lab/haolin/nhk/excerpts/2001_10_20_19_00_3.webm;Junichiro KOIZUMI.jpg;12385;12397;17357;413;413;0
/net/per920a/export/das14a/satoh-lab/haolin/nhk/excerpts/2001_10_20_19_00_3.webm;Junichiro KOIZUMI.jpg;12413;12425;17357;414;414;0
/net/per920a/export/das14a/satoh-lab/haolin/nhk/excerpts/2001_10_20_19_00_3.webm;Junichiro KOIZUMI.jpg;12441;12441;17357;415;415;0
/net/per920a/export/das14a/satoh-lab/haolin/nhk/excerpts/2001_10_20_19_00_3.webm;Junichiro KOIZUMI.jpg;12461;12481;17357;415;416;1
/net/per920a/export/das14a/satoh-lab/haolin/nhk/excerpts/2001_10_20_19_00_3.webm;Junichiro KOIZUMI.jpg;12521;12533;17357;417;418;1
/net/per920a/export/das14a/satoh-lab/haolin/nhk/excerpts/2001_10_20_19_00_3.webm;Junichiro KOIZUMI.jpg;12545;12545;17357;418;418;0
/net/per920a/export/das14a/satoh-lab/haolin/nhk/excerpts/2001_10_20_19_00_3.webm;Junichiro KOIZUMI.jpg;12565;12577;17357;419;419;0
/net/per920a/export/das14a/satoh-lab/haolin/nhk/excerpts/2001_10_20_19_00_3.webm;Junichiro KOIZUMI.jpg;12597;12621;17357;420;421;1
/net/per920a/export/das14a/satoh-lab/haolin/nhk/excerpts/2001_10_20_19_00_3.webm;Junichiro KOIZUMI.jpg;15533;15533;17357;518;518;0
/net/per920a/export/das14a/satoh-lab/haolin/nhk/excerpts/2001_10_20_19_00_3.webm;Junichiro KOIZUMI.jpg;15545;15549;17357;518;518;0
/net/per920a/export/das14a/satoh-lab/haolin/nhk/excerpts/2001_10_20_19_00_3.webm;Junichiro KOIZUMI.jpg;15569;15617;17357;519;520;1
/net/per920a/export/das14a/satoh-lab/haolin/nhk/excerpts/2001_10_20_19_00_3.webm;Junichiro KOIZUMI.jpg;15641;15693;17357;521;523;2
/net/per920a/export/das14a/satoh-lab/haolin/nhk/excerpts/2001_10_31_19_00_1.webm;Junichiro KOIZUMI.jpg;42729;42729;50421;1425;1425;0
/net/per920a/export/das14a/satoh-lab/haolin/nhk/excerpts/2001_10_31_19_00_1.webm;Junichiro KOIZUMI.jpg;42825;42825;50421;1428;1428;0
/net/per920a/export/das14a/satoh-lab/haolin/nhk/excerpts/2001_10_31_19_00_1.webm;Junichiro KOIZUMI.jpg;42857;42881;50421;1429;1430;1
/net/per920a/export/das14a/satoh-lab/haolin/nhk/excerpts/2001_10_31_19_00_1.webm;Junichiro KOIZUMI.jpg;42893;42897;50421;1430;1431;1
/net/per920a/export/das14a/satoh-lab/haolin/nhk/excerpts/2001_10_31_19_00_1.webm;Junichiro KOIZUMI.jpg;42929;42941;50421;1432;1432;0
/net/per920a/export/das14a/satoh-lab/haolin/nhk/excerpts/2001_10_31_19_00_1.webm;Junichiro KOIZUMI.jpg;42953;42961;50421;1432;1433;1
/net/per920a/export/das14a/satoh-lab/haolin/nhk/excerpts/2001_10_31_19_00_1.webm;Junichiro KOIZUMI.jpg;42977;42981;50421;1433;1433;0
/net/per920a/export/das14a/satoh-lab/haolin/nhk/excerpts/2001_10_31_19_00_1.webm;Junichiro KOIZUMI.jpg;42993;42997;50421;1434;1434;0
/net/per920a/export/das14a/satoh-lab/haolin/nhk/excerpts/2001_10_31_19_00_1.webm;Junichiro KOIZUMI.jpg;45729;45805;50421;1525;1528;3
/net/per920a/export/das14a/satoh-lab/haolin/nhk/excerpts/2001_10_31_19_00_1.webm;Junichiro KOIZUMI.jpg;49677;49685;50421;1657;1657;0
/net/per920a/export/das14a/satoh-lab/haolin/nhk/excerpts/2001_10_31_19_00_1.webm;Takenori KANZAKI.jpg;43085;43597;50421;1437;1454;17
/net/per920a/export/das14a/satoh-lab/haolin/nhk/excerpts/2001_10_31_19_00_1.webm;Takenori KANZAKI.jpg;43685;43929;50421;1457;1465;8
/net/per920a/export/das14a/satoh-lab/haolin/nhk/excerpts/2001_10_31_19_00_1.webm;Takenori KANZAKI.jpg;45821;45881;50421;1528;1530;2
/net/per920a/export/das14a/satoh-lab/haolin/nhk/excerpts/2001_11_22_19_00_1.webm;Junichiro KOIZUMI.jpg;3617;3625;7497;120;120;0
/net/per920a/export/das14a/satoh-lab/haolin/nhk/excerpts/2001_11_22_19_00_1.webm;Junichiro KOIZUMI.jpg;3649;3705;7497;121;123;2
/net/per920a/export/das14a/satoh-lab/haolin/nhk/excerpts/2001_11_22_19_00_1.webm;Junichiro KOIZUMI.jpg;3725;3733;7497;124;124;0
/net/per920a/export/das14a/satoh-lab/haolin/nhk/excerpts/2001_11_22_19_00_1.webm;Junichiro KOIZUMI.jpg;3753;3773;7497;125;125;0
/net/per920a/export/das14a/satoh-lab/haolin/nhk/excerpts/2001_11_22_19_00_1.webm;Junichiro KOIZUMI.jpg;3789;3793;7497;126;126;0
/net/per920a/export/das14a/satoh-lab/haolin/nhk/excerpts/2001_11_22_19_00_1.webm;Junichiro KOIZUMI.jpg;5449;5561;7497;181;185;4
/net/per920a/export/das14a/satoh-lab/haolin/nhk/excerpts/2001_11_22_19_00_1.webm;Takenori KANZAKI.jpg;5581;5637;7497;186;187;1
/net/per920a/export/das14a/satoh-lab/haolin/nhk/excerpts/2001_11_22_19_00_1.webm;Yasuo FUKUDA.jpg;5713;5721;7497;190;190;0
/net/per920a/export/das14a/satoh-lab/haolin/nhk/excerpts/2001_12_28_19_00_1.webm;Yukio EDANO.jpg;4073;4893;4897;135;162;27
/net/per920a/export/das14a/satoh-lab/haolin/nhk/excerpts/2002_01_14_19_00_2.webm;Junichiro KOIZUMI.jpg;29;629;11485;0;20;20
/net/per920a/export/das14a/satoh-lab/haolin/nhk/excerpts/2002_01_14_19_00_2.webm;Junichiro KOIZUMI.jpg;721;1137;11485;24;37;13
/net/per920a/export/das14a/satoh-lab/haolin/nhk/excerpts/2002_01_14_19_00_2.webm;Junichiro KOIZUMI.jpg;1153;1401;11485;38;46;8
/net/per920a/export/das14a/satoh-lab/haolin/nhk/excerpts/2002_01_14_19_00_2.webm;Junichiro KOIZUMI.jpg;1417;1501;11485;47;50;3
/net/per920a/export/das14a/satoh-lab/haolin/nhk/excerpts/2002_01_14_19_00_2.webm;Junichiro KOIZUMI.jpg;1633;1713;11485;54;57;3
/net/per920a/export/das14a/satoh-lab/haolin/nhk/excerpts/2002_01_14_19_00_2.webm;Junichiro KOIZUMI.jpg;1729;2845;11485;57;94;37
/net/per920a/export/das14a/satoh-lab/haolin/nhk/excerpts/2002_01_14_19_00_2.webm;Junichiro KOIZUMI.jpg;2953;3337;11485;98;111;13
/net/per920a/export/das14a/satoh-lab/haolin/nhk/excerpts/2002_01_14_19_00_2.webm;Junichiro KOIZUMI.jpg;3353;3409;11485;111;113;2
/net/per920a/export/das14a/satoh-lab/haolin/nhk/excerpts/2002_01_14_19_00_2.webm;Junichiro KOIZUMI.jpg;3429;3485;11485;114;116;2
/net/per920a/export/das14a/satoh-lab/haolin/nhk/excerpts/2002_01_14_19_00_2.webm;Junichiro KOIZUMI.jpg;3501;4117;11485;116;137;21
/net/per920a/export/das14a/satoh-lab/haolin/nhk/excerpts/2002_01_14_19_00_2.webm;Junichiro KOIZUMI.jpg;4857;5277;11485;161;175;14
/net/per920a/export/das14a/satoh-lab/haolin/nhk/excerpts/2002_01_14_19_00_2.webm;Junichiro KOIZUMI.jpg;5361;5393;11485;178;179;1
/net/per920a/export/das14a/satoh-lab/haolin/nhk/excerpts/2002_01_14_19_00_2.webm;Junichiro KOIZUMI.jpg;5405;5733;11485;180;191;11
/net/per920a/export/das14a/satoh-lab/haolin/nhk/excerpts/2002_01_14_19_00_2.webm;Junichiro KOIZUMI.jpg;5745;5837;11485;191;194;3
/net/per920a/export/das14a/satoh-lab/haolin/nhk/excerpts/2002_01_14_19_00_2.webm;Junichiro KOIZUMI.jpg;7037;7037;11485;234;234;0
/net/per920a/export/das14a/satoh-lab/haolin/nhk/excerpts/2002_01_14_19_00_2.webm;Junichiro KOIZUMI.jpg;7337;7337;11485;244;244;0
/net/per920a/export/das14a/satoh-lab/haolin/nhk/excerpts/2002_01_14_19_00_2.webm;Junichiro KOIZUMI.jpg;7377;7385;11485;246;246;0
/net/per920a/export/das14a/satoh-lab/haolin/nhk/excerpts/2002_01_14_19_00_2.webm;Junichiro KOIZUMI.jpg;7401;7401;11485;246;246;0
/net/per920a/export/das14a/satoh-lab/haolin/nhk/excerpts/2002_01_14_19_00_2.webm;Junichiro KOIZUMI.jpg;7413;7417;11485;247;247;0
/net/per920a/export/das14a/satoh-lab/haolin/nhk/excerpts/2002_01_14_19_00_2.webm;Junichiro KOIZUMI.jpg;7429;7433;11485;247;247;0
/net/per920a/export/das14a/satoh-lab/haolin/nhk/excerpts/2002_01_14_19_00_2.webm;Junichiro KOIZUMI.jpg;10685;10689;11485;356;356;0
/net/per920a/export/das14a/satoh-lab/haolin/nhk/excerpts/2002_01_29_19_00_2.webm;Ichiro OZAWA.jpg;141;157;20061;4;5;1
/net/per920a/export/das14a/satoh-lab/haolin/nhk/excerpts/2002_01_29_19_00_2.webm;Kazuo SHII.jpg;7097;7509;20061;236;250;14
/net/per920a/export/das14a/satoh-lab/haolin/nhk/excerpts/2002_01_29_19_00_2.webm;Kazuo SHII.jpg;7569;7573;20061;252;252;0
/net/per920a/export/das14a/satoh-lab/haolin/nhk/excerpts/2002_01_29_19_00_2.webm;Kazuo SHII.jpg;7697;7697;20061;256;256;0
/net/per920a/export/das14a/satoh-lab/haolin/nhk/excerpts/2002_01_29_19_00_2.webm;Kazuo SHII.jpg;7737;7737;20061;258;258;0
/net/per920a/export/das14a/satoh-lab/haolin/nhk/excerpts/2002_01_29_19_00_2.webm;Kazuo SHII.jpg;7749;7749;20061;258;258;0
/net/per920a/export/das14a/satoh-lab/haolin/nhk/excerpts/2002_01_29_19_00_2.webm;Kazuo SHII.jpg;7761;7773;20061;258;259;1
/net/per920a/export/das14a/satoh-lab/haolin/nhk/excerpts/2002_01_29_19_00_2.webm;Kazuo SHII.jpg;7785;7793;20061;259;259;0
/net/per920a/export/das14a/satoh-lab/haolin/nhk/excerpts/2002_01_29_19_00_2.webm;Kazuo SHII.jpg;7917;7941;20061;264;264;0
/net/per920a/export/das14a/satoh-lab/haolin/nhk/excerpts/2002_01_29_19_00_2.webm;Kazuo SHII.jpg;7961;11773;20061;265;392;127
/net/per920a/export/das14a/satoh-lab/haolin/nhk/excerpts/2002_01_29_19_00_2.webm;Kazuo SHII.jpg;13597;13629;20061;453;454;1
/net/per920a/export/das14a/satoh-lab/haolin/nhk/excerpts/2002_01_29_19_00_2.webm;Kazuo SHII.jpg;13865;13901;20061;462;463;1
/net/per920a/export/das14a/satoh-lab/haolin/nhk/excerpts/2002_01_29_19_00_2.webm;Kazuo SHII.jpg;13913;13917;20061;463;464;1
/net/per920a/export/das14a/satoh-lab/haolin/nhk/excerpts/2002_01_29_19_00_2.webm;Kazuo SHII.jpg;13929;13945;20061;464;465;1
/net/per920a/export/das14a/satoh-lab/haolin/nhk/excerpts/2002_01_29_19_00_2.webm;Kazuo SHII.jpg;13965;13965;20061;465;465;0
/net/per920a/export/das14a/satoh-lab/haolin/nhk/excerpts/2002_01_29_19_00_2.webm;Kazuo SHII.jpg;13977;14505;20061;466;483;17
/net/per920a/export/das14a/satoh-lab/haolin/nhk/excerpts/2002_01_29_19_00_2.webm;Kazuo SHII.jpg;14541;14609;20061;484;487;3
/net/per920a/export/das14a/satoh-lab/haolin/nhk/excerpts/2002_01_29_19_00_2.webm;Kazuo SHII.jpg;15073;15121;20061;502;504;2
/net/per920a/export/das14a/satoh-lab/haolin/nhk/excerpts/2002_01_29_19_00_2.webm;Kazuo SHII.jpg;16249;16317;20061;541;544;3
/net/per920a/export/das14a/satoh-lab/haolin/nhk/excerpts/2002_01_29_19_00_2.webm;Kazuo SHII.jpg;16413;16425;20061;547;547;0
/net/per920a/export/das14a/satoh-lab/haolin/nhk/excerpts/2002_01_29_19_00_2.webm;Kazuo SHII.jpg;16441;16441;20061;548;548;0
/net/per920a/export/das14a/satoh-lab/haolin/nhk/excerpts/2002_01_29_19_00_2.webm;Kazuo SHII.jpg;16453;16477;20061;548;549;1
/net/per920a/export/das14a/satoh-lab/haolin/nhk/excerpts/2002_01_29_19_00_2.webm;Kazuo SHII.jpg;16785;16977;20061;559;566;7
/net/per920a/export/das14a/satoh-lab/haolin/nhk/excerpts/2002_01_29_19_00_2.webm;Kazuo SHII.jpg;17025;17057;20061;567;568;1
/net/per920a/export/das14a/satoh-lab/haolin/nhk/excerpts/2002_01_29_19_00_2.webm;Kazuo SHII.jpg;17069;17073;20061;569;569;0
/net/per920a/export/das14a/satoh-lab/haolin/nhk/excerpts/2002_01_29_19_00_2.webm;Kazuo SHII.jpg;17101;17113;20061;570;570;0
/net/per920a/export/das14a/satoh-lab/haolin/nhk/excerpts/2002_01_29_19_00_2.webm;Kazuo SHII.jpg;17125;17129;20061;571;571;0
/net/per920a/export/das14a/satoh-lab/haolin/nhk/excerpts/2002_01_29_19_00_2.webm;Kazuo SHII.jpg;18521;18533;20061;617;618;1
/net/per920a/export/das14a/satoh-lab/haolin/nhk/excerpts/2002_01_29_19_00_2.webm;Kazuo SHII.jpg;18549;18549;20061;618;618;0
/net/per920a/export/das14a/satoh-lab/haolin/nhk/excerpts/2002_01_29_19_00_2.webm;Kazuo SHII.jpg;18561;18649;20061;618;621;3
/net/per920a/export/das14a/satoh-lab/haolin/nhk/excerpts/2002_01_29_19_00_2.webm;Yasuo FUKUDA.jpg;12013;12193;20061;400;406;6
/net/per920a/export/das14a/satoh-lab/haolin/nhk/excerpts/2002_01_29_19_00_2.webm;Yasuo FUKUDA.jpg;12209;12241;20061;407;408;1
/net/per920a/export/das14a/satoh-lab/haolin/nhk/excerpts/2002_01_29_19_00_2.webm;Yasuo FUKUDA.jpg;12257;12781;20061;408;426;18
/net/per920a/export/das14a/satoh-lab/haolin/nhk/excerpts/2002_01_29_19_00_2.webm;Yukio HATOYAMA.jpg;19085;20057;20061;636;668;32
/net/per920a/export/das14a/satoh-lab/haolin/nhk/excerpts/2002_02_04_19_00_1.webm;Junichiro KOIZUMI.jpg;9;33;2941;0;1;1
/net/per920a/export/das14a/satoh-lab/haolin/nhk/excerpts/2002_02_04_19_00_1.webm;Junichiro KOIZUMI.jpg;49;89;2941;1;2;1
/net/per920a/export/das14a/satoh-lab/haolin/nhk/excerpts/2002_02_04_19_00_1.webm;Junichiro KOIZUMI.jpg;101;105;2941;3;3;0
/net/per920a/export/das14a/satoh-lab/haolin/nhk/excerpts/2002_02_04_19_00_1.webm;Junichiro KOIZUMI.jpg;117;193;2941;3;6;3
/net/per920a/export/das14a/satoh-lab/haolin/nhk/excerpts/2002_02_04_19_00_1.webm;Junichiro KOIZUMI.jpg;209;261;2941;6;8;2
/net/per920a/export/das14a/satoh-lab/haolin/nhk/excerpts/2002_02_04_19_00_1.webm;Junichiro KOIZUMI.jpg;273;273;2941;9;9;0
/net/per920a/export/das14a/satoh-lab/haolin/nhk/excerpts/2002_02_04_19_00_1.webm;Junichiro KOIZUMI.jpg;285;289;2941;9;9;0
/net/per920a/export/das14a/satoh-lab/haolin/nhk/excerpts/2002_02_04_19_00_1.webm;Junichiro KOIZUMI.jpg;305;345;2941;10;11;1
/net/per920a/export/das14a/satoh-lab/haolin/nhk/excerpts/2002_02_04_19_00_1.webm;Junichiro KOIZUMI.jpg;421;473;2941;14;15;1
/net/per920a/export/das14a/satoh-lab/haolin/nhk/excerpts/2002_02_04_19_00_1.webm;Junichiro KOIZUMI.jpg;533;541;2941;17;18;1
/net/per920a/export/das14a/satoh-lab/haolin/nhk/excerpts/2002_02_04_19_00_1.webm;Junichiro KOIZUMI.jpg;557;993;2941;18;33;15
/net/per920a/export/das14a/satoh-lab/haolin/nhk/excerpts/2002_02_04_19_00_1.webm;Junichiro KOIZUMI.jpg;1009;1209;2941;33;40;7
/net/per920a/export/das14a/satoh-lab/haolin/nhk/excerpts/2002_02_04_19_00_1.webm;Junichiro KOIZUMI.jpg;1317;1325;2941;43;44;1
/net/per920a/export/das14a/satoh-lab/haolin/nhk/excerpts/2002_02_04_19_00_1.webm;Junichiro KOIZUMI.jpg;1337;1341;2941;44;44;0
/net/per920a/export/das14a/satoh-lab/haolin/nhk/excerpts/2002_02_04_19_00_1.webm;Junichiro KOIZUMI.jpg;1365;1365;2941;45;45;0
/net/per920a/export/das14a/satoh-lab/haolin/nhk/excerpts/2002_02_04_19_00_1.webm;Junichiro KOIZUMI.jpg;1381;1385;2941;46;46;0
/net/per920a/export/das14a/satoh-lab/haolin/nhk/excerpts/2002_02_04_19_00_1.webm;Junichiro KOIZUMI.jpg;1397;1397;2941;46;46;0
/net/per920a/export/das14a/satoh-lab/haolin/nhk/excerpts/2002_02_04_19_00_1.webm;Junichiro KOIZUMI.jpg;1409;1417;2941;46;47;1
/net/per920a/export/das14a/satoh-lab/haolin/nhk/excerpts/2002_02_04_19_00_1.webm;Junichiro KOIZUMI.jpg;1441;1461;2941;48;48;0
/net/per920a/export/das14a/satoh-lab/haolin/nhk/excerpts/2002_02_04_19_00_1.webm;Junichiro KOIZUMI.jpg;1473;1477;2941;49;49;0
/net/per920a/export/das14a/satoh-lab/haolin/nhk/excerpts/2002_02_04_19_00_1.webm;Junichiro KOIZUMI.jpg;1489;1497;2941;49;49;0
/net/per920a/export/das14a/satoh-lab/haolin/nhk/excerpts/2002_02_04_19_00_1.webm;Junichiro KOIZUMI.jpg;1509;1509;2941;50;50;0
/net/per920a/export/das14a/satoh-lab/haolin/nhk/excerpts/2002_02_04_19_00_1.webm;Junichiro KOIZUMI.jpg;1857;2633;2941;61;87;26
/net/per920a/export/das14a/satoh-lab/haolin/nhk/excerpts/2002_02_13_19_00_2.webm;Junichiro KOIZUMI.jpg;9;385;8821;0;12;12
/net/per920a/export/das14a/satoh-lab/haolin/nhk/excerpts/2002_02_13_19_00_2.webm;Junichiro KOIZUMI.jpg;421;421;8821;14;14;0
/net/per920a/export/das14a/satoh-lab/haolin/nhk/excerpts/2002_02_13_19_00_2.webm;Junichiro KOIZUMI.jpg;433;433;8821;14;14;0
/net/per920a/export/das14a/satoh-lab/haolin/nhk/excerpts/2002_02_13_19_00_2.webm;Junichiro KOIZUMI.jpg;449;453;8821;14;15;1
/net/per920a/export/das14a/satoh-lab/haolin/nhk/excerpts/2002_02_13_19_00_2.webm;Junichiro KOIZUMI.jpg;5433;5473;8821;181;182;1
/net/per920a/export/das14a/satoh-lab/haolin/nhk/excerpts/2002_02_13_19_00_2.webm;Junichiro KOIZUMI.jpg;5489;5517;8821;182;183;1
/net/per920a/export/das14a/satoh-lab/haolin/nhk/excerpts/2002_02_13_19_00_2.webm;Junichiro KOIZUMI.jpg;5533;5569;8821;184;185;1
/net/per920a/export/das14a/satoh-lab/haolin/nhk/excerpts/2002_02_13_19_00_2.webm;Junichiro KOIZUMI.jpg;5581;5581;8821;186;186;0
/net/per920a/export/das14a/satoh-lab/haolin/nhk/excerpts/2002_02_13_19_00_2.webm;Junichiro KOIZUMI.jpg;5593;5613;8821;186;187;1
/net/per920a/export/das14a/satoh-lab/haolin/nhk/excerpts/2002_02_13_19_00_2.webm;Junichiro KOIZUMI.jpg;5633;5633;8821;187;187;0
/net/per920a/export/das14a/satoh-lab/haolin/nhk/excerpts/2002_02_13_19_00_2.webm;Junichiro KOIZUMI.jpg;5649;5689;8821;188;189;1
/net/per920a/export/das14a/satoh-lab/haolin/nhk/excerpts/2002_02_13_19_00_2.webm;Junichiro KOIZUMI.jpg;5705;5901;8821;190;196;6
/net/per920a/export/das14a/satoh-lab/haolin/nhk/excerpts/2002_02_13_19_00_2.webm;Junichiro KOIZUMI.jpg;5929;5961;8821;197;198;1
/net/per920a/export/das14a/satoh-lab/haolin/nhk/excerpts/2002_02_13_19_00_2.webm;Junichiro KOIZUMI.jpg;5977;6009;8821;199;200;1
/net/per920a/export/das14a/satoh-lab/haolin/nhk/excerpts/2002_02_13_19_00_2.webm;Junichiro KOIZUMI.jpg;6609;6869;8821;220;228;8
/net/per920a/export/das14a/satoh-lab/haolin/nhk/excerpts/2002_02_13_19_00_2.webm;Junichiro KOIZUMI.jpg;7617;7729;8821;253;257;4
/net/per920a/export/das14a/satoh-lab/haolin/nhk/excerpts/2002_02_13_19_00_2.webm;Junichiro KOIZUMI.jpg;7749;7829;8821;258;260;2
/net/per920a/export/das14a/satoh-lab/haolin/nhk/excerpts/2002_02_13_19_00_2.webm;Junichiro KOIZUMI.jpg;7889;8817;8821;262;293;31
/net/per920a/export/das14a/satoh-lab/haolin/nhk/excerpts/2002_02_13_19_00_2.webm;Yasuo FUKUDA.jpg;3561;3785;8821;118;126;8
/net/per920a/export/das14a/satoh-lab/haolin/nhk/excerpts/2002_02_13_19_00_2.webm;Yasuo FUKUDA.jpg;3801;4013;8821;126;133;7
/net/per920a/export/das14a/satoh-lab/haolin/nhk/excerpts/2002_02_13_19_00_2.webm;Yasuo FUKUDA.jpg;4029;4153;8821;134;138;4
/net/per920a/export/das14a/satoh-lab/haolin/nhk/excerpts/2002_02_13_19_00_2.webm;Yasuo FUKUDA.jpg;4169;4313;8821;138;143;5
/net/per920a/export/das14a/satoh-lab/haolin/nhk/excerpts/2002_02_14_19_00_3.webm;Yasuo FUKUDA.jpg;2993;3145;3397;99;104;5
/net/per920a/export/das14a/satoh-lab/haolin/nhk/excerpts/2002_02_14_19_00_3.webm;Yasuo FUKUDA.jpg;3161;3393;3397;105;112;7
/net/per920a/export/das14a/satoh-lab/haolin/nhk/excerpts/2002_02_24_19_00_1.webm;Naoto KAN.jpg;2753;3961;4745;91;131;40
/net/per920a/export/das14a/satoh-lab/haolin/nhk/excerpts/2002_02_24_19_00_1.webm;Naoto KAN.jpg;3977;4277;4745;132;142;10
/net/per920a/export/das14a/satoh-lab/haolin/nhk/excerpts/2002_02_24_19_00_1.webm;Naoto KAN.jpg;4417;4673;4745;147;155;8
/net/per920a/export/das14a/satoh-lab/haolin/nhk/excerpts/2002_02_24_19_00_1.webm;Naoto KAN.jpg;4689;4741;4745;156;157;1
/net/per920a/export/das14a/satoh-lab/haolin/nhk/excerpts/2002_02_27_19_00_1.webm;Yukio HATOYAMA.jpg;5853;5965;9205;195;198;3
/net/per920a/export/das14a/satoh-lab/haolin/nhk/excerpts/2002_02_27_19_00_1.webm;Yukio HATOYAMA.jpg;6601;7381;9205;220;246;26
/net/per920a/export/das14a/satoh-lab/haolin/nhk/excerpts/2002_02_27_19_00_1.webm;Yukio HATOYAMA.jpg;7485;7489;9205;249;249;0
/net/per920a/export/das14a/satoh-lab/haolin/nhk/excerpts/2002_02_27_19_00_1.webm;Yukio HATOYAMA.jpg;7501;8085;9205;250;269;19
/net/per920a/export/das14a/satoh-lab/haolin/nhk/excerpts/2002_02_27_19_00_1.webm;Ichiro OZAWA.jpg;6053;6057;9205;201;202;1
/net/per920a/export/das14a/satoh-lab/haolin/nhk/excerpts/2002_02_27_19_00_1.webm;Ichiro OZAWA.jpg;6073;6101;9205;202;203;1
/net/per920a/export/das14a/satoh-lab/haolin/nhk/excerpts/2002_02_27_19_00_1.webm;Ichiro OZAWA.jpg;6257;6341;9205;208;211;3
/net/per920a/export/das14a/satoh-lab/haolin/nhk/excerpts/2002_02_27_19_00_1.webm;Ichiro OZAWA.jpg;6357;6397;9205;212;213;1
/net/per920a/export/das14a/satoh-lab/haolin/nhk/excerpts/2002_02_27_19_00_1.webm;Ichiro OZAWA.jpg;7485;7489;9205;249;249;0
/net/per920a/export/das14a/satoh-lab/haolin/nhk/excerpts/2002_02_27_19_00_1.webm;Kazuo SHII.jpg;6121;6245;9205;204;208;4
/net/per920a/export/das14a/satoh-lab/haolin/nhk/excerpts/2002_02_27_19_00_1.webm;Naoto KAN.jpg;6493;6501;9205;216;216;0
/net/per920a/export/das14a/satoh-lab/haolin/nhk/excerpts/2002_02_27_19_00_1.webm;Takenori KANZAKI.jpg;8109;8305;9205;270;276;6
/net/per920a/export/das14a/satoh-lab/haolin/nhk/excerpts/2002_02_27_19_00_1.webm;Takenori KANZAKI.jpg;8321;8349;9205;277;278;1
/net/per920a/export/das14a/satoh-lab/haolin/nhk/excerpts/2002_02_27_19_00_1.webm;Takenori KANZAKI.jpg;8365;8493;9205;278;283;5
/net/per920a/export/das14a/satoh-lab/haolin/nhk/excerpts/2002_02_27_19_00_1.webm;Takenori KANZAKI.jpg;8509;8513;9205;283;283;0
/net/per920a/export/das14a/satoh-lab/haolin/nhk/excerpts/2002_02_27_19_00_1.webm;Takenori KANZAKI.jpg;8529;8565;9205;284;285;1
/net/per920a/export/das14a/satoh-lab/haolin/nhk/excerpts/2002_02_27_19_00_1.webm;Takenori KANZAKI.jpg;8581;8597;9205;286;286;0
/net/per920a/export/das14a/satoh-lab/haolin/nhk/excerpts/2002_02_27_19_00_1.webm;Takenori KANZAKI.jpg;8621;8741;9205;287;291;4
/net/per920a/export/das14a/satoh-lab/haolin/nhk/excerpts/2002_02_27_19_00_1.webm;Takenori KANZAKI.jpg;8757;8829;9205;292;294;2
/net/per920a/export/das14a/satoh-lab/haolin/nhk/excerpts/2002_02_27_19_00_1.webm;Takenori KANZAKI.jpg;8845;8853;9205;294;295;1
/net/per920a/export/das14a/satoh-lab/haolin/nhk/excerpts/2002_02_27_19_00_1.webm;Takenori KANZAKI.jpg;8869;8985;9205;295;299;4
/net/per920a/export/das14a/satoh-lab/haolin/nhk/excerpts/2002_02_27_19_00_1.webm;Takenori KANZAKI.jpg;9001;9201;9205;300;306;6
/net/per920a/export/das14a/satoh-lab/haolin/nhk/excerpts/2002_02_28_19_00_1.webm;Ichiro OZAWA.jpg;1453;1485;26921;48;49;1
/net/per920a/export/das14a/satoh-lab/haolin/nhk/excerpts/2002_02_28_19_00_1.webm;Yukio HATOYAMA.jpg;2181;2901;26921;72;96;24
/net/per920a/export/das14a/satoh-lab/haolin/nhk/excerpts/2002_02_28_19_00_1.webm;Yukio HATOYAMA.jpg;13813;13813;26921;460;460;0
/net/per920a/export/das14a/satoh-lab/haolin/nhk/excerpts/2002_02_28_19_00_1.webm;Yukio HATOYAMA.jpg;13825;13837;26921;461;461;0
/net/per920a/export/das14a/satoh-lab/haolin/nhk/excerpts/2002_02_28_19_00_1.webm;Yukio HATOYAMA.jpg;14073;14073;26921;469;469;0
/net/per920a/export/das14a/satoh-lab/haolin/nhk/excerpts/2002_02_28_19_00_1.webm;Yukio HATOYAMA.jpg;14165;14165;26921;472;472;0
/net/per920a/export/das14a/satoh-lab/haolin/nhk/excerpts/2002_02_28_19_00_1.webm;Yukio HATOYAMA.jpg;14413;14417;26921;480;480;0
/net/per920a/export/das14a/satoh-lab/haolin/nhk/excerpts/2002_02_28_19_00_1.webm;Yukio HATOYAMA.jpg;14485;14489;26921;483;483;0
/net/per920a/export/das14a/satoh-lab/haolin/nhk/excerpts/2002_02_28_19_00_1.webm;Kazuo SHII.jpg;2917;2965;26921;97;98;1
/net/per920a/export/das14a/satoh-lab/haolin/nhk/excerpts/2002_02_28_19_00_1.webm;Shizuka KAMEI.jpg;5993;6053;26921;199;201;2
/net/per920a/export/das14a/satoh-lab/haolin/nhk/excerpts/2002_03_05_19_00_3.webm;Junichiro KOIZUMI.jpg;693;717;2641;23;23;0
/net/per920a/export/das14a/satoh-lab/haolin/nhk/excerpts/2002_03_05_19_00_3.webm;Junichiro KOIZUMI.jpg;1433;1433;2641;47;47;0
/net/per920a/export/das14a/satoh-lab/haolin/nhk/excerpts/2002_03_29_19_00_1.webm;Shintaro ISHIHARA.jpg;4089;4093;10973;136;136;0
/net/per920a/export/das14a/satoh-lab/haolin/nhk/excerpts/2002_03_29_19_00_1.webm;Shintaro ISHIHARA.jpg;4117;4117;10973;137;137;0
/net/per920a/export/das14a/satoh-lab/haolin/nhk/excerpts/2002_03_29_19_00_1.webm;Shintaro ISHIHARA.jpg;4141;4141;10973;138;138;0
/net/per920a/export/das14a/satoh-lab/haolin/nhk/excerpts/2002_03_29_19_00_1.webm;Shintaro ISHIHARA.jpg;4169;4181;10973;139;139;0
/net/per920a/export/das14a/satoh-lab/haolin/nhk/excerpts/2002_03_29_19_00_1.webm;Shintaro ISHIHARA.jpg;4281;4281;10973;142;142;0
/net/per920a/export/das14a/satoh-lab/haolin/nhk/excerpts/2002_03_29_19_00_1.webm;Shintaro ISHIHARA.jpg;4297;4301;10973;143;143;0
/net/per920a/export/das14a/satoh-lab/haolin/nhk/excerpts/2002_03_29_19_00_1.webm;Shintaro ISHIHARA.jpg;4317;4317;10973;143;143;0
/net/per920a/export/das14a/satoh-lab/haolin/nhk/excerpts/2002_03_29_19_00_1.webm;Shintaro ISHIHARA.jpg;4373;4377;10973;145;145;0
/net/per920a/export/das14a/satoh-lab/haolin/nhk/excerpts/2002_03_29_19_00_1.webm;Shintaro ISHIHARA.jpg;4457;4461;10973;148;148;0
/net/per920a/export/das14a/satoh-lab/haolin/nhk/excerpts/2002_03_29_19_00_1.webm;Shintaro ISHIHARA.jpg;4481;4497;10973;149;149;0
/net/per920a/export/das14a/satoh-lab/haolin/nhk/excerpts/2002_03_29_19_00_1.webm;Shintaro ISHIHARA.jpg;4513;4537;10973;150;151;1
/net/per920a/export/das14a/satoh-lab/haolin/nhk/excerpts/2002_03_29_19_00_1.webm;Shintaro ISHIHARA.jpg;4549;4557;10973;151;151;0
/net/per920a/export/das14a/satoh-lab/haolin/nhk/excerpts/2002_03_29_19_00_1.webm;Shintaro ISHIHARA.jpg;4569;4569;10973;152;152;0
/net/per920a/export/das14a/satoh-lab/haolin/nhk/excerpts/2002_03_29_19_00_1.webm;Shintaro ISHIHARA.jpg;4585;4585;10973;152;152;0
/net/per920a/export/das14a/satoh-lab/haolin/nhk/excerpts/2002_03_29_19_00_1.webm;Shintaro ISHIHARA.jpg;4597;4605;10973;153;153;0
/net/per920a/export/das14a/satoh-lab/haolin/nhk/excerpts/2002_03_29_19_00_1.webm;Shintaro ISHIHARA.jpg;4617;4625;10973;153;154;1
/net/per920a/export/das14a/satoh-lab/haolin/nhk/excerpts/2002_03_29_19_00_1.webm;Shintaro ISHIHARA.jpg;4649;4657;10973;155;155;0
/net/per920a/export/das14a/satoh-lab/haolin/nhk/excerpts/2002_03_29_19_00_1.webm;Shintaro ISHIHARA.jpg;4721;4721;10973;157;157;0
/net/per920a/export/das14a/satoh-lab/haolin/nhk/excerpts/2002_03_29_19_00_1.webm;Shintaro ISHIHARA.jpg;4845;4877;10973;161;162;1
/net/per920a/export/das14a/satoh-lab/haolin/nhk/excerpts/2002_03_29_19_00_1.webm;Shintaro ISHIHARA.jpg;4893;4901;10973;163;163;0
/net/per920a/export/das14a/satoh-lab/haolin/nhk/excerpts/2002_03_29_19_00_1.webm;Shintaro ISHIHARA.jpg;4917;4937;10973;164;164;0
/net/per920a/export/das14a/satoh-lab/haolin/nhk/excerpts/2002_03_29_19_00_1.webm;Shintaro ISHIHARA.jpg;5049;5065;10973;168;168;0
/net/per920a/export/das14a/satoh-lab/haolin/nhk/excerpts/2002_03_29_19_00_1.webm;Shintaro ISHIHARA.jpg;5081;5145;10973;169;171;2
/net/per920a/export/das14a/satoh-lab/haolin/nhk/excerpts/2002_03_29_19_00_1.webm;Shintaro ISHIHARA.jpg;5161;5193;10973;172;173;1
/net/per920a/export/das14a/satoh-lab/haolin/nhk/excerpts/2002_03_29_19_00_1.webm;Shintaro ISHIHARA.jpg;5213;5217;10973;173;174;1
/net/per920a/export/das14a/satoh-lab/haolin/nhk/excerpts/2002_03_29_19_00_1.webm;Shintaro ISHIHARA.jpg;5237;5297;10973;174;176;2
/net/per920a/export/das14a/satoh-lab/haolin/nhk/excerpts/2002_03_29_19_00_1.webm;Shintaro ISHIHARA.jpg;5353;5357;10973;178;178;0
/net/per920a/export/das14a/satoh-lab/haolin/nhk/excerpts/2002_03_29_19_00_1.webm;Shintaro ISHIHARA.jpg;5381;5385;10973;179;179;0
/net/per920a/export/das14a/satoh-lab/haolin/nhk/excerpts/2002_03_29_19_00_1.webm;Shintaro ISHIHARA.jpg;5457;5457;10973;182;182;0
/net/per920a/export/das14a/satoh-lab/haolin/nhk/excerpts/2002_03_29_19_00_1.webm;Shintaro ISHIHARA.jpg;5469;5481;10973;182;182;0
/net/per920a/export/das14a/satoh-lab/haolin/nhk/excerpts/2002_03_29_19_00_1.webm;Shintaro ISHIHARA.jpg;5513;5517;10973;183;184;1
/net/per920a/export/das14a/satoh-lab/haolin/nhk/excerpts/2002_03_29_19_00_1.webm;Shintaro ISHIHARA.jpg;5577;5581;10973;186;186;0
/net/per920a/export/das14a/satoh-lab/haolin/nhk/excerpts/2002_03_29_19_00_1.webm;Shintaro ISHIHARA.jpg;5601;5601;10973;186;186;0
/net/per920a/export/das14a/satoh-lab/haolin/nhk/excerpts/2002_03_29_19_00_1.webm;Shintaro ISHIHARA.jpg;5613;5621;10973;187;187;0
/net/per920a/export/das14a/satoh-lab/haolin/nhk/excerpts/2002_03_29_19_00_1.webm;Shintaro ISHIHARA.jpg;5725;5725;10973;190;190;0
/net/per920a/export/das14a/satoh-lab/haolin/nhk/excerpts/2002_03_29_19_00_1.webm;Shintaro ISHIHARA.jpg;5741;5761;10973;191;192;1
/net/per920a/export/das14a/satoh-lab/haolin/nhk/excerpts/2002_03_29_19_00_1.webm;Shintaro ISHIHARA.jpg;5813;5817;10973;193;194;1
/net/per920a/export/das14a/satoh-lab/haolin/nhk/excerpts/2002_03_29_19_00_1.webm;Shintaro ISHIHARA.jpg;5989;6005;10973;199;200;1
/net/per920a/export/das14a/satoh-lab/haolin/nhk/excerpts/2002_03_29_19_00_1.webm;Shintaro ISHIHARA.jpg;6069;6069;10973;202;202;0
/net/per920a/export/das14a/satoh-lab/haolin/nhk/excerpts/2002_03_29_19_00_1.webm;Shintaro ISHIHARA.jpg;6097;6109;10973;203;203;0
/net/per920a/export/das14a/satoh-lab/haolin/nhk/excerpts/2002_03_29_19_00_1.webm;Shintaro ISHIHARA.jpg;6209;6217;10973;207;207;0
/net/per920a/export/das14a/satoh-lab/haolin/nhk/excerpts/2002_03_29_19_00_1.webm;Shintaro ISHIHARA.jpg;6245;6245;10973;208;208;0
/net/per920a/export/das14a/satoh-lab/haolin/nhk/excerpts/2002_03_29_19_00_1.webm;Shintaro ISHIHARA.jpg;6389;6389;10973;213;213;0
/net/per920a/export/das14a/satoh-lab/haolin/nhk/excerpts/2002_03_29_19_00_1.webm;Shintaro ISHIHARA.jpg;6533;6537;10973;217;218;1
/net/per920a/export/das14a/satoh-lab/haolin/nhk/excerpts/2002_03_29_19_00_1.webm;Shintaro ISHIHARA.jpg;6569;6577;10973;219;219;0
/net/per920a/export/das14a/satoh-lab/haolin/nhk/excerpts/2002_03_29_19_00_1.webm;Shintaro ISHIHARA.jpg;6657;6661;10973;222;222;0
/net/per920a/export/das14a/satoh-lab/haolin/nhk/excerpts/2002_03_29_19_00_1.webm;Shintaro ISHIHARA.jpg;6697;6701;10973;223;223;0
/net/per920a/export/das14a/satoh-lab/haolin/nhk/excerpts/2002_03_29_19_00_1.webm;Shintaro ISHIHARA.jpg;6773;6773;10973;225;225;0
/net/per920a/export/das14a/satoh-lab/haolin/nhk/excerpts/2002_03_29_19_00_1.webm;Shintaro ISHIHARA.jpg;6805;6809;10973;226;227;1
/net/per920a/export/das14a/satoh-lab/haolin/nhk/excerpts/2002_03_29_19_00_1.webm;Shintaro ISHIHARA.jpg;6837;6837;10973;228;228;0
/net/per920a/export/das14a/satoh-lab/haolin/nhk/excerpts/2002_03_29_19_00_1.webm;Shintaro ISHIHARA.jpg;6937;6937;10973;231;231;0
/net/per920a/export/das14a/satoh-lab/haolin/nhk/excerpts/2002_03_29_19_00_1.webm;Shintaro ISHIHARA.jpg;6961;6965;10973;232;232;0
/net/per920a/export/das14a/satoh-lab/haolin/nhk/excerpts/2002_03_29_19_00_1.webm;Shintaro ISHIHARA.jpg;7009;7009;10973;233;233;0
/net/per920a/export/das14a/satoh-lab/haolin/nhk/excerpts/2002_03_29_19_00_1.webm;Shintaro ISHIHARA.jpg;7025;7041;10973;234;234;0
/net/per920a/export/das14a/satoh-lab/haolin/nhk/excerpts/2002_03_29_19_00_1.webm;Yukio EDANO.jpg;9617;9673;10973;320;322;2
/net/per920a/export/das14a/satoh-lab/haolin/nhk/excerpts/2002_03_29_19_00_1.webm;Yukio EDANO.jpg;10033;10089;10973;334;336;2
/net/per920a/export/das14a/satoh-lab/haolin/nhk/excerpts/2002_04_01_19_00_1.webm;Takenori KANZAKI.jpg;1681;1925;3633;55;64;9
/net/per920a/export/das14a/satoh-lab/haolin/nhk/excerpts/2002_04_01_19_00_1.webm;Takenori KANZAKI.jpg;1941;1957;3633;64;65;1
/net/per920a/export/das14a/satoh-lab/haolin/nhk/excerpts/2002_04_01_19_00_1.webm;Takenori KANZAKI.jpg;1973;2009;3633;65;66;1
/net/per920a/export/das14a/satoh-lab/haolin/nhk/excerpts/2002_04_01_19_00_1.webm;Takenori KANZAKI.jpg;2025;2713;3633;67;90;23
/net/per920a/export/das14a/satoh-lab/haolin/nhk/excerpts/2002_04_01_19_00_1.webm;Yukio EDANO.jpg;2833;2917;3633;94;97;3
/net/per920a/export/das14a/satoh-lab/haolin/nhk/excerpts/2002_04_08_19_00_2.webm;Junichiro KOIZUMI.jpg;585;1661;26625;19;55;36
/net/per920a/export/das14a/satoh-lab/haolin/nhk/excerpts/2002_04_08_19_00_2.webm;Junichiro KOIZUMI.jpg;1677;1869;26625;55;62;7
/net/per920a/export/das14a/satoh-lab/haolin/nhk/excerpts/2002_04_08_19_00_2.webm;Junichiro KOIZUMI.jpg;12501;12509;26625;416;417;1
/net/per920a/export/das14a/satoh-lab/haolin/nhk/excerpts/2002_04_08_19_00_2.webm;Junichiro KOIZUMI.jpg;12521;12525;26625;417;417;0
/net/per920a/export/das14a/satoh-lab/haolin/nhk/excerpts/2002_04_08_19_00_2.webm;Junichiro KOIZUMI.jpg;12541;12569;26625;418;419;1
/net/per920a/export/das14a/satoh-lab/haolin/nhk/excerpts/2002_04_08_19_00_2.webm;Junichiro KOIZUMI.jpg;18217;18217;26625;607;607;0
/net/per920a/export/das14a/satoh-lab/haolin/nhk/excerpts/2002_04_08_19_00_2.webm;Junichiro KOIZUMI.jpg;18245;18245;26625;608;608;0
/net/per920a/export/das14a/satoh-lab/haolin/nhk/excerpts/2002_04_08_19_00_2.webm;Junichiro KOIZUMI.jpg;18265;18309;26625;609;610;1
/net/per920a/export/das14a/satoh-lab/haolin/nhk/excerpts/2002_04_08_19_00_2.webm;Takenori KANZAKI.jpg;4269;5041;26625;142;168;26
/net/per920a/export/das14a/satoh-lab/haolin/nhk/excerpts/2002_04_08_19_00_2.webm;Yukio HATOYAMA.jpg;6069;6069;26625;202;202;0
/net/per920a/export/das14a/satoh-lab/haolin/nhk/excerpts/2002_04_08_19_00_2.webm;Yukio HATOYAMA.jpg;6085;6105;26625;202;203;1
/net/per920a/export/das14a/satoh-lab/haolin/nhk/excerpts/2002_04_08_19_00_2.webm;Yukio HATOYAMA.jpg;6129;6141;26625;204;204;0
/net/per920a/export/das14a/satoh-lab/haolin/nhk/excerpts/2002_04_08_19_00_2.webm;Yukio HATOYAMA.jpg;6153;6181;26625;205;206;1
/net/per920a/export/das14a/satoh-lab/haolin/nhk/excerpts/2002_04_08_19_00_2.webm;Yukio HATOYAMA.jpg;6213;6333;26625;207;211;4
/net/per920a/export/das14a/satoh-lab/haolin/nhk/excerpts/2002_04_08_19_00_2.webm;Yukio HATOYAMA.jpg;6353;6377;26625;211;212;1
/net/per920a/export/das14a/satoh-lab/haolin/nhk/excerpts/2002_04_08_19_00_2.webm;Yukio HATOYAMA.jpg;6389;6453;26625;213;215;2
/net/per920a/export/das14a/satoh-lab/haolin/nhk/excerpts/2002_04_08_19_00_2.webm;Yukio HATOYAMA.jpg;6469;6477;26625;215;216;1
/net/per920a/export/das14a/satoh-lab/haolin/nhk/excerpts/2002_04_08_19_00_2.webm;Yukio HATOYAMA.jpg;6501;6513;26625;216;217;1
/net/per920a/export/das14a/satoh-lab/haolin/nhk/excerpts/2002_04_08_19_00_2.webm;Yukio HATOYAMA.jpg;6541;6549;26625;218;218;0
/net/per920a/export/das14a/satoh-lab/haolin/nhk/excerpts/2002_04_08_19_00_2.webm;Yukio HATOYAMA.jpg;6565;6565;26625;218;218;0
/net/per920a/export/das14a/satoh-lab/haolin/nhk/excerpts/2002_04_08_19_00_2.webm;Yukio HATOYAMA.jpg;6581;6589;26625;219;219;0
/net/per920a/export/das14a/satoh-lab/haolin/nhk/excerpts/2002_04_08_19_00_2.webm;Yukio HATOYAMA.jpg;6633;6653;26625;221;221;0
/net/per920a/export/das14a/satoh-lab/haolin/nhk/excerpts/2002_04_08_19_00_2.webm;Yukio HATOYAMA.jpg;6681;6693;26625;222;223;1
/net/per920a/export/das14a/satoh-lab/haolin/nhk/excerpts/2002_04_08_19_00_2.webm;Yukio HATOYAMA.jpg;6709;6725;26625;223;224;1
/net/per920a/export/das14a/satoh-lab/haolin/nhk/excerpts/2002_04_08_19_00_2.webm;Yukio HATOYAMA.jpg;6761;6761;26625;225;225;0
/net/per920a/export/das14a/satoh-lab/haolin/nhk/excerpts/2002_04_08_19_00_2.webm;Yukio HATOYAMA.jpg;6841;6841;26625;228;228;0
/net/per920a/export/das14a/satoh-lab/haolin/nhk/excerpts/2002_04_08_19_00_2.webm;Yukio HATOYAMA.jpg;6873;6873;26625;229;229;0
/net/per920a/export/das14a/satoh-lab/haolin/nhk/excerpts/2002_04_08_19_00_2.webm;Yukio HATOYAMA.jpg;6889;6897;26625;229;230;1
/net/per920a/export/das14a/satoh-lab/haolin/nhk/excerpts/2002_04_08_19_00_2.webm;Yukio HATOYAMA.jpg;6909;6909;26625;230;230;0
/net/per920a/export/das14a/satoh-lab/haolin/nhk/excerpts/2002_04_08_19_00_2.webm;Yukio HATOYAMA.jpg;6933;6945;26625;231;231;0
/net/per920a/export/das14a/satoh-lab/haolin/nhk/excerpts/2002_04_08_19_00_2.webm;Yukio HATOYAMA.jpg;6965;6969;26625;232;232;0
/net/per920a/export/das14a/satoh-lab/haolin/nhk/excerpts/2002_04_08_19_00_2.webm;Kazuo SHII.jpg;8449;8977;26625;281;299;18
/net/per920a/export/das14a/satoh-lab/haolin/nhk/excerpts/2002_04_08_19_00_2.webm;Shizuka KAMEI.jpg;24393;24449;26625;813;815;2
/net/per920a/export/das14a/satoh-lab/haolin/nhk/excerpts/2002_04_08_19_00_2.webm;Shizuka KAMEI.jpg;24469;24669;26625;816;822;6
/net/per920a/export/das14a/satoh-lab/haolin/nhk/excerpts/2002_04_08_19_00_2.webm;Shizuka KAMEI.jpg;24685;24765;26625;823;825;2
/net/per920a/export/das14a/satoh-lab/haolin/nhk/excerpts/2002_04_08_19_00_2.webm;Shizuka KAMEI.jpg;24797;24977;26625;827;833;6
/net/per920a/export/das14a/satoh-lab/haolin/nhk/excerpts/2002_04_08_19_00_2.webm;Shizuka KAMEI.jpg;24993;25005;26625;833;833;0
/net/per920a/export/das14a/satoh-lab/haolin/nhk/excerpts/2002_04_08_19_00_2.webm;Shizuka KAMEI.jpg;25297;25345;26625;843;845;2
/net/per920a/export/das14a/satoh-lab/haolin/nhk/excerpts/2002_04_08_19_00_2.webm;Shizuka KAMEI.jpg;25365;25581;26625;845;853;8
/net/per920a/export/das14a/satoh-lab/haolin/nhk/excerpts/2002_04_08_19_00_2.webm;Shizuka KAMEI.jpg;25597;25657;26625;853;855;2
/net/per920a/export/das14a/satoh-lab/haolin/nhk/excerpts/2002_04_16_19_00_1.webm;Takenori KANZAKI.jpg;1125;1185;11961;37;39;2
/net/per920a/export/das14a/satoh-lab/haolin/nhk/excerpts/2002_05_01_19_00_3.webm;Junichiro KOIZUMI.jpg;785;789;2609;26;26;0
/net/per920a/export/das14a/satoh-lab/haolin/nhk/excerpts/2002_05_01_19_00_3.webm;Junichiro KOIZUMI.jpg;1001;1049;2609;33;34;1
/net/per920a/export/das14a/satoh-lab/haolin/nhk/excerpts/2002_05_01_19_00_3.webm;Junichiro KOIZUMI.jpg;1225;1233;2609;40;41;1
/net/per920a/export/das14a/satoh-lab/haolin/nhk/excerpts/2002_05_01_19_00_3.webm;Junichiro KOIZUMI.jpg;1249;1253;2609;41;41;0
/net/per920a/export/das14a/satoh-lab/haolin/nhk/excerpts/2002_05_01_19_00_3.webm;Junichiro KOIZUMI.jpg;1269;1309;2609;42;43;1
/net/per920a/export/das14a/satoh-lab/haolin/nhk/excerpts/2002_05_01_19_00_3.webm;Junichiro KOIZUMI.jpg;1325;1385;2609;44;46;2
/net/per920a/export/das14a/satoh-lab/haolin/nhk/excerpts/2002_05_07_19_00_2.webm;Junichiro KOIZUMI.jpg;9;709;9173;0;23;23
/net/per920a/export/das14a/satoh-lab/haolin/nhk/excerpts/2002_05_07_19_00_2.webm;Junichiro KOIZUMI.jpg;1197;1909;9173;39;63;24
/net/per920a/export/das14a/satoh-lab/haolin/nhk/excerpts/2002_05_07_19_00_2.webm;Junichiro KOIZUMI.jpg;1921;1933;9173;64;64;0
/net/per920a/export/das14a/satoh-lab/haolin/nhk/excerpts/2002_05_07_19_00_2.webm;Junichiro KOIZUMI.jpg;1945;2137;9173;64;71;7
/net/per920a/export/das14a/satoh-lab/haolin/nhk/excerpts/2002_05_07_19_00_2.webm;Junichiro KOIZUMI.jpg;2885;2885;9173;96;96;0
/net/per920a/export/das14a/satoh-lab/haolin/nhk/excerpts/2002_05_07_19_00_2.webm;Junichiro KOIZUMI.jpg;2925;2925;9173;97;97;0
/net/per920a/export/das14a/satoh-lab/haolin/nhk/excerpts/2002_05_07_19_00_2.webm;Junichiro KOIZUMI.jpg;2965;3005;9173;98;100;2
/net/per920a/export/das14a/satoh-lab/haolin/nhk/excerpts/2002_05_07_19_00_2.webm;Junichiro KOIZUMI.jpg;3021;3033;9173;100;101;1
/net/per920a/export/das14a/satoh-lab/haolin/nhk/excerpts/2002_05_07_19_00_2.webm;Junichiro KOIZUMI.jpg;3049;3065;9173;101;102;1
/net/per920a/export/das14a/satoh-lab/haolin/nhk/excerpts/2002_05_07_19_00_2.webm;Junichiro KOIZUMI.jpg;3081;3149;9173;102;105;3
/net/per920a/export/das14a/satoh-lab/haolin/nhk/excerpts/2002_05_07_19_00_2.webm;Junichiro KOIZUMI.jpg;3165;3169;9173;105;105;0
/net/per920a/export/das14a/satoh-lab/haolin/nhk/excerpts/2002_05_07_19_00_2.webm;Junichiro KOIZUMI.jpg;3189;3217;9173;106;107;1
/net/per920a/export/das14a/satoh-lab/haolin/nhk/excerpts/2002_05_07_19_00_2.webm;Junichiro KOIZUMI.jpg;3241;3261;9173;108;108;0
/net/per920a/export/das14a/satoh-lab/haolin/nhk/excerpts/2002_05_07_19_00_2.webm;Junichiro KOIZUMI.jpg;3301;3313;9173;110;110;0
/net/per920a/export/das14a/satoh-lab/haolin/nhk/excerpts/2002_05_07_19_00_2.webm;Junichiro KOIZUMI.jpg;3329;3337;9173;111;111;0
/net/per920a/export/das14a/satoh-lab/haolin/nhk/excerpts/2002_05_07_19_00_2.webm;Junichiro KOIZUMI.jpg;3349;3349;9173;111;111;0
/net/per920a/export/das14a/satoh-lab/haolin/nhk/excerpts/2002_05_07_19_00_2.webm;Junichiro KOIZUMI.jpg;3361;3433;9173;112;114;2
/net/per920a/export/das14a/satoh-lab/haolin/nhk/excerpts/2002_05_07_19_00_2.webm;Junichiro KOIZUMI.jpg;5045;5133;9173;168;171;3
/net/per920a/export/das14a/satoh-lab/haolin/nhk/excerpts/2002_05_07_19_00_2.webm;Junichiro KOIZUMI.jpg;5201;5717;9173;173;190;17
/net/per920a/export/das14a/satoh-lab/haolin/nhk/excerpts/2002_05_07_19_00_2.webm;Junichiro KOIZUMI.jpg;5729;5889;9173;191;196;5
/net/per920a/export/das14a/satoh-lab/haolin/nhk/excerpts/2002_05_13_19_00_2.webm;Junichiro KOIZUMI.jpg;19545;19549;25633;651;652;1
/net/per920a/export/das14a/satoh-lab/haolin/nhk/excerpts/2002_05_13_19_00_2.webm;Junichiro KOIZUMI.jpg;19581;19589;25633;653;653;0
/net/per920a/export/das14a/satoh-lab/haolin/nhk/excerpts/2002_05_13_19_00_2.webm;Junichiro KOIZUMI.jpg;19609;19629;25633;654;654;0
/net/per920a/export/das14a/satoh-lab/haolin/nhk/excerpts/2002_05_13_19_00_2.webm;Junichiro KOIZUMI.jpg;19665;19665;25633;655;655;0
/net/per920a/export/das14a/satoh-lab/haolin/nhk/excerpts/2002_05_13_19_00_2.webm;Junichiro KOIZUMI.jpg;19677;19677;25633;656;656;0
/net/per920a/export/das14a/satoh-lab/haolin/nhk/excerpts/2002_05_13_19_00_2.webm;Junichiro KOIZUMI.jpg;19717;19717;25633;657;657;0
/net/per920a/export/das14a/satoh-lab/haolin/nhk/excerpts/2002_05_13_19_00_2.webm;Junichiro KOIZUMI.jpg;19729;19729;25633;658;658;0
/net/per920a/export/das14a/satoh-lab/haolin/nhk/excerpts/2002_05_13_19_00_2.webm;Junichiro KOIZUMI.jpg;19745;19749;25633;658;658;0
/net/per920a/export/das14a/satoh-lab/haolin/nhk/excerpts/2002_05_13_19_00_2.webm;Junichiro KOIZUMI.jpg;19761;19817;25633;659;661;2
/net/per920a/export/das14a/satoh-lab/haolin/nhk/excerpts/2002_05_13_19_00_2.webm;Takenori KANZAKI.jpg;19937;20009;25633;665;667;2
/net/per920a/export/das14a/satoh-lab/haolin/nhk/excerpts/2002_05_13_19_00_2.webm;Takenori KANZAKI.jpg;20025;20029;25633;667;668;1
/net/per920a/export/das14a/satoh-lab/haolin/nhk/excerpts/2002_05_13_19_00_2.webm;Takenori KANZAKI.jpg;20045;20149;25633;668;672;4
/net/per920a/export/das14a/satoh-lab/haolin/nhk/excerpts/2002_05_22_19_00_1.webm;Junichiro KOIZUMI.jpg;7109;7329;30541;237;244;7
/net/per920a/export/das14a/satoh-lab/haolin/nhk/excerpts/2002_05_22_19_00_1.webm;Junichiro KOIZUMI.jpg;7345;7377;30541;245;246;1
/net/per920a/export/das14a/satoh-lab/haolin/nhk/excerpts/2002_05_22_19_00_1.webm;Junichiro KOIZUMI.jpg;7393;7393;30541;246;246;0
/net/per920a/export/das14a/satoh-lab/haolin/nhk/excerpts/2002_05_22_19_00_1.webm;Junichiro KOIZUMI.jpg;7421;7433;30541;247;248;1
/net/per920a/export/das14a/satoh-lab/haolin/nhk/excerpts/2002_05_22_19_00_1.webm;Junichiro KOIZUMI.jpg;24229;24229;30541;808;808;0
/net/per920a/export/das14a/satoh-lab/haolin/nhk/excerpts/2002_05_22_19_00_1.webm;Junichiro KOIZUMI.jpg;24309;24369;30541;811;813;2
/net/per920a/export/das14a/satoh-lab/haolin/nhk/excerpts/2002_05_22_19_00_1.webm;Junichiro KOIZUMI.jpg;24397;24397;30541;814;814;0
/net/per920a/export/das14a/satoh-lab/haolin/nhk/excerpts/2002_05_22_19_00_1.webm;Junichiro KOIZUMI.jpg;30425;30537;30541;1015;1018;3
/net/per920a/export/das14a/satoh-lab/haolin/nhk/excerpts/2002_05_22_19_00_1.webm;Yasuo FUKUDA.jpg;17529;17589;30541;584;586;2
/net/per920a/export/das14a/satoh-lab/haolin/nhk/excerpts/2002_05_22_19_00_1.webm;Yasuo FUKUDA.jpg;17605;17629;30541;587;588;1
/net/per920a/export/das14a/satoh-lab/haolin/nhk/excerpts/2002_05_22_19_00_1.webm;Yasuo FUKUDA.jpg;17649;17677;30541;588;589;1
/net/per920a/export/das14a/satoh-lab/haolin/nhk/excerpts/2002_05_22_19_00_1.webm;Yasuo FUKUDA.jpg;17693;17757;30541;590;592;2
/net/per920a/export/das14a/satoh-lab/haolin/nhk/excerpts/2002_05_22_19_00_1.webm;Yasuo FUKUDA.jpg;17773;17773;30541;592;592;0
/net/per920a/export/das14a/satoh-lab/haolin/nhk/excerpts/2002_05_22_19_00_1.webm;Yasuo FUKUDA.jpg;17789;18033;30541;593;601;8
/net/per920a/export/das14a/satoh-lab/haolin/nhk/excerpts/2002_07_01_19_00_1.webm;Junichiro KOIZUMI.jpg;765;765;12869;25;25;0
/net/per920a/export/das14a/satoh-lab/haolin/nhk/excerpts/2002_07_01_19_00_1.webm;Junichiro KOIZUMI.jpg;833;837;12869;27;27;0
/net/per920a/export/das14a/satoh-lab/haolin/nhk/excerpts/2002_07_01_19_00_1.webm;Junichiro KOIZUMI.jpg;849;849;12869;28;28;0
/net/per920a/export/das14a/satoh-lab/haolin/nhk/excerpts/2002_07_01_19_00_1.webm;Junichiro KOIZUMI.jpg;865;873;12869;28;29;1
/net/per920a/export/das14a/satoh-lab/haolin/nhk/excerpts/2002_07_01_19_00_1.webm;Junichiro KOIZUMI.jpg;885;885;12869;29;29;0
/net/per920a/export/das14a/satoh-lab/haolin/nhk/excerpts/2002_07_01_19_00_1.webm;Junichiro KOIZUMI.jpg;909;953;12869;30;31;1
/net/per920a/export/das14a/satoh-lab/haolin/nhk/excerpts/2002_07_01_19_00_1.webm;Junichiro KOIZUMI.jpg;981;981;12869;32;32;0
/net/per920a/export/das14a/satoh-lab/haolin/nhk/excerpts/2002_07_01_19_00_1.webm;Junichiro KOIZUMI.jpg;1021;1053;12869;34;35;1
/net/per920a/export/das14a/satoh-lab/haolin/nhk/excerpts/2002_07_01_19_00_1.webm;Junichiro KOIZUMI.jpg;2997;3013;12869;99;100;1
/net/per920a/export/das14a/satoh-lab/haolin/nhk/excerpts/2002_07_01_19_00_1.webm;Junichiro KOIZUMI.jpg;3029;3217;12869;100;107;7
/net/per920a/export/das14a/satoh-lab/haolin/nhk/excerpts/2002_07_01_19_00_1.webm;Junichiro KOIZUMI.jpg;3233;4237;12869;107;141;34
/net/per920a/export/das14a/satoh-lab/haolin/nhk/excerpts/2002_07_01_19_00_1.webm;Junichiro KOIZUMI.jpg;4913;4917;12869;163;163;0
/net/per920a/export/das14a/satoh-lab/haolin/nhk/excerpts/2002_07_01_19_00_1.webm;Junichiro KOIZUMI.jpg;4953;4961;12869;165;165;0
/net/per920a/export/das14a/satoh-lab/haolin/nhk/excerpts/2002_07_01_19_00_1.webm;Junichiro KOIZUMI.jpg;4977;4985;12869;165;166;1
/net/per920a/export/das14a/satoh-lab/haolin/nhk/excerpts/2002_07_01_19_00_1.webm;Junichiro KOIZUMI.jpg;5001;5029;12869;166;167;1
/net/per920a/export/das14a/satoh-lab/haolin/nhk/excerpts/2002_07_01_19_00_1.webm;Junichiro KOIZUMI.jpg;5041;5041;12869;168;168;0
/net/per920a/export/das14a/satoh-lab/haolin/nhk/excerpts/2002_07_01_19_00_1.webm;Junichiro KOIZUMI.jpg;5053;5053;12869;168;168;0
/net/per920a/export/das14a/satoh-lab/haolin/nhk/excerpts/2002_07_01_19_00_1.webm;Junichiro KOIZUMI.jpg;5065;5065;12869;168;168;0
/net/per920a/export/das14a/satoh-lab/haolin/nhk/excerpts/2002_07_01_19_00_1.webm;Junichiro KOIZUMI.jpg;5097;5101;12869;169;170;1
/net/per920a/export/das14a/satoh-lab/haolin/nhk/excerpts/2002_07_01_19_00_1.webm;Junichiro KOIZUMI.jpg;5117;5117;12869;170;170;0
/net/per920a/export/das14a/satoh-lab/haolin/nhk/excerpts/2002_07_01_19_00_1.webm;Junichiro KOIZUMI.jpg;5129;5133;12869;170;171;1
/net/per920a/export/das14a/satoh-lab/haolin/nhk/excerpts/2002_07_01_19_00_1.webm;Junichiro KOIZUMI.jpg;9737;9805;12869;324;326;2
/net/per920a/export/das14a/satoh-lab/haolin/nhk/excerpts/2002_07_01_19_00_1.webm;Junichiro KOIZUMI.jpg;9817;9817;12869;327;327;0
/net/per920a/export/das14a/satoh-lab/haolin/nhk/excerpts/2002_07_01_19_00_1.webm;Junichiro KOIZUMI.jpg;9833;9865;12869;327;328;1
/net/per920a/export/das14a/satoh-lab/haolin/nhk/excerpts/2002_07_01_19_00_1.webm;Junichiro KOIZUMI.jpg;9881;9905;12869;329;330;1
/net/per920a/export/das14a/satoh-lab/haolin/nhk/excerpts/2002_07_01_19_00_1.webm;Junichiro KOIZUMI.jpg;10325;10341;12869;344;344;0
/net/per920a/export/das14a/satoh-lab/haolin/nhk/excerpts/2002_07_01_19_00_1.webm;Junichiro KOIZUMI.jpg;10353;10365;12869;345;345;0
/net/per920a/export/das14a/satoh-lab/haolin/nhk/excerpts/2002_07_01_19_00_1.webm;Junichiro KOIZUMI.jpg;10857;10889;12869;361;362;1
/net/per920a/export/das14a/satoh-lab/haolin/nhk/excerpts/2002_07_01_19_00_1.webm;Junichiro KOIZUMI.jpg;11041;11045;12869;368;368;0
/net/per920a/export/das14a/satoh-lab/haolin/nhk/excerpts/2002_07_01_19_00_1.webm;Junichiro KOIZUMI.jpg;11105;11117;12869;370;370;0
/net/per920a/export/das14a/satoh-lab/haolin/nhk/excerpts/2002_07_01_19_00_1.webm;Junichiro KOIZUMI.jpg;11161;11161;12869;372;372;0
/net/per920a/export/das14a/satoh-lab/haolin/nhk/excerpts/2002_07_01_19_00_1.webm;Junichiro KOIZUMI.jpg;11177;11181;12869;372;372;0
/net/per920a/export/das14a/satoh-lab/haolin/nhk/excerpts/2002_07_01_19_00_1.webm;Taro ASO.jpg;1213;1237;12869;40;41;1
/net/per920a/export/das14a/satoh-lab/haolin/nhk/excerpts/2002_07_01_19_00_1.webm;Taro ASO.jpg;1249;1249;12869;41;41;0
/net/per920a/export/das14a/satoh-lab/haolin/nhk/excerpts/2002_07_01_19_00_1.webm;Taro ASO.jpg;1261;1325;12869;42;44;2
/net/per920a/export/das14a/satoh-lab/haolin/nhk/excerpts/2002_07_01_19_00_1.webm;Taro ASO.jpg;1337;1341;12869;44;44;0
/net/per920a/export/das14a/satoh-lab/haolin/nhk/excerpts/2002_07_01_19_00_1.webm;Taro ASO.jpg;1353;1361;12869;45;45;0
/net/per920a/export/das14a/satoh-lab/haolin/nhk/excerpts/2002_07_01_19_00_1.webm;Taro ASO.jpg;1373;1377;12869;45;45;0
/net/per920a/export/das14a/satoh-lab/haolin/nhk/excerpts/2002_07_01_19_00_1.webm;Taro ASO.jpg;1393;1397;12869;46;46;0
/net/per920a/export/das14a/satoh-lab/haolin/nhk/excerpts/2002_07_01_19_00_1.webm;Taro ASO.jpg;1453;1461;12869;48;48;0
/net/per920a/export/das14a/satoh-lab/haolin/nhk/excerpts/2002_07_01_19_00_1.webm;Taro ASO.jpg;1473;1485;12869;49;49;0
/net/per920a/export/das14a/satoh-lab/haolin/nhk/excerpts/2002_07_01_19_00_1.webm;Shinzo ABE.jpg;5129;5133;12869;170;171;1
/net/per920a/export/das14a/satoh-lab/haolin/nhk/excerpts/2002_07_16_19_00_2.webm;Junichiro KOIZUMI.jpg;117;121;14481;3;4;1
/net/per920a/export/das14a/satoh-lab/haolin/nhk/excerpts/2002_07_16_19_00_2.webm;Junichiro KOIZUMI.jpg;137;289;14481;4;9;5
/net/per920a/export/das14a/satoh-lab/haolin/nhk/excerpts/2002_07_16_19_00_2.webm;Junichiro KOIZUMI.jpg;593;725;14481;19;24;5
/net/per920a/export/das14a/satoh-lab/haolin/nhk/excerpts/2002_07_16_19_00_2.webm;Junichiro KOIZUMI.jpg;3005;3149;14481;100;105;5
/net/per920a/export/das14a/satoh-lab/haolin/nhk/excerpts/2002_07_16_19_00_2.webm;Junichiro KOIZUMI.jpg;3161;3461;14481;105;115;10
/net/per920a/export/das14a/satoh-lab/haolin/nhk/excerpts/2002_07_16_19_00_2.webm;Junichiro KOIZUMI.jpg;3477;4149;14481;115;138;23
/net/per920a/export/das14a/satoh-lab/haolin/nhk/excerpts/2002_07_16_19_00_2.webm;Junichiro KOIZUMI.jpg;4165;4225;14481;138;140;2
/net/per920a/export/das14a/satoh-lab/haolin/nhk/excerpts/2002_07_16_19_00_2.webm;Junichiro KOIZUMI.jpg;4237;4321;14481;141;144;3
/net/per920a/export/das14a/satoh-lab/haolin/nhk/excerpts/2002_07_16_19_00_2.webm;Junichiro KOIZUMI.jpg;5133;5133;14481;171;171;0
/net/per920a/export/das14a/satoh-lab/haolin/nhk/excerpts/2002_07_16_19_00_2.webm;Junichiro KOIZUMI.jpg;5157;5197;14481;172;173;1
/net/per920a/export/das14a/satoh-lab/haolin/nhk/excerpts/2002_07_16_19_00_2.webm;Junichiro KOIZUMI.jpg;5221;5221;14481;174;174;0
/net/per920a/export/das14a/satoh-lab/haolin/nhk/excerpts/2002_07_16_19_00_2.webm;Junichiro KOIZUMI.jpg;5253;5257;14481;175;175;0
/net/per920a/export/das14a/satoh-lab/haolin/nhk/excerpts/2002_07_16_19_00_2.webm;Sadakazu TANIGAKI.jpg;6149;6805;14481;205;226;21
/net/per920a/export/das14a/satoh-lab/haolin/nhk/excerpts/2002_07_16_19_00_2.webm;Yasuo FUKUDA.jpg;8277;8833;14481;276;294;18
/net/per920a/export/das14a/satoh-lab/haolin/nhk/excerpts/2002_07_30_19_00_2.webm;Yukio HATOYAMA.jpg;773;833;3157;25;27;2
/net/per920a/export/das14a/satoh-lab/haolin/nhk/excerpts/2002_07_30_19_00_2.webm;Yukio HATOYAMA.jpg;845;849;3157;28;28;0
/net/per920a/export/das14a/satoh-lab/haolin/nhk/excerpts/2002_07_30_19_00_2.webm;Junichiro KOIZUMI.jpg;1457;1529;3157;48;50;2
/net/per920a/export/das14a/satoh-lab/haolin/nhk/excerpts/2002_07_30_19_00_2.webm;Junichiro KOIZUMI.jpg;2105;2121;3157;70;70;0
/net/per920a/export/das14a/satoh-lab/haolin/nhk/excerpts/2002_08_26_19_00_1.webm;Junichiro KOIZUMI.jpg;725;729;11065;24;24;0
/net/per920a/export/das14a/satoh-lab/haolin/nhk/excerpts/2002_08_26_19_00_1.webm;Junichiro KOIZUMI.jpg;757;773;11065;25;25;0
/net/per920a/export/das14a/satoh-lab/haolin/nhk/excerpts/2002_08_26_19_00_1.webm;Junichiro KOIZUMI.jpg;801;805;11065;26;26;0
/net/per920a/export/das14a/satoh-lab/haolin/nhk/excerpts/2002_08_26_19_00_1.webm;Junichiro KOIZUMI.jpg;817;873;11065;27;29;2
/net/per920a/export/das14a/satoh-lab/haolin/nhk/excerpts/2002_08_26_19_00_1.webm;Junichiro KOIZUMI.jpg;909;913;11065;30;30;0
/net/per920a/export/das14a/satoh-lab/haolin/nhk/excerpts/2002_08_26_19_00_1.webm;Junichiro KOIZUMI.jpg;925;925;11065;30;30;0
/net/per920a/export/das14a/satoh-lab/haolin/nhk/excerpts/2002_08_26_19_00_1.webm;Junichiro KOIZUMI.jpg;937;941;11065;31;31;0
/net/per920a/export/das14a/satoh-lab/haolin/nhk/excerpts/2002_08_26_19_00_1.webm;Junichiro KOIZUMI.jpg;953;957;11065;31;31;0
/net/per920a/export/das14a/satoh-lab/haolin/nhk/excerpts/2002_08_26_19_00_1.webm;Junichiro KOIZUMI.jpg;977;993;11065;32;33;1
/net/per920a/export/das14a/satoh-lab/haolin/nhk/excerpts/2002_08_26_19_00_1.webm;Junichiro KOIZUMI.jpg;5281;5281;11065;176;176;0
/net/per920a/export/das14a/satoh-lab/haolin/nhk/excerpts/2002_08_26_19_00_1.webm;Junichiro KOIZUMI.jpg;5293;5305;11065;176;176;0
/net/per920a/export/das14a/satoh-lab/haolin/nhk/excerpts/2002_08_26_19_00_1.webm;Junichiro KOIZUMI.jpg;5321;5341;11065;177;178;1
/net/per920a/export/das14a/satoh-lab/haolin/nhk/excerpts/2002_08_26_19_00_1.webm;Junichiro KOIZUMI.jpg;5357;5357;11065;178;178;0
/net/per920a/export/das14a/satoh-lab/haolin/nhk/excerpts/2002_08_26_19_00_1.webm;Junichiro KOIZUMI.jpg;5373;6501;11065;179;216;37
/net/per920a/export/das14a/satoh-lab/haolin/nhk/excerpts/2002_08_26_19_00_1.webm;Junichiro KOIZUMI.jpg;8825;8833;11065;294;294;0
/net/per920a/export/das14a/satoh-lab/haolin/nhk/excerpts/2002_08_26_19_00_1.webm;Junichiro KOIZUMI.jpg;8865;8865;11065;295;295;0
/net/per920a/export/das14a/satoh-lab/haolin/nhk/excerpts/2002_08_26_19_00_1.webm;Junichiro KOIZUMI.jpg;8877;8937;11065;296;298;2
/net/per920a/export/das14a/satoh-lab/haolin/nhk/excerpts/2002_09_08_19_00_2.webm;Junichiro KOIZUMI.jpg;5977;7097;8365;199;236;37
/net/per920a/export/das14a/satoh-lab/haolin/nhk/excerpts/2002_09_08_19_00_2.webm;Junichiro KOIZUMI.jpg;7113;7401;8365;237;246;9
/net/per920a/export/das14a/satoh-lab/haolin/nhk/excerpts/2002_09_16_19_00_1.webm;Junichiro KOIZUMI.jpg;9;97;43853;0;3;3
/net/per920a/export/das14a/satoh-lab/haolin/nhk/excerpts/2002_09_16_19_00_1.webm;Junichiro KOIZUMI.jpg;2269;2389;43853;75;79;4
/net/per920a/export/das14a/satoh-lab/haolin/nhk/excerpts/2002_09_16_19_00_1.webm;Junichiro KOIZUMI.jpg;3517;3965;43853;117;132;15
/net/per920a/export/das14a/satoh-lab/haolin/nhk/excerpts/2002_09_16_19_00_1.webm;Junichiro KOIZUMI.jpg;4025;4029;43853;134;134;0
/net/per920a/export/das14a/satoh-lab/haolin/nhk/excerpts/2002_09_16_19_00_1.webm;Junichiro KOIZUMI.jpg;4045;4129;43853;134;137;3
/net/per920a/export/das14a/satoh-lab/haolin/nhk/excerpts/2002_09_16_19_00_1.webm;Junichiro KOIZUMI.jpg;4145;4213;43853;138;140;2
/net/per920a/export/das14a/satoh-lab/haolin/nhk/excerpts/2002_09_16_19_00_1.webm;Junichiro KOIZUMI.jpg;4229;4641;43853;141;154;13
/net/per920a/export/das14a/satoh-lab/haolin/nhk/excerpts/2002_09_16_19_00_1.webm;Junichiro KOIZUMI.jpg;4665;4665;43853;155;155;0
/net/per920a/export/das14a/satoh-lab/haolin/nhk/excerpts/2002_09_16_19_00_1.webm;Junichiro KOIZUMI.jpg;4757;4757;43853;158;158;0
/net/per920a/export/das14a/satoh-lab/haolin/nhk/excerpts/2002_09_16_19_00_1.webm;Junichiro KOIZUMI.jpg;4785;4797;43853;159;160;1
/net/per920a/export/das14a/satoh-lab/haolin/nhk/excerpts/2002_09_16_19_00_1.webm;Junichiro KOIZUMI.jpg;4825;4841;43853;160;161;1
/net/per920a/export/das14a/satoh-lab/haolin/nhk/excerpts/2002_09_16_19_00_1.webm;Junichiro KOIZUMI.jpg;4861;4865;43853;162;162;0
/net/per920a/export/das14a/satoh-lab/haolin/nhk/excerpts/2002_09_16_19_00_1.webm;Junichiro KOIZUMI.jpg;4889;4993;43853;163;166;3
/net/per920a/export/das14a/satoh-lab/haolin/nhk/excerpts/2002_09_16_19_00_1.webm;Junichiro KOIZUMI.jpg;5013;5809;43853;167;193;26
/net/per920a/export/das14a/satoh-lab/haolin/nhk/excerpts/2002_09_16_19_00_1.webm;Junichiro KOIZUMI.jpg;6669;7133;43853;222;237;15
/net/per920a/export/das14a/satoh-lab/haolin/nhk/excerpts/2002_09_16_19_00_1.webm;Junichiro KOIZUMI.jpg;7153;7153;43853;238;238;0
/net/per920a/export/das14a/satoh-lab/haolin/nhk/excerpts/2002_09_16_19_00_1.webm;Junichiro KOIZUMI.jpg;7177;7177;43853;239;239;0
/net/per920a/export/das14a/satoh-lab/haolin/nhk/excerpts/2002_09_16_19_00_1.webm;Junichiro KOIZUMI.jpg;7201;7209;43853;240;240;0
/net/per920a/export/das14a/satoh-lab/haolin/nhk/excerpts/2002_09_16_19_00_1.webm;Junichiro KOIZUMI.jpg;7221;7221;43853;240;240;0
/net/per920a/export/das14a/satoh-lab/haolin/nhk/excerpts/2002_09_16_19_00_1.webm;Junichiro KOIZUMI.jpg;7233;7485;43853;241;249;8
/net/per920a/export/das14a/satoh-lab/haolin/nhk/excerpts/2002_09_16_19_00_1.webm;Junichiro KOIZUMI.jpg;8389;8877;43853;279;296;17
/net/per920a/export/das14a/satoh-lab/haolin/nhk/excerpts/2002_09_16_19_00_1.webm;Junichiro KOIZUMI.jpg;8893;9145;43853;296;305;9
/net/per920a/export/das14a/satoh-lab/haolin/nhk/excerpts/2002_09_16_19_00_1.webm;Junichiro KOIZUMI.jpg;9157;9573;43853;305;319;14
/net/per920a/export/das14a/satoh-lab/haolin/nhk/excerpts/2002_09_16_19_00_1.webm;Junichiro KOIZUMI.jpg;13061;13541;43853;435;451;16
/net/per920a/export/das14a/satoh-lab/haolin/nhk/excerpts/2002_09_16_19_00_1.webm;Junichiro KOIZUMI.jpg;19541;19917;43853;651;664;13
/net/per920a/export/das14a/satoh-lab/haolin/nhk/excerpts/2002_09_16_19_00_1.webm;Junichiro KOIZUMI.jpg;26589;27097;43853;887;903;16
/net/per920a/export/das14a/satoh-lab/haolin/nhk/excerpts/2002_09_16_19_00_1.webm;Junichiro KOIZUMI.jpg;33765;34169;43853;1126;1139;13
/net/per920a/export/das14a/satoh-lab/haolin/nhk/excerpts/2002_09_16_19_00_1.webm;Junichiro KOIZUMI.jpg;34185;34205;43853;1140;1141;1
/net/per920a/export/das14a/satoh-lab/haolin/nhk/excerpts/2002_09_16_19_00_1.webm;Junichiro KOIZUMI.jpg;34277;34805;43853;1143;1161;18
/net/per920a/export/das14a/satoh-lab/haolin/nhk/excerpts/2002_09_16_19_00_1.webm;Junichiro KOIZUMI.jpg;34821;34921;43853;1161;1165;4
/net/per920a/export/das14a/satoh-lab/haolin/nhk/excerpts/2002_09_16_19_00_1.webm;Junichiro KOIZUMI.jpg;42605;42629;43853;1421;1422;1
/net/per920a/export/das14a/satoh-lab/haolin/nhk/excerpts/2002_09_16_19_00_1.webm;Junichiro KOIZUMI.jpg;42641;42765;43853;1422;1426;4
/net/per920a/export/das14a/satoh-lab/haolin/nhk/excerpts/2002_09_23_19_00_2.webm;Junichiro KOIZUMI.jpg;1461;1497;6153;48;49;1
/net/per920a/export/das14a/satoh-lab/haolin/nhk/excerpts/2002_09_23_19_00_2.webm;Junichiro KOIZUMI.jpg;1509;1581;6153;50;52;2
/net/per920a/export/das14a/satoh-lab/haolin/nhk/excerpts/2002_09_23_19_00_2.webm;Junichiro KOIZUMI.jpg;2393;2437;6153;79;81;2
/net/per920a/export/das14a/satoh-lab/haolin/nhk/excerpts/2002_09_23_19_00_2.webm;Junichiro KOIZUMI.jpg;2473;2789;6153;82;92;10
/net/per920a/export/das14a/satoh-lab/haolin/nhk/excerpts/2002_09_23_19_00_2.webm;Junichiro KOIZUMI.jpg;4285;4321;6153;142;143;1
/net/per920a/export/das14a/satoh-lab/haolin/nhk/excerpts/2002_09_23_19_00_2.webm;Junichiro KOIZUMI.jpg;4333;4385;6153;144;146;2
/net/per920a/export/das14a/satoh-lab/haolin/nhk/excerpts/2002_09_30_19_00_1.webm;Ichiro OZAWA.jpg;1897;2021;7829;63;67;4
/net/per920a/export/das14a/satoh-lab/haolin/nhk/excerpts/2002_09_30_19_00_1.webm;Ichiro OZAWA.jpg;6169;6169;7829;205;205;0
/net/per920a/export/das14a/satoh-lab/haolin/nhk/excerpts/2002_09_30_19_00_1.webm;Ichiro OZAWA.jpg;6193;6377;7829;206;212;6
/net/per920a/export/das14a/satoh-lab/haolin/nhk/excerpts/2002_09_30_19_00_1.webm;Ichiro OZAWA.jpg;6393;6769;7829;213;225;12
/net/per920a/export/das14a/satoh-lab/haolin/nhk/excerpts/2002_09_30_19_00_1.webm;Shizuka KAMEI.jpg;2073;2081;7829;69;69;0
/net/per920a/export/das14a/satoh-lab/haolin/nhk/excerpts/2002_09_30_19_00_1.webm;Shizuka KAMEI.jpg;2129;2161;7829;70;72;2
/net/per920a/export/das14a/satoh-lab/haolin/nhk/excerpts/2002_09_30_19_00_1.webm;Shizuka KAMEI.jpg;2229;2233;7829;74;74;0
/net/per920a/export/das14a/satoh-lab/haolin/nhk/excerpts/2002_09_30_19_00_1.webm;Shizuka KAMEI.jpg;2281;2297;7829;76;76;0
/net/per920a/export/das14a/satoh-lab/haolin/nhk/excerpts/2002_09_30_19_00_1.webm;Shizuka KAMEI.jpg;2309;2313;7829;76;77;1
/net/per920a/export/das14a/satoh-lab/haolin/nhk/excerpts/2002_09_30_19_00_1.webm;Shizuka KAMEI.jpg;2333;2333;7829;77;77;0
/net/per920a/export/das14a/satoh-lab/haolin/nhk/excerpts/2002_09_30_19_00_1.webm;Shizuka KAMEI.jpg;2345;2349;7829;78;78;0
/net/per920a/export/das14a/satoh-lab/haolin/nhk/excerpts/2002_09_30_19_00_1.webm;Shizuka KAMEI.jpg;2429;2433;7829;80;81;1
/net/per920a/export/das14a/satoh-lab/haolin/nhk/excerpts/2002_09_30_19_00_1.webm;Shizuka KAMEI.jpg;2545;2549;7829;84;84;0
/net/per920a/export/das14a/satoh-lab/haolin/nhk/excerpts/2002_09_30_19_00_1.webm;Shizuka KAMEI.jpg;2609;2609;7829;86;86;0
/net/per920a/export/das14a/satoh-lab/haolin/nhk/excerpts/2002_09_30_19_00_1.webm;Shizuka KAMEI.jpg;2629;2633;7829;87;87;0
/net/per920a/export/das14a/satoh-lab/haolin/nhk/excerpts/2002_09_30_19_00_1.webm;Shizuka KAMEI.jpg;2669;2705;7829;88;90;2
/net/per920a/export/das14a/satoh-lab/haolin/nhk/excerpts/2002_09_30_19_00_1.webm;Shizuka KAMEI.jpg;2721;2733;7829;90;91;1
/net/per920a/export/das14a/satoh-lab/haolin/nhk/excerpts/2002_09_30_19_00_1.webm;Takenori KANZAKI.jpg;4085;4097;7829;136;136;0
/net/per920a/export/das14a/satoh-lab/haolin/nhk/excerpts/2002_09_30_19_00_1.webm;Takenori KANZAKI.jpg;4117;4129;7829;137;137;0
/net/per920a/export/das14a/satoh-lab/haolin/nhk/excerpts/2002_09_30_19_00_1.webm;Takenori KANZAKI.jpg;4145;4149;7829;138;138;0
/net/per920a/export/das14a/satoh-lab/haolin/nhk/excerpts/2002_09_30_19_00_1.webm;Takenori KANZAKI.jpg;4185;4185;7829;139;139;0
/net/per920a/export/das14a/satoh-lab/haolin/nhk/excerpts/2002_09_30_19_00_1.webm;Takenori KANZAKI.jpg;4205;4225;7829;140;140;0
/net/per920a/export/das14a/satoh-lab/haolin/nhk/excerpts/2002_09_30_19_00_1.webm;Takenori KANZAKI.jpg;4241;4261;7829;141;142;1
/net/per920a/export/das14a/satoh-lab/haolin/nhk/excerpts/2002_09_30_19_00_1.webm;Takenori KANZAKI.jpg;4285;4337;7829;142;144;2
/net/per920a/export/das14a/satoh-lab/haolin/nhk/excerpts/2002_09_30_19_00_1.webm;Takenori KANZAKI.jpg;4361;4389;7829;145;146;1
/net/per920a/export/das14a/satoh-lab/haolin/nhk/excerpts/2002_09_30_19_00_1.webm;Takenori KANZAKI.jpg;4405;4405;7829;146;146;0
/net/per920a/export/das14a/satoh-lab/haolin/nhk/excerpts/2002_09_30_19_00_1.webm;Takenori KANZAKI.jpg;4421;4441;7829;147;148;1
/net/per920a/export/das14a/satoh-lab/haolin/nhk/excerpts/2002_09_30_19_00_1.webm;Takenori KANZAKI.jpg;4457;4477;7829;148;149;1
/net/per920a/export/das14a/satoh-lab/haolin/nhk/excerpts/2002_09_30_19_00_1.webm;Takenori KANZAKI.jpg;4489;4493;7829;149;149;0
/net/per920a/export/das14a/satoh-lab/haolin/nhk/excerpts/2002_09_30_19_00_1.webm;Takenori KANZAKI.jpg;4517;4533;7829;150;151;1
/net/per920a/export/das14a/satoh-lab/haolin/nhk/excerpts/2002_09_30_19_00_1.webm;Takenori KANZAKI.jpg;4549;4557;7829;151;151;0
/net/per920a/export/das14a/satoh-lab/haolin/nhk/excerpts/2002_09_30_19_00_1.webm;Takenori KANZAKI.jpg;4617;4621;7829;153;154;1
/net/per920a/export/das14a/satoh-lab/haolin/nhk/excerpts/2002_09_30_19_00_1.webm;Takenori KANZAKI.jpg;4637;4641;7829;154;154;0
/net/per920a/export/das14a/satoh-lab/haolin/nhk/excerpts/2002_09_30_19_00_1.webm;Takenori KANZAKI.jpg;4657;4657;7829;155;155;0
/net/per920a/export/das14a/satoh-lab/haolin/nhk/excerpts/2002_09_30_19_00_1.webm;Takenori KANZAKI.jpg;4677;4685;7829;155;156;1
/net/per920a/export/das14a/satoh-lab/haolin/nhk/excerpts/2002_09_30_19_00_1.webm;Takenori KANZAKI.jpg;4721;4729;7829;157;157;0
/net/per920a/export/das14a/satoh-lab/haolin/nhk/excerpts/2002_09_30_19_00_1.webm;Yukio HATOYAMA.jpg;5493;5589;7829;183;186;3
/net/per920a/export/das14a/satoh-lab/haolin/nhk/excerpts/2002_09_30_19_00_1.webm;Yukio HATOYAMA.jpg;5605;6065;7829;186;202;16
/net/per920a/export/das14a/satoh-lab/haolin/nhk/excerpts/2002_09_30_19_00_1.webm;Yukio HATOYAMA.jpg;6081;6121;7829;202;204;2
/net/per920a/export/das14a/satoh-lab/haolin/nhk/excerpts/2002_09_30_19_00_1.webm;Kazuo SHII.jpg;6785;7153;7829;226;238;12
/net/per920a/export/das14a/satoh-lab/haolin/nhk/excerpts/2002_09_30_19_00_1.webm;Kazuo SHII.jpg;7169;7757;7829;238;258;20
/net/per920a/export/das14a/satoh-lab/haolin/nhk/excerpts/2002_09_30_19_00_1.webm;Junichiro KOIZUMI.jpg;7777;7825;7829;259;260;1
/net/per920a/export/das14a/satoh-lab/haolin/nhk/excerpts/2002_10_03_19_00_2.webm;Junichiro KOIZUMI.jpg;445;845;6869;14;28;14
/net/per920a/export/das14a/satoh-lab/haolin/nhk/excerpts/2002_10_03_19_00_2.webm;Yasuo FUKUDA.jpg;861;861;6869;28;28;0
/net/per920a/export/das14a/satoh-lab/haolin/nhk/excerpts/2002_10_03_19_00_2.webm;Yasuo FUKUDA.jpg;877;897;6869;29;29;0
/net/per920a/export/das14a/satoh-lab/haolin/nhk/excerpts/2002_10_03_19_00_2.webm;Yasuo FUKUDA.jpg;913;1053;6869;30;35;5
/net/per920a/export/das14a/satoh-lab/haolin/nhk/excerpts/2002_10_03_19_00_2.webm;Yasuo FUKUDA.jpg;1073;1105;6869;35;36;1
/net/per920a/export/das14a/satoh-lab/haolin/nhk/excerpts/2002_10_03_19_00_2.webm;Yasuo FUKUDA.jpg;1121;1137;6869;37;37;0
/net/per920a/export/das14a/satoh-lab/haolin/nhk/excerpts/2002_10_03_19_00_2.webm;Yasuo FUKUDA.jpg;1153;1689;6869;38;56;18
/net/per920a/export/das14a/satoh-lab/haolin/nhk/excerpts/2002_10_03_19_00_2.webm;Shinzo ABE.jpg;1701;1701;6869;56;56;0
/net/per920a/export/das14a/satoh-lab/haolin/nhk/excerpts/2002_10_03_19_00_2.webm;Shinzo ABE.jpg;1741;1797;6869;58;59;1
/net/per920a/export/das14a/satoh-lab/haolin/nhk/excerpts/2002_10_03_19_00_2.webm;Shinzo ABE.jpg;1809;1825;6869;60;60;0
/net/per920a/export/das14a/satoh-lab/haolin/nhk/excerpts/2002_10_03_19_00_2.webm;Shinzo ABE.jpg;1841;1857;6869;61;61;0
/net/per920a/export/das14a/satoh-lab/haolin/nhk/excerpts/2002_10_03_19_00_2.webm;Shinzo ABE.jpg;1873;1917;6869;62;63;1
/net/per920a/export/das14a/satoh-lab/haolin/nhk/excerpts/2002_10_03_19_00_2.webm;Shinzo ABE.jpg;1937;1941;6869;64;64;0
/net/per920a/export/das14a/satoh-lab/haolin/nhk/excerpts/2002_10_03_19_00_2.webm;Shinzo ABE.jpg;1953;1957;6869;65;65;0
/net/per920a/export/das14a/satoh-lab/haolin/nhk/excerpts/2002_10_03_19_00_2.webm;Shinzo ABE.jpg;1985;1985;6869;66;66;0
/net/per920a/export/das14a/satoh-lab/haolin/nhk/excerpts/2002_10_03_19_00_2.webm;Shinzo ABE.jpg;2009;2125;6869;66;70;4
/net/per920a/export/das14a/satoh-lab/haolin/nhk/excerpts/2002_10_03_19_00_2.webm;Shinzo ABE.jpg;2141;2141;6869;71;71;0
/net/per920a/export/das14a/satoh-lab/haolin/nhk/excerpts/2002_10_03_19_00_2.webm;Shinzo ABE.jpg;2173;2177;6869;72;72;0
/net/per920a/export/das14a/satoh-lab/haolin/nhk/excerpts/2002_10_03_19_00_2.webm;Shinzo ABE.jpg;2209;2209;6869;73;73;0
/net/per920a/export/das14a/satoh-lab/haolin/nhk/excerpts/2002_10_03_19_00_2.webm;Shinzo ABE.jpg;2229;2237;6869;74;74;0
/net/per920a/export/das14a/satoh-lab/haolin/nhk/excerpts/2002_10_03_19_00_2.webm;Shinzo ABE.jpg;2253;2253;6869;75;75;0
/net/per920a/export/das14a/satoh-lab/haolin/nhk/excerpts/2002_10_03_19_00_2.webm;Shinzo ABE.jpg;2265;2337;6869;75;77;2
/net/per920a/export/das14a/satoh-lab/haolin/nhk/excerpts/2002_10_03_19_00_2.webm;Shinzo ABE.jpg;2357;2361;6869;78;78;0
/net/per920a/export/das14a/satoh-lab/haolin/nhk/excerpts/2002_10_03_19_00_2.webm;Shinzo ABE.jpg;2373;2417;6869;79;80;1
/net/per920a/export/das14a/satoh-lab/haolin/nhk/excerpts/2002_10_03_19_00_2.webm;Shinzo ABE.jpg;2433;2449;6869;81;81;0
/net/per920a/export/das14a/satoh-lab/haolin/nhk/excerpts/2002_10_03_19_00_2.webm;Shinzo ABE.jpg;2461;2501;6869;82;83;1
/net/per920a/export/das14a/satoh-lab/haolin/nhk/excerpts/2002_10_03_19_00_2.webm;Yukio EDANO.jpg;4901;4997;6869;163;166;3
/net/per920a/export/das14a/satoh-lab/haolin/nhk/excerpts/2002_10_03_19_00_2.webm;Shizuka KAMEI.jpg;5253;5393;6869;175;179;4
/net/per920a/export/das14a/satoh-lab/haolin/nhk/excerpts/2002_10_03_19_00_2.webm;Shizuka KAMEI.jpg;5409;5469;6869;180;182;2
/net/per920a/export/das14a/satoh-lab/haolin/nhk/excerpts/2002_10_03_19_00_2.webm;Shizuka KAMEI.jpg;5493;5589;6869;183;186;3
/net/per920a/export/das14a/satoh-lab/haolin/nhk/excerpts/2002_10_03_19_00_2.webm;Shizuka KAMEI.jpg;5605;5625;6869;186;187;1
/net/per920a/export/das14a/satoh-lab/haolin/nhk/excerpts/2002_10_03_19_00_2.webm;Shizuka KAMEI.jpg;5641;5721;6869;188;190;2
/net/per920a/export/das14a/satoh-lab/haolin/nhk/excerpts/2002_10_12_19_00_1.webm;Junichiro KOIZUMI.jpg;9421;9661;14033;314;322;8
/net/per920a/export/das14a/satoh-lab/haolin/nhk/excerpts/2002_10_12_19_00_1.webm;Junichiro KOIZUMI.jpg;9677;9821;14033;322;327;5
/net/per920a/export/das14a/satoh-lab/haolin/nhk/excerpts/2002_10_12_19_00_1.webm;Junichiro KOIZUMI.jpg;9837;9845;14033;328;328;0
/net/per920a/export/das14a/satoh-lab/haolin/nhk/excerpts/2002_10_12_19_00_1.webm;Junichiro KOIZUMI.jpg;9881;10189;14033;329;339;10
/net/per920a/export/das14a/satoh-lab/haolin/nhk/excerpts/2002_10_12_19_00_1.webm;Junichiro KOIZUMI.jpg;10313;10353;14033;343;345;2
/net/per920a/export/das14a/satoh-lab/haolin/nhk/excerpts/2002_10_12_19_00_1.webm;Junichiro KOIZUMI.jpg;10365;10401;14033;345;346;1
/net/per920a/export/das14a/satoh-lab/haolin/nhk/excerpts/2002_10_12_19_00_1.webm;Junichiro KOIZUMI.jpg;10413;10437;14033;347;348;1
/net/per920a/export/das14a/satoh-lab/haolin/nhk/excerpts/2002_10_12_19_00_1.webm;Junichiro KOIZUMI.jpg;10453;10513;14033;348;350;2
/net/per920a/export/das14a/satoh-lab/haolin/nhk/excerpts/2002_10_12_19_00_1.webm;Junichiro KOIZUMI.jpg;10989;11009;14033;366;367;1
/net/per920a/export/das14a/satoh-lab/haolin/nhk/excerpts/2002_10_12_19_00_1.webm;Junichiro KOIZUMI.jpg;11021;11029;14033;367;367;0
/net/per920a/export/das14a/satoh-lab/haolin/nhk/excerpts/2002_10_12_19_00_1.webm;Junichiro KOIZUMI.jpg;11045;11069;14033;368;369;1
/net/per920a/export/das14a/satoh-lab/haolin/nhk/excerpts/2002_10_12_19_00_1.webm;Junichiro KOIZUMI.jpg;11245;11313;14033;375;377;2
/net/per920a/export/das14a/satoh-lab/haolin/nhk/excerpts/2002_10_12_19_00_1.webm;Junichiro KOIZUMI.jpg;11333;11361;14033;377;378;1
/net/per920a/export/das14a/satoh-lab/haolin/nhk/excerpts/2002_10_12_19_00_1.webm;Junichiro KOIZUMI.jpg;11385;11397;14033;379;380;1
/net/per920a/export/das14a/satoh-lab/haolin/nhk/excerpts/2002_10_12_19_00_1.webm;Junichiro KOIZUMI.jpg;11409;11513;14033;380;383;3
/net/per920a/export/das14a/satoh-lab/haolin/nhk/excerpts/2002_10_20_19_00_2.webm;Junichiro KOIZUMI.jpg;2281;2281;3209;76;76;0
/net/per920a/export/das14a/satoh-lab/haolin/nhk/excerpts/2002_10_20_19_00_2.webm;Junichiro KOIZUMI.jpg;2309;2313;3209;76;77;1
/net/per920a/export/das14a/satoh-lab/haolin/nhk/excerpts/2002_10_20_19_00_2.webm;Junichiro KOIZUMI.jpg;2333;2333;3209;77;77;0
/net/per920a/export/das14a/satoh-lab/haolin/nhk/excerpts/2002_10_20_19_00_2.webm;Junichiro KOIZUMI.jpg;2345;2345;3209;78;78;0
/net/per920a/export/das14a/satoh-lab/haolin/nhk/excerpts/2002_10_20_19_00_2.webm;Junichiro KOIZUMI.jpg;2357;2361;3209;78;78;0
/net/per920a/export/das14a/satoh-lab/haolin/nhk/excerpts/2002_10_20_19_00_2.webm;Junichiro KOIZUMI.jpg;2373;2373;3209;79;79;0
/net/per920a/export/das14a/satoh-lab/haolin/nhk/excerpts/2002_10_20_19_00_2.webm;Junichiro KOIZUMI.jpg;2385;2417;3209;79;80;1
/net/per920a/export/das14a/satoh-lab/haolin/nhk/excerpts/2002_10_20_19_00_2.webm;Shinzo ABE.jpg;2345;2345;3209;78;78;0
/net/per920a/export/das14a/satoh-lab/haolin/nhk/excerpts/2002_10_20_19_00_2.webm;Shinzo ABE.jpg;2357;2357;3209;78;78;0
/net/per920a/export/das14a/satoh-lab/haolin/nhk/excerpts/2002_10_20_19_00_2.webm;Shinzo ABE.jpg;2413;2417;3209;80;80;0
/net/per920a/export/das14a/satoh-lab/haolin/nhk/excerpts/2002_10_20_19_00_2.webm;Shinzo ABE.jpg;2445;2449;3209;81;81;0
/net/per920a/export/das14a/satoh-lab/haolin/nhk/excerpts/2002_10_27_19_00_3.webm;Junichiro KOIZUMI.jpg;821;833;2133;27;27;0
/net/per920a/export/das14a/satoh-lab/haolin/nhk/excerpts/2002_10_27_19_00_3.webm;Junichiro KOIZUMI.jpg;849;873;2133;28;29;1
/net/per920a/export/das14a/satoh-lab/haolin/nhk/excerpts/2002_11_03_19_00_1.webm;Yukio HATOYAMA.jpg;1593;1617;1625;52;53;1
/net/per920a/export/das14a/satoh-lab/haolin/nhk/excerpts/2002_11_03_19_00_3.webm;Junichiro KOIZUMI.jpg;905;921;1597;30;30;0
/net/per920a/export/das14a/satoh-lab/haolin/nhk/excerpts/2002_11_03_19_00_3.webm;Junichiro KOIZUMI.jpg;945;989;1597;31;32;1
/net/per920a/export/das14a/satoh-lab/haolin/nhk/excerpts/2002_11_03_19_00_3.webm;Junichiro KOIZUMI.jpg;1117;1517;1597;37;50;13
/net/per920a/export/das14a/satoh-lab/haolin/nhk/excerpts/2002_11_04_19_00_1.webm;Junichiro KOIZUMI.jpg;77;81;29501;2;2;0
/net/per920a/export/das14a/satoh-lab/haolin/nhk/excerpts/2002_11_04_19_00_1.webm;Junichiro KOIZUMI.jpg;105;117;29501;3;3;0
/net/per920a/export/das14a/satoh-lab/haolin/nhk/excerpts/2002_11_04_19_00_1.webm;Junichiro KOIZUMI.jpg;145;145;29501;4;4;0
/net/per920a/export/das14a/satoh-lab/haolin/nhk/excerpts/2002_11_04_19_00_1.webm;Junichiro KOIZUMI.jpg;161;169;29501;5;5;0
/net/per920a/export/das14a/satoh-lab/haolin/nhk/excerpts/2002_11_04_19_00_1.webm;Junichiro KOIZUMI.jpg;181;185;29501;6;6;0
/net/per920a/export/das14a/satoh-lab/haolin/nhk/excerpts/2002_11_04_19_00_1.webm;Junichiro KOIZUMI.jpg;197;201;29501;6;6;0
/net/per920a/export/das14a/satoh-lab/haolin/nhk/excerpts/2002_11_04_19_00_1.webm;Junichiro KOIZUMI.jpg;221;221;29501;7;7;0
/net/per920a/export/das14a/satoh-lab/haolin/nhk/excerpts/2002_11_04_19_00_1.webm;Junichiro KOIZUMI.jpg;237;237;29501;7;7;0
/net/per920a/export/das14a/satoh-lab/haolin/nhk/excerpts/2002_11_04_19_00_1.webm;Junichiro KOIZUMI.jpg;249;253;29501;8;8;0
/net/per920a/export/das14a/satoh-lab/haolin/nhk/excerpts/2002_11_04_19_00_1.webm;Junichiro KOIZUMI.jpg;265;281;29501;8;9;1
/net/per920a/export/das14a/satoh-lab/haolin/nhk/excerpts/2002_11_04_19_00_1.webm;Junichiro KOIZUMI.jpg;441;441;29501;14;14;0
/net/per920a/export/das14a/satoh-lab/haolin/nhk/excerpts/2002_11_04_19_00_1.webm;Junichiro KOIZUMI.jpg;473;473;29501;15;15;0
/net/per920a/export/das14a/satoh-lab/haolin/nhk/excerpts/2002_11_04_19_00_1.webm;Junichiro KOIZUMI.jpg;485;497;29501;16;16;0
/net/per920a/export/das14a/satoh-lab/haolin/nhk/excerpts/2002_11_04_19_00_1.webm;Junichiro KOIZUMI.jpg;517;537;29501;17;17;0
/net/per920a/export/das14a/satoh-lab/haolin/nhk/excerpts/2002_11_04_19_00_1.webm;Junichiro KOIZUMI.jpg;549;589;29501;18;19;1
/net/per920a/export/das14a/satoh-lab/haolin/nhk/excerpts/2002_11_04_19_00_1.webm;Junichiro KOIZUMI.jpg;609;613;29501;20;20;0
/net/per920a/export/das14a/satoh-lab/haolin/nhk/excerpts/2002_11_04_19_00_1.webm;Junichiro KOIZUMI.jpg;625;633;29501;20;21;1
/net/per920a/export/das14a/satoh-lab/haolin/nhk/excerpts/2002_11_04_19_00_1.webm;Junichiro KOIZUMI.jpg;657;661;29501;21;22;1
/net/per920a/export/das14a/satoh-lab/haolin/nhk/excerpts/2002_11_04_19_00_1.webm;Junichiro KOIZUMI.jpg;689;693;29501;22;23;1
/net/per920a/export/das14a/satoh-lab/haolin/nhk/excerpts/2002_11_04_19_00_1.webm;Junichiro KOIZUMI.jpg;709;717;29501;23;23;0
/net/per920a/export/das14a/satoh-lab/haolin/nhk/excerpts/2002_11_04_19_00_1.webm;Junichiro KOIZUMI.jpg;741;741;29501;24;24;0
/net/per920a/export/das14a/satoh-lab/haolin/nhk/excerpts/2002_11_04_19_00_1.webm;Junichiro KOIZUMI.jpg;761;765;29501;25;25;0
/net/per920a/export/das14a/satoh-lab/haolin/nhk/excerpts/2002_11_04_19_00_1.webm;Junichiro KOIZUMI.jpg;777;777;29501;25;25;0
/net/per920a/export/das14a/satoh-lab/haolin/nhk/excerpts/2002_11_04_19_00_1.webm;Junichiro KOIZUMI.jpg;789;801;29501;26;26;0
/net/per920a/export/das14a/satoh-lab/haolin/nhk/excerpts/2002_11_04_19_00_1.webm;Junichiro KOIZUMI.jpg;813;821;29501;27;27;0
/net/per920a/export/das14a/satoh-lab/haolin/nhk/excerpts/2002_11_04_19_00_1.webm;Junichiro KOIZUMI.jpg;841;841;29501;28;28;0
/net/per920a/export/das14a/satoh-lab/haolin/nhk/excerpts/2002_11_04_19_00_1.webm;Junichiro KOIZUMI.jpg;861;865;29501;28;28;0
/net/per920a/export/das14a/satoh-lab/haolin/nhk/excerpts/2002_11_04_19_00_1.webm;Junichiro KOIZUMI.jpg;881;881;29501;29;29;0
/net/per920a/export/das14a/satoh-lab/haolin/nhk/excerpts/2002_11_04_19_00_1.webm;Junichiro KOIZUMI.jpg;901;905;29501;30;30;0
/net/per920a/export/das14a/satoh-lab/haolin/nhk/excerpts/2002_11_04_19_00_1.webm;Junichiro KOIZUMI.jpg;933;937;29501;31;31;0
/net/per920a/export/das14a/satoh-lab/haolin/nhk/excerpts/2002_11_04_19_00_1.webm;Junichiro KOIZUMI.jpg;953;961;29501;31;32;1
/net/per920a/export/das14a/satoh-lab/haolin/nhk/excerpts/2002_11_04_19_00_1.webm;Junichiro KOIZUMI.jpg;985;985;29501;32;32;0
/net/per920a/export/das14a/satoh-lab/haolin/nhk/excerpts/2002_11_04_19_00_1.webm;Junichiro KOIZUMI.jpg;1013;1013;29501;33;33;0
/net/per920a/export/das14a/satoh-lab/haolin/nhk/excerpts/2002_11_04_19_00_1.webm;Junichiro KOIZUMI.jpg;1025;1029;29501;34;34;0
/net/per920a/export/das14a/satoh-lab/haolin/nhk/excerpts/2002_11_04_19_00_1.webm;Junichiro KOIZUMI.jpg;2257;2265;29501;75;75;0
/net/per920a/export/das14a/satoh-lab/haolin/nhk/excerpts/2002_11_04_19_00_1.webm;Junichiro KOIZUMI.jpg;2313;2321;29501;77;77;0
/net/per920a/export/das14a/satoh-lab/haolin/nhk/excerpts/2002_11_04_19_00_1.webm;Junichiro KOIZUMI.jpg;2337;2361;29501;77;78;1
/net/per920a/export/das14a/satoh-lab/haolin/nhk/excerpts/2002_11_04_19_00_1.webm;Junichiro KOIZUMI.jpg;2385;2409;29501;79;80;1
/net/per920a/export/das14a/satoh-lab/haolin/nhk/excerpts/2002_11_04_19_00_1.webm;Junichiro KOIZUMI.jpg;2425;2453;29501;80;81;1
/net/per920a/export/das14a/satoh-lab/haolin/nhk/excerpts/2002_11_04_19_00_1.webm;Junichiro KOIZUMI.jpg;2469;2501;29501;82;83;1
/net/per920a/export/das14a/satoh-lab/haolin/nhk/excerpts/2002_11_04_19_00_1.webm;Junichiro KOIZUMI.jpg;2517;2565;29501;83;85;2
/net/per920a/export/das14a/satoh-lab/haolin/nhk/excerpts/2002_11_04_19_00_1.webm;Junichiro KOIZUMI.jpg;3669;3825;29501;122;127;5
/net/per920a/export/das14a/satoh-lab/haolin/nhk/excerpts/2002_11_04_19_00_1.webm;Ichiro OZAWA.jpg;105;117;29501;3;3;0
/net/per920a/export/das14a/satoh-lab/haolin/nhk/excerpts/2002_11_04_19_00_1.webm;Ichiro OZAWA.jpg;145;145;29501;4;4;0
/net/per920a/export/das14a/satoh-lab/haolin/nhk/excerpts/2002_11_04_19_00_1.webm;Ichiro OZAWA.jpg;161;169;29501;5;5;0
/net/per920a/export/das14a/satoh-lab/haolin/nhk/excerpts/2002_11_04_19_00_1.webm;Ichiro OZAWA.jpg;181;185;29501;6;6;0
/net/per920a/export/das14a/satoh-lab/haolin/nhk/excerpts/2002_11_04_19_00_1.webm;Ichiro OZAWA.jpg;197;201;29501;6;6;0
/net/per920a/export/das14a/satoh-lab/haolin/nhk/excerpts/2002_11_04_19_00_1.webm;Ichiro OZAWA.jpg;221;221;29501;7;7;0
/net/per920a/export/das14a/satoh-lab/haolin/nhk/excerpts/2002_11_04_19_00_1.webm;Ichiro OZAWA.jpg;237;237;29501;7;7;0
/net/per920a/export/das14a/satoh-lab/haolin/nhk/excerpts/2002_11_04_19_00_1.webm;Ichiro OZAWA.jpg;249;253;29501;8;8;0
/net/per920a/export/das14a/satoh-lab/haolin/nhk/excerpts/2002_11_04_19_00_1.webm;Ichiro OZAWA.jpg;265;281;29501;8;9;1
/net/per920a/export/das14a/satoh-lab/haolin/nhk/excerpts/2002_11_04_19_00_1.webm;Ichiro OZAWA.jpg;441;441;29501;14;14;0
/net/per920a/export/das14a/satoh-lab/haolin/nhk/excerpts/2002_11_04_19_00_1.webm;Ichiro OZAWA.jpg;473;473;29501;15;15;0
/net/per920a/export/das14a/satoh-lab/haolin/nhk/excerpts/2002_11_04_19_00_1.webm;Ichiro OZAWA.jpg;485;497;29501;16;16;0
/net/per920a/export/das14a/satoh-lab/haolin/nhk/excerpts/2002_11_04_19_00_1.webm;Ichiro OZAWA.jpg;517;537;29501;17;17;0
/net/per920a/export/das14a/satoh-lab/haolin/nhk/excerpts/2002_11_04_19_00_1.webm;Ichiro OZAWA.jpg;549;589;29501;18;19;1
/net/per920a/export/das14a/satoh-lab/haolin/nhk/excerpts/2002_11_04_19_00_1.webm;Ichiro OZAWA.jpg;609;613;29501;20;20;0
/net/per920a/export/das14a/satoh-lab/haolin/nhk/excerpts/2002_11_04_19_00_1.webm;Ichiro OZAWA.jpg;625;633;29501;20;21;1
/net/per920a/export/das14a/satoh-lab/haolin/nhk/excerpts/2002_11_04_19_00_1.webm;Ichiro OZAWA.jpg;657;661;29501;21;22;1
/net/per920a/export/das14a/satoh-lab/haolin/nhk/excerpts/2002_11_04_19_00_1.webm;Ichiro OZAWA.jpg;689;693;29501;22;23;1
/net/per920a/export/das14a/satoh-lab/haolin/nhk/excerpts/2002_11_04_19_00_1.webm;Ichiro OZAWA.jpg;709;717;29501;23;23;0
/net/per920a/export/das14a/satoh-lab/haolin/nhk/excerpts/2002_11_04_19_00_1.webm;Ichiro OZAWA.jpg;741;741;29501;24;24;0
/net/per920a/export/das14a/satoh-lab/haolin/nhk/excerpts/2002_11_04_19_00_1.webm;Ichiro OZAWA.jpg;761;765;29501;25;25;0
/net/per920a/export/das14a/satoh-lab/haolin/nhk/excerpts/2002_11_04_19_00_1.webm;Ichiro OZAWA.jpg;777;777;29501;25;25;0
/net/per920a/export/das14a/satoh-lab/haolin/nhk/excerpts/2002_11_04_19_00_1.webm;Ichiro OZAWA.jpg;789;801;29501;26;26;0
/net/per920a/export/das14a/satoh-lab/haolin/nhk/excerpts/2002_11_04_19_00_1.webm;Ichiro OZAWA.jpg;813;821;29501;27;27;0
/net/per920a/export/das14a/satoh-lab/haolin/nhk/excerpts/2002_11_04_19_00_1.webm;Ichiro OZAWA.jpg;841;841;29501;28;28;0
/net/per920a/export/das14a/satoh-lab/haolin/nhk/excerpts/2002_11_04_19_00_1.webm;Ichiro OZAWA.jpg;861;865;29501;28;28;0
/net/per920a/export/das14a/satoh-lab/haolin/nhk/excerpts/2002_11_04_19_00_1.webm;Ichiro OZAWA.jpg;881;881;29501;29;29;0
/net/per920a/export/das14a/satoh-lab/haolin/nhk/excerpts/2002_11_04_19_00_1.webm;Ichiro OZAWA.jpg;901;905;29501;30;30;0
/net/per920a/export/das14a/satoh-lab/haolin/nhk/excerpts/2002_11_04_19_00_1.webm;Ichiro OZAWA.jpg;933;937;29501;31;31;0
/net/per920a/export/das14a/satoh-lab/haolin/nhk/excerpts/2002_11_04_19_00_1.webm;Ichiro OZAWA.jpg;953;961;29501;31;32;1
/net/per920a/export/das14a/satoh-lab/haolin/nhk/excerpts/2002_11_04_19_00_1.webm;Ichiro OZAWA.jpg;985;985;29501;32;32;0
/net/per920a/export/das14a/satoh-lab/haolin/nhk/excerpts/2002_11_04_19_00_1.webm;Ichiro OZAWA.jpg;1013;1013;29501;33;33;0
/net/per920a/export/das14a/satoh-lab/haolin/nhk/excerpts/2002_11_04_19_00_1.webm;Ichiro OZAWA.jpg;1025;1029;29501;34;34;0
/net/per920a/export/das14a/satoh-lab/haolin/nhk/excerpts/2002_11_04_19_00_1.webm;Ichiro OZAWA.jpg;3045;3241;29501;101;108;7
/net/per920a/export/das14a/satoh-lab/haolin/nhk/excerpts/2002_11_04_19_00_1.webm;Ichiro OZAWA.jpg;3329;3437;29501;111;114;3
/net/per920a/export/das14a/satoh-lab/haolin/nhk/excerpts/2002_11_04_19_00_1.webm;Ichiro OZAWA.jpg;3453;3473;29501;115;115;0
/net/per920a/export/das14a/satoh-lab/haolin/nhk/excerpts/2002_11_04_19_00_1.webm;Ichiro OZAWA.jpg;3513;3529;29501;117;117;0
/net/per920a/export/das14a/satoh-lab/haolin/nhk/excerpts/2002_11_04_19_00_1.webm;Ichiro OZAWA.jpg;3545;3569;29501;118;119;1
/net/per920a/export/das14a/satoh-lab/haolin/nhk/excerpts/2002_11_04_19_00_1.webm;Ichiro OZAWA.jpg;3585;3625;29501;119;120;1
/net/per920a/export/das14a/satoh-lab/haolin/nhk/excerpts/2002_11_04_19_00_1.webm;Ichiro OZAWA.jpg;4161;4177;29501;138;139;1
/net/per920a/export/das14a/satoh-lab/haolin/nhk/excerpts/2002_11_04_19_00_1.webm;Ichiro OZAWA.jpg;4193;4265;29501;139;142;3
/net/per920a/export/das14a/satoh-lab/haolin/nhk/excerpts/2002_11_04_19_00_1.webm;Ichiro OZAWA.jpg;4285;4297;29501;142;143;1
/net/per920a/export/das14a/satoh-lab/haolin/nhk/excerpts/2002_11_04_19_00_1.webm;Ichiro OZAWA.jpg;4313;4313;29501;143;143;0
/net/per920a/export/das14a/satoh-lab/haolin/nhk/excerpts/2002_11_04_19_00_1.webm;Ichiro OZAWA.jpg;4581;4609;29501;152;153;1
/net/per920a/export/das14a/satoh-lab/haolin/nhk/excerpts/2002_11_04_19_00_1.webm;Ichiro OZAWA.jpg;4625;4629;29501;154;154;0
/net/per920a/export/das14a/satoh-lab/haolin/nhk/excerpts/2002_11_06_19_00_1.webm;Shinzo ABE.jpg;9893;9925;18165;330;331;1
/net/per920a/export/das14a/satoh-lab/haolin/nhk/excerpts/2002_11_06_19_00_1.webm;Shinzo ABE.jpg;10177;10181;18165;339;339;0
/net/per920a/export/das14a/satoh-lab/haolin/nhk/excerpts/2002_11_06_19_00_1.webm;Shinzo ABE.jpg;10197;10201;18165;340;340;0
/net/per920a/export/das14a/satoh-lab/haolin/nhk/excerpts/2002_11_06_19_00_1.webm;Shinzo ABE.jpg;10841;10861;18165;361;362;1
/net/per920a/export/das14a/satoh-lab/haolin/nhk/excerpts/2002_11_06_19_00_1.webm;Shinzo ABE.jpg;10881;10881;18165;362;362;0
/net/per920a/export/das14a/satoh-lab/haolin/nhk/excerpts/2002_11_06_19_00_1.webm;Shinzo ABE.jpg;10917;10925;18165;364;364;0
/net/per920a/export/das14a/satoh-lab/haolin/nhk/excerpts/2002_11_06_19_00_1.webm;Shinzo ABE.jpg;11273;11313;18165;376;377;1
/net/per920a/export/das14a/satoh-lab/haolin/nhk/excerpts/2002_11_06_19_00_1.webm;Shinzo ABE.jpg;11581;11733;18165;386;391;5
/net/per920a/export/das14a/satoh-lab/haolin/nhk/excerpts/2002_11_06_19_00_1.webm;Shinzo ABE.jpg;11745;11757;18165;391;392;1
/net/per920a/export/das14a/satoh-lab/haolin/nhk/excerpts/2002_11_06_19_00_1.webm;Shinzo ABE.jpg;12281;12301;18165;409;410;1
/net/per920a/export/das14a/satoh-lab/haolin/nhk/excerpts/2002_11_06_19_00_1.webm;Shinzo ABE.jpg;12313;12317;18165;410;410;0
/net/per920a/export/das14a/satoh-lab/haolin/nhk/excerpts/2002_11_06_19_00_1.webm;Shinzo ABE.jpg;12341;12433;18165;411;414;3
/net/per920a/export/das14a/satoh-lab/haolin/nhk/excerpts/2002_11_06_19_00_1.webm;Shinzo ABE.jpg;12449;12449;18165;415;415;0
/net/per920a/export/das14a/satoh-lab/haolin/nhk/excerpts/2002_11_06_19_00_1.webm;Shinzo ABE.jpg;12465;12581;18165;415;419;4
/net/per920a/export/das14a/satoh-lab/haolin/nhk/excerpts/2002_11_06_19_00_1.webm;Shinzo ABE.jpg;12597;12665;18165;420;422;2
/net/per920a/export/das14a/satoh-lab/haolin/nhk/excerpts/2002_11_06_19_00_1.webm;Shinzo ABE.jpg;12685;12685;18165;423;423;0
/net/per920a/export/das14a/satoh-lab/haolin/nhk/excerpts/2002_11_06_19_00_1.webm;Shinzo ABE.jpg;12717;12733;18165;424;424;0
/net/per920a/export/das14a/satoh-lab/haolin/nhk/excerpts/2002_11_06_19_00_1.webm;Shinzo ABE.jpg;12753;12753;18165;425;425;0
/net/per920a/export/das14a/satoh-lab/haolin/nhk/excerpts/2002_11_06_19_00_1.webm;Shinzo ABE.jpg;12769;12777;18165;425;426;1
/net/per920a/export/das14a/satoh-lab/haolin/nhk/excerpts/2002_11_06_19_00_1.webm;Shinzo ABE.jpg;12805;12821;18165;427;427;0
/net/per920a/export/das14a/satoh-lab/haolin/nhk/excerpts/2002_11_06_19_00_1.webm;Shinzo ABE.jpg;12917;12921;18165;430;431;1
/net/per920a/export/das14a/satoh-lab/haolin/nhk/excerpts/2002_11_06_19_00_1.webm;Shinzo ABE.jpg;13093;13125;18165;436;437;1
/net/per920a/export/das14a/satoh-lab/haolin/nhk/excerpts/2002_11_06_19_00_1.webm;Shinzo ABE.jpg;13141;13181;18165;438;439;1
/net/per920a/export/das14a/satoh-lab/haolin/nhk/excerpts/2002_11_06_19_00_1.webm;Shinzo ABE.jpg;13213;13233;18165;440;441;1
/net/per920a/export/das14a/satoh-lab/haolin/nhk/excerpts/2002_11_06_19_00_1.webm;Shinzo ABE.jpg;13245;13249;18165;441;441;0
/net/per920a/export/das14a/satoh-lab/haolin/nhk/excerpts/2002_11_06_19_00_1.webm;Shinzo ABE.jpg;13261;13261;18165;442;442;0
/net/per920a/export/das14a/satoh-lab/haolin/nhk/excerpts/2002_11_06_19_00_1.webm;Shinzo ABE.jpg;13273;13409;18165;442;447;5
/net/per920a/export/das14a/satoh-lab/haolin/nhk/excerpts/2002_11_06_19_00_1.webm;Shinzo ABE.jpg;13429;13429;18165;448;448;0
/net/per920a/export/das14a/satoh-lab/haolin/nhk/excerpts/2002_11_06_19_00_1.webm;Shinzo ABE.jpg;13441;13449;18165;448;448;0
/net/per920a/export/das14a/satoh-lab/haolin/nhk/excerpts/2002_11_06_19_00_1.webm;Shinzo ABE.jpg;13473;13489;18165;449;450;1
/net/per920a/export/das14a/satoh-lab/haolin/nhk/excerpts/2002_11_06_19_00_1.webm;Shinzo ABE.jpg;13509;13513;18165;450;450;0
/net/per920a/export/das14a/satoh-lab/haolin/nhk/excerpts/2002_11_06_19_00_1.webm;Shinzo ABE.jpg;13529;13537;18165;451;451;0
/net/per920a/export/das14a/satoh-lab/haolin/nhk/excerpts/2002_11_06_19_00_1.webm;Shinzo ABE.jpg;13549;13561;18165;452;452;0
/net/per920a/export/das14a/satoh-lab/haolin/nhk/excerpts/2002_11_06_19_00_1.webm;Shinzo ABE.jpg;13573;13589;18165;452;453;1
/net/per920a/export/das14a/satoh-lab/haolin/nhk/excerpts/2002_11_06_19_00_1.webm;Shinzo ABE.jpg;13629;13629;18165;454;454;0
/net/per920a/export/das14a/satoh-lab/haolin/nhk/excerpts/2002_11_06_19_00_1.webm;Shinzo ABE.jpg;13645;13653;18165;455;455;0
/net/per920a/export/das14a/satoh-lab/haolin/nhk/excerpts/2002_11_06_19_00_1.webm;Shinzo ABE.jpg;13701;13701;18165;457;457;0
/net/per920a/export/das14a/satoh-lab/haolin/nhk/excerpts/2002_11_06_19_00_1.webm;Shinzo ABE.jpg;13789;13789;18165;460;460;0
/net/per920a/export/das14a/satoh-lab/haolin/nhk/excerpts/2002_12_02_19_00_1.webm;Yukio HATOYAMA.jpg;33;37;10769;1;1;0
/net/per920a/export/das14a/satoh-lab/haolin/nhk/excerpts/2002_12_02_19_00_1.webm;Yukio HATOYAMA.jpg;53;69;10769;1;2;1
/net/per920a/export/das14a/satoh-lab/haolin/nhk/excerpts/2002_12_02_19_00_1.webm;Yukio HATOYAMA.jpg;85;89;10769;2;2;0
/net/per920a/export/das14a/satoh-lab/haolin/nhk/excerpts/2002_12_02_19_00_1.webm;Yukio HATOYAMA.jpg;117;761;10769;3;25;22
/net/per920a/export/das14a/satoh-lab/haolin/nhk/excerpts/2002_12_02_19_00_1.webm;Yukio HATOYAMA.jpg;805;809;10769;26;26;0
/net/per920a/export/das14a/satoh-lab/haolin/nhk/excerpts/2002_12_02_19_00_1.webm;Yukio HATOYAMA.jpg;861;869;10769;28;28;0
/net/per920a/export/das14a/satoh-lab/haolin/nhk/excerpts/2002_12_02_19_00_1.webm;Yukio HATOYAMA.jpg;905;905;10769;30;30;0
/net/per920a/export/das14a/satoh-lab/haolin/nhk/excerpts/2002_12_02_19_00_1.webm;Yukio HATOYAMA.jpg;1141;1173;10769;38;39;1
/net/per920a/export/das14a/satoh-lab/haolin/nhk/excerpts/2002_12_02_19_00_1.webm;Yukio HATOYAMA.jpg;1189;1213;10769;39;40;1
/net/per920a/export/das14a/satoh-lab/haolin/nhk/excerpts/2002_12_02_19_00_1.webm;Yukio HATOYAMA.jpg;1737;1765;10769;57;58;1
/net/per920a/export/das14a/satoh-lab/haolin/nhk/excerpts/2002_12_02_19_00_1.webm;Yukio HATOYAMA.jpg;1777;1937;10769;59;64;5
/net/per920a/export/das14a/satoh-lab/haolin/nhk/excerpts/2002_12_02_19_00_1.webm;Yukio HATOYAMA.jpg;1957;2025;10769;65;67;2
/net/per920a/export/das14a/satoh-lab/haolin/nhk/excerpts/2002_12_02_19_00_1.webm;Yukio HATOYAMA.jpg;2609;2641;10769;86;88;2
/net/per920a/export/das14a/satoh-lab/haolin/nhk/excerpts/2002_12_02_19_00_1.webm;Yukio HATOYAMA.jpg;2669;3313;10769;88;110;22
/net/per920a/export/das14a/satoh-lab/haolin/nhk/excerpts/2002_12_02_19_00_1.webm;Yukio HATOYAMA.jpg;3329;3429;10769;110;114;4
/net/per920a/export/das14a/satoh-lab/haolin/nhk/excerpts/2002_12_02_19_00_1.webm;Yukio HATOYAMA.jpg;3981;4293;10769;132;143;11
/net/per920a/export/das14a/satoh-lab/haolin/nhk/excerpts/2002_12_02_19_00_1.webm;Yukio HATOYAMA.jpg;5429;5541;10769;180;184;4
/net/per920a/export/das14a/satoh-lab/haolin/nhk/excerpts/2002_12_02_19_00_1.webm;Yukio HATOYAMA.jpg;6557;6573;10769;218;219;1
/net/per920a/export/das14a/satoh-lab/haolin/nhk/excerpts/2002_12_02_19_00_1.webm;Yukio HATOYAMA.jpg;6589;6589;10769;219;219;0
/net/per920a/export/das14a/satoh-lab/haolin/nhk/excerpts/2002_12_02_19_00_1.webm;Yukio HATOYAMA.jpg;6961;6965;10769;232;232;0
/net/per920a/export/das14a/satoh-lab/haolin/nhk/excerpts/2002_12_02_19_00_1.webm;Yukio HATOYAMA.jpg;7621;7773;10769;254;259;5
/net/per920a/export/das14a/satoh-lab/haolin/nhk/excerpts/2002_12_02_19_00_1.webm;Yukio HATOYAMA.jpg;9001;9017;10769;300;300;0
/net/per920a/export/das14a/satoh-lab/haolin/nhk/excerpts/2002_12_02_19_00_1.webm;Yukio HATOYAMA.jpg;9037;9037;10769;301;301;0
/net/per920a/export/das14a/satoh-lab/haolin/nhk/excerpts/2002_12_02_19_00_1.webm;Yukio HATOYAMA.jpg;9049;9049;10769;301;301;0
/net/per920a/export/das14a/satoh-lab/haolin/nhk/excerpts/2002_12_02_19_00_1.webm;Yukio HATOYAMA.jpg;9081;9085;10769;302;302;0
/net/per920a/export/das14a/satoh-lab/haolin/nhk/excerpts/2002_12_02_19_00_1.webm;Yukio HATOYAMA.jpg;9101;9129;10769;303;304;1
/net/per920a/export/das14a/satoh-lab/haolin/nhk/excerpts/2002_12_02_19_00_1.webm;Yukio HATOYAMA.jpg;9141;9141;10769;304;304;0
/net/per920a/export/das14a/satoh-lab/haolin/nhk/excerpts/2002_12_02_19_00_1.webm;Yukio HATOYAMA.jpg;9201;9321;10769;306;310;4
/net/per920a/export/das14a/satoh-lab/haolin/nhk/excerpts/2002_12_02_19_00_1.webm;Yukio HATOYAMA.jpg;9765;9773;10769;325;325;0
/net/per920a/export/das14a/satoh-lab/haolin/nhk/excerpts/2002_12_02_19_00_1.webm;Yukio HATOYAMA.jpg;9801;9817;10769;326;327;1
/net/per920a/export/das14a/satoh-lab/haolin/nhk/excerpts/2002_12_02_19_00_1.webm;Yukio HATOYAMA.jpg;10145;10197;10769;338;339;1
/net/per920a/export/das14a/satoh-lab/haolin/nhk/excerpts/2002_12_02_19_00_1.webm;Yukio HATOYAMA.jpg;10313;10741;10769;343;358;15
/net/per920a/export/das14a/satoh-lab/haolin/nhk/excerpts/2002_12_02_19_00_1.webm;Yukio HATOYAMA.jpg;10753;10765;10769;358;358;0
/net/per920a/export/das14a/satoh-lab/haolin/nhk/excerpts/2002_12_02_19_00_1.webm;Ichiro OZAWA.jpg;8757;8917;10769;291;297;6
/net/per920a/export/das14a/satoh-lab/haolin/nhk/excerpts/2002_12_02_19_00_1.webm;Ichiro OZAWA.jpg;9001;9017;10769;300;300;0
/net/per920a/export/das14a/satoh-lab/haolin/nhk/excerpts/2002_12_02_19_00_1.webm;Ichiro OZAWA.jpg;9037;9037;10769;301;301;0
/net/per920a/export/das14a/satoh-lab/haolin/nhk/excerpts/2002_12_02_19_00_1.webm;Ichiro OZAWA.jpg;9049;9049;10769;301;301;0
/net/per920a/export/das14a/satoh-lab/haolin/nhk/excerpts/2002_12_02_19_00_1.webm;Ichiro OZAWA.jpg;9141;9141;10769;304;304;0
/net/per920a/export/das14a/satoh-lab/haolin/nhk/excerpts/2002_12_02_19_00_1.webm;Ichiro OZAWA.jpg;9161;9189;10769;305;306;1
/net/per920a/export/das14a/satoh-lab/haolin/nhk/excerpts/2003_01_02_19_00_1.webm;Junichiro KOIZUMI.jpg;3477;3557;5489;115;118;3
/net/per920a/export/das14a/satoh-lab/haolin/nhk/excerpts/2003_02_10_19_00_1.webm;Junichiro KOIZUMI.jpg;15737;15741;38005;525;525;0
/net/per920a/export/das14a/satoh-lab/haolin/nhk/excerpts/2003_02_10_19_00_1.webm;Junichiro KOIZUMI.jpg;15841;15853;38005;528;528;0
/net/per920a/export/das14a/satoh-lab/haolin/nhk/excerpts/2003_02_10_19_00_1.webm;Junichiro KOIZUMI.jpg;15869;15901;38005;529;530;1
/net/per920a/export/das14a/satoh-lab/haolin/nhk/excerpts/2003_02_10_19_00_1.webm;Junichiro KOIZUMI.jpg;15917;15961;38005;531;532;1
/net/per920a/export/das14a/satoh-lab/haolin/nhk/excerpts/2003_02_10_19_00_1.webm;Junichiro KOIZUMI.jpg;16065;16325;38005;535;544;9
/net/per920a/export/das14a/satoh-lab/haolin/nhk/excerpts/2003_02_10_19_00_1.webm;Junichiro KOIZUMI.jpg;16341;16485;38005;545;550;5
/net/per920a/export/das14a/satoh-lab/haolin/nhk/excerpts/2003_02_10_19_00_1.webm;Junichiro KOIZUMI.jpg;16941;16957;38005;565;565;0
/net/per920a/export/das14a/satoh-lab/haolin/nhk/excerpts/2003_02_10_19_00_1.webm;Junichiro KOIZUMI.jpg;16973;16985;38005;566;566;0
/net/per920a/export/das14a/satoh-lab/haolin/nhk/excerpts/2003_02_10_19_00_1.webm;Junichiro KOIZUMI.jpg;17001;17009;38005;567;567;0
/net/per920a/export/das14a/satoh-lab/haolin/nhk/excerpts/2003_02_10_19_00_1.webm;Junichiro KOIZUMI.jpg;17481;17805;38005;583;594;11
/net/per920a/export/das14a/satoh-lab/haolin/nhk/excerpts/2003_02_10_19_00_1.webm;Junichiro KOIZUMI.jpg;17817;17893;38005;594;596;2
/net/per920a/export/das14a/satoh-lab/haolin/nhk/excerpts/2003_02_10_19_00_1.webm;Junichiro KOIZUMI.jpg;17909;17941;38005;597;598;1
/net/per920a/export/das14a/satoh-lab/haolin/nhk/excerpts/2003_02_10_19_00_1.webm;Junichiro KOIZUMI.jpg;17957;18161;38005;599;605;6
/net/per920a/export/das14a/satoh-lab/haolin/nhk/excerpts/2003_02_10_19_00_1.webm;Junichiro KOIZUMI.jpg;30073;30081;38005;1003;1003;0
/net/per920a/export/das14a/satoh-lab/haolin/nhk/excerpts/2003_02_10_19_00_1.webm;Junichiro KOIZUMI.jpg;30189;30237;38005;1007;1008;1
/net/per920a/export/das14a/satoh-lab/haolin/nhk/excerpts/2003_02_10_19_00_1.webm;Junichiro KOIZUMI.jpg;30253;30261;38005;1009;1009;0
/net/per920a/export/das14a/satoh-lab/haolin/nhk/excerpts/2003_02_10_19_00_1.webm;Junichiro KOIZUMI.jpg;30273;30277;38005;1010;1010;0
/net/per920a/export/das14a/satoh-lab/haolin/nhk/excerpts/2003_02_10_19_00_1.webm;Junichiro KOIZUMI.jpg;30985;31085;38005;1033;1037;4
/net/per920a/export/das14a/satoh-lab/haolin/nhk/excerpts/2003_02_10_19_00_1.webm;Junichiro KOIZUMI.jpg;31161;31217;38005;1039;1041;2
/net/per920a/export/das14a/satoh-lab/haolin/nhk/excerpts/2003_02_10_19_00_1.webm;Junichiro KOIZUMI.jpg;31233;32237;38005;1042;1075;33
/net/per920a/export/das14a/satoh-lab/haolin/nhk/excerpts/2003_02_10_19_00_1.webm;Toru Hashimoto.jpg;21989;22289;38005;733;743;10
/net/per920a/export/das14a/satoh-lab/haolin/nhk/excerpts/2003_02_10_19_00_1.webm;Toru Hashimoto.jpg;22309;22369;38005;744;746;2
/net/per920a/export/das14a/satoh-lab/haolin/nhk/excerpts/2003_02_10_19_00_1.webm;Toru Hashimoto.jpg;22385;22473;38005;746;749;3
/net/per920a/export/das14a/satoh-lab/haolin/nhk/excerpts/2003_02_10_19_00_1.webm;Toru Hashimoto.jpg;22489;22541;38005;750;752;2
/net/per920a/export/das14a/satoh-lab/haolin/nhk/excerpts/2003_02_10_19_00_1.webm;Toru Hashimoto.jpg;24565;24565;38005;819;819;0
/net/per920a/export/das14a/satoh-lab/haolin/nhk/excerpts/2003_02_10_19_00_1.webm;Toru Hashimoto.jpg;24581;24581;38005;820;820;0
/net/per920a/export/das14a/satoh-lab/haolin/nhk/excerpts/2003_02_10_19_00_1.webm;Toru Hashimoto.jpg;24613;24745;38005;821;825;4
/net/per920a/export/das14a/satoh-lab/haolin/nhk/excerpts/2003_02_10_19_00_1.webm;Toru Hashimoto.jpg;24769;24769;38005;826;826;0
/net/per920a/export/das14a/satoh-lab/haolin/nhk/excerpts/2003_02_10_19_00_1.webm;Toru Hashimoto.jpg;24781;24789;38005;826;827;1
/net/per920a/export/das14a/satoh-lab/haolin/nhk/excerpts/2003_02_10_19_00_1.webm;Toru Hashimoto.jpg;24805;24805;38005;827;827;0
/net/per920a/export/das14a/satoh-lab/haolin/nhk/excerpts/2003_02_10_19_00_1.webm;Toru Hashimoto.jpg;24817;24817;38005;827;827;0
/net/per920a/export/das14a/satoh-lab/haolin/nhk/excerpts/2003_02_10_19_00_1.webm;Toru Hashimoto.jpg;24829;24829;38005;828;828;0
/net/per920a/export/das14a/satoh-lab/haolin/nhk/excerpts/2003_02_10_19_00_1.webm;Toru Hashimoto.jpg;24841;24845;38005;828;828;0
/net/per920a/export/das14a/satoh-lab/haolin/nhk/excerpts/2003_02_10_19_00_1.webm;Toru Hashimoto.jpg;24865;24881;38005;829;830;1
/net/per920a/export/das14a/satoh-lab/haolin/nhk/excerpts/2003_02_10_19_00_1.webm;Toru Hashimoto.jpg;24901;24901;38005;830;830;0
/net/per920a/export/das14a/satoh-lab/haolin/nhk/excerpts/2003_02_10_19_00_1.webm;Toru Hashimoto.jpg;24913;24949;38005;831;832;1
/net/per920a/export/das14a/satoh-lab/haolin/nhk/excerpts/2003_02_10_19_00_1.webm;Toru Hashimoto.jpg;24973;24977;38005;833;833;0
/net/per920a/export/das14a/satoh-lab/haolin/nhk/excerpts/2003_02_10_19_00_1.webm;Toru Hashimoto.jpg;24989;24989;38005;833;833;0
/net/per920a/export/das14a/satoh-lab/haolin/nhk/excerpts/2003_02_10_19_00_1.webm;Toru Hashimoto.jpg;25009;25045;38005;834;835;1
/net/per920a/export/das14a/satoh-lab/haolin/nhk/excerpts/2003_02_10_19_00_1.webm;Toru Hashimoto.jpg;25065;25093;38005;836;837;1
/net/per920a/export/das14a/satoh-lab/haolin/nhk/excerpts/2003_02_10_19_00_1.webm;Toru Hashimoto.jpg;25117;25121;38005;838;838;0
/net/per920a/export/das14a/satoh-lab/haolin/nhk/excerpts/2003_03_11_19_00_1.webm;Junichiro KOIZUMI.jpg;10537;10785;15765;351;359;8
/net/per920a/export/das14a/satoh-lab/haolin/nhk/excerpts/2003_03_11_19_00_1.webm;Junichiro KOIZUMI.jpg;15125;15137;15765;504;505;1
/net/per920a/export/das14a/satoh-lab/haolin/nhk/excerpts/2003_03_11_19_00_1.webm;Junichiro KOIZUMI.jpg;15153;15181;15765;505;506;1
/net/per920a/export/das14a/satoh-lab/haolin/nhk/excerpts/2003_03_11_19_00_1.webm;Junichiro KOIZUMI.jpg;15193;15193;15765;506;506;0
/net/per920a/export/das14a/satoh-lab/haolin/nhk/excerpts/2003_03_11_19_00_1.webm;Junichiro KOIZUMI.jpg;15205;15237;15765;507;508;1
/net/per920a/export/das14a/satoh-lab/haolin/nhk/excerpts/2003_03_11_19_00_1.webm;Ichiro OZAWA.jpg;13273;13273;15765;442;442;0
/net/per920a/export/das14a/satoh-lab/haolin/nhk/excerpts/2003_03_11_19_00_1.webm;Ichiro OZAWA.jpg;13289;13393;15765;443;446;3
/net/per920a/export/das14a/satoh-lab/haolin/nhk/excerpts/2003_03_11_19_00_1.webm;Ichiro OZAWA.jpg;13409;13409;15765;447;447;0
/net/per920a/export/das14a/satoh-lab/haolin/nhk/excerpts/2003_03_11_19_00_1.webm;Ichiro OZAWA.jpg;13425;13425;15765;447;447;0
/net/per920a/export/das14a/satoh-lab/haolin/nhk/excerpts/2003_03_11_19_00_1.webm;Ichiro OZAWA.jpg;13453;13537;15765;448;451;3
/net/per920a/export/das14a/satoh-lab/haolin/nhk/excerpts/2003_03_11_19_00_1.webm;Ichiro OZAWA.jpg;13561;13561;15765;452;452;0
/net/per920a/export/das14a/satoh-lab/haolin/nhk/excerpts/2003_03_11_19_00_1.webm;Ichiro OZAWA.jpg;13573;13585;15765;452;453;1
/net/per920a/export/das14a/satoh-lab/haolin/nhk/excerpts/2003_03_11_19_00_1.webm;Toru Hashimoto.jpg;14153;14205;15765;472;473;1
/net/per920a/export/das14a/satoh-lab/haolin/nhk/excerpts/2003_03_11_19_00_1.webm;Toru Hashimoto.jpg;14221;14265;15765;474;475;1
/net/per920a/export/das14a/satoh-lab/haolin/nhk/excerpts/2003_03_11_19_00_1.webm;Toru Hashimoto.jpg;14281;14293;15765;476;476;0
/net/per920a/export/das14a/satoh-lab/haolin/nhk/excerpts/2003_03_11_19_00_1.webm;Toru Hashimoto.jpg;14309;14341;15765;477;478;1
/net/per920a/export/das14a/satoh-lab/haolin/nhk/excerpts/2003_03_11_19_00_1.webm;Toru Hashimoto.jpg;14377;14481;15765;479;483;4
/net/per920a/export/das14a/satoh-lab/haolin/nhk/excerpts/2003_03_11_19_00_1.webm;Toru Hashimoto.jpg;14497;14517;15765;483;484;1
/net/per920a/export/das14a/satoh-lab/haolin/nhk/excerpts/2003_03_11_19_00_1.webm;Toru Hashimoto.jpg;14549;14549;15765;485;485;0
/net/per920a/export/das14a/satoh-lab/haolin/nhk/excerpts/2003_03_11_19_00_1.webm;Toru Hashimoto.jpg;14577;14577;15765;486;486;0
/net/per920a/export/das14a/satoh-lab/haolin/nhk/excerpts/2003_03_11_19_00_1.webm;Toru Hashimoto.jpg;14593;14593;15765;486;486;0
/net/per920a/export/das14a/satoh-lab/haolin/nhk/excerpts/2003_03_11_19_00_1.webm;Toru Hashimoto.jpg;14629;14637;15765;488;488;0
/net/per920a/export/das14a/satoh-lab/haolin/nhk/excerpts/2003_03_11_19_00_1.webm;Takenori KANZAKI.jpg;15257;15469;15765;509;516;7
/net/per920a/export/das14a/satoh-lab/haolin/nhk/excerpts/2003_04_17_19_00_1.webm;Junichiro KOIZUMI.jpg;19653;19657;21949;655;655;0
/net/per920a/export/das14a/satoh-lab/haolin/nhk/excerpts/2003_04_17_19_00_1.webm;Junichiro KOIZUMI.jpg;19749;19789;21949;658;659;1
/net/per920a/export/das14a/satoh-lab/haolin/nhk/excerpts/2003_04_17_19_00_1.webm;Junichiro KOIZUMI.jpg;19829;19833;21949;661;661;0
/net/per920a/export/das14a/satoh-lab/haolin/nhk/excerpts/2003_04_17_19_00_1.webm;Junichiro KOIZUMI.jpg;19845;19845;21949;661;661;0
/net/per920a/export/das14a/satoh-lab/haolin/nhk/excerpts/2003_04_17_19_00_1.webm;Junichiro KOIZUMI.jpg;19877;19893;21949;662;663;1
/net/per920a/export/das14a/satoh-lab/haolin/nhk/excerpts/2003_04_17_19_00_1.webm;Junichiro KOIZUMI.jpg;19905;19965;21949;663;665;2
/net/per920a/export/das14a/satoh-lab/haolin/nhk/excerpts/2003_04_17_19_00_1.webm;Junichiro KOIZUMI.jpg;21313;21637;21949;710;721;11
/net/per920a/export/das14a/satoh-lab/haolin/nhk/excerpts/2003_04_17_19_00_1.webm;Junichiro KOIZUMI.jpg;21653;21889;21949;722;729;7
/net/per920a/export/das14a/satoh-lab/haolin/nhk/excerpts/2003_04_17_19_00_1.webm;Shintaro ISHIHARA.jpg;20573;20573;21949;686;686;0
/net/per920a/export/das14a/satoh-lab/haolin/nhk/excerpts/2003_04_17_19_00_1.webm;Shintaro ISHIHARA.jpg;20637;20749;21949;688;691;3
/net/per920a/export/das14a/satoh-lab/haolin/nhk/excerpts/2003_04_17_19_00_1.webm;Shintaro ISHIHARA.jpg;20849;20853;21949;695;695;0
/net/per920a/export/das14a/satoh-lab/haolin/nhk/excerpts/2003_04_17_19_00_1.webm;Shintaro ISHIHARA.jpg;20989;20989;21949;699;699;0
/net/per920a/export/das14a/satoh-lab/haolin/nhk/excerpts/2003_04_17_19_00_1.webm;Shintaro ISHIHARA.jpg;21037;21045;21949;701;701;0
/net/per920a/export/das14a/satoh-lab/haolin/nhk/excerpts/2003_04_17_19_00_1.webm;Shintaro ISHIHARA.jpg;21089;21089;21949;703;703;0
/net/per920a/export/das14a/satoh-lab/haolin/nhk/excerpts/2003_04_17_19_00_1.webm;Shintaro ISHIHARA.jpg;21121;21129;21949;704;704;0
/net/per920a/export/das14a/satoh-lab/haolin/nhk/excerpts/2003_04_17_19_00_1.webm;Shintaro ISHIHARA.jpg;21161;21165;21949;705;705;0
/net/per920a/export/das14a/satoh-lab/haolin/nhk/excerpts/2003_04_17_19_00_1.webm;Shintaro ISHIHARA.jpg;21253;21257;21949;708;708;0
/net/per920a/export/das14a/satoh-lab/haolin/nhk/excerpts/2003_04_30_19_00_3.webm;Junichiro KOIZUMI.jpg;7429;7509;12181;247;250;3
/net/per920a/export/das14a/satoh-lab/haolin/nhk/excerpts/2003_04_30_19_00_3.webm;Junichiro KOIZUMI.jpg;7525;7933;12181;250;264;14
/net/per920a/export/das14a/satoh-lab/haolin/nhk/excerpts/2003_04_30_19_00_3.webm;Junichiro KOIZUMI.jpg;8253;8257;12181;275;275;0
/net/per920a/export/das14a/satoh-lab/haolin/nhk/excerpts/2003_04_30_19_00_3.webm;Junichiro KOIZUMI.jpg;8289;8293;12181;276;276;0
/net/per920a/export/das14a/satoh-lab/haolin/nhk/excerpts/2003_04_30_19_00_3.webm;Junichiro KOIZUMI.jpg;8309;8313;12181;276;277;1
/net/per920a/export/das14a/satoh-lab/haolin/nhk/excerpts/2003_04_30_19_00_3.webm;Junichiro KOIZUMI.jpg;8389;8389;12181;279;279;0
/net/per920a/export/das14a/satoh-lab/haolin/nhk/excerpts/2003_04_30_19_00_3.webm;Junichiro KOIZUMI.jpg;8401;8425;12181;280;280;0
/net/per920a/export/das14a/satoh-lab/haolin/nhk/excerpts/2003_04_30_19_00_3.webm;Junichiro KOIZUMI.jpg;8437;8521;12181;281;284;3
/net/per920a/export/das14a/satoh-lab/haolin/nhk/excerpts/2003_04_30_19_00_3.webm;Junichiro KOIZUMI.jpg;8533;8545;12181;284;284;0
/net/per920a/export/das14a/satoh-lab/haolin/nhk/excerpts/2003_04_30_19_00_3.webm;Junichiro KOIZUMI.jpg;8557;8649;12181;285;288;3
/net/per920a/export/das14a/satoh-lab/haolin/nhk/excerpts/2003_04_30_19_00_3.webm;Junichiro KOIZUMI.jpg;8665;8721;12181;288;290;2
/net/per920a/export/das14a/satoh-lab/haolin/nhk/excerpts/2003_04_30_19_00_3.webm;Junichiro KOIZUMI.jpg;9009;9009;12181;300;300;0
/net/per920a/export/das14a/satoh-lab/haolin/nhk/excerpts/2003_04_30_19_00_3.webm;Shinzo ABE.jpg;8269;8273;12181;275;275;0
/net/per920a/export/das14a/satoh-lab/haolin/nhk/excerpts/2003_04_30_19_00_3.webm;Shinzo ABE.jpg;8289;8293;12181;276;276;0
/net/per920a/export/das14a/satoh-lab/haolin/nhk/excerpts/2003_04_30_19_00_3.webm;Shinzo ABE.jpg;8309;8313;12181;276;277;1
/net/per920a/export/das14a/satoh-lab/haolin/nhk/excerpts/2003_06_17_19_00_2.webm;Junichiro KOIZUMI.jpg;1761;1777;1985;58;59;1
/net/per920a/export/das14a/satoh-lab/haolin/nhk/excerpts/2003_06_17_19_00_2.webm;Junichiro KOIZUMI.jpg;1789;1877;1985;59;62;3
/net/per920a/export/das14a/satoh-lab/haolin/nhk/excerpts/2003_06_17_19_00_2.webm;Junichiro KOIZUMI.jpg;1925;1929;1985;64;64;0
/net/per920a/export/das14a/satoh-lab/haolin/nhk/excerpts/2003_06_17_19_00_2.webm;Junichiro KOIZUMI.jpg;1949;1949;1985;64;64;0
/net/per920a/export/das14a/satoh-lab/haolin/nhk/excerpts/2003_06_17_19_00_2.webm;Junichiro KOIZUMI.jpg;1961;1981;1985;65;65;0
/net/per920a/export/das14a/satoh-lab/haolin/nhk/excerpts/2003_07_15_19_00_3.webm;Ichiro OZAWA.jpg;1493;1493;5185;49;49;0
/net/per920a/export/das14a/satoh-lab/haolin/nhk/excerpts/2003_07_15_19_00_3.webm;Ichiro OZAWA.jpg;1505;1513;5185;50;50;0
/net/per920a/export/das14a/satoh-lab/haolin/nhk/excerpts/2003_07_15_19_00_3.webm;Ichiro OZAWA.jpg;1533;1533;5185;51;51;0
/net/per920a/export/das14a/satoh-lab/haolin/nhk/excerpts/2003_07_15_19_00_3.webm;Ichiro OZAWA.jpg;1545;1821;5185;51;60;9
/net/per920a/export/das14a/satoh-lab/haolin/nhk/excerpts/2003_07_15_19_00_3.webm;Ichiro OZAWA.jpg;1837;1849;5185;61;61;0
/net/per920a/export/das14a/satoh-lab/haolin/nhk/excerpts/2003_07_15_19_00_3.webm;Junichiro KOIZUMI.jpg;2713;2773;5185;90;92;2
/net/per920a/export/das14a/satoh-lab/haolin/nhk/excerpts/2003_07_15_19_00_3.webm;Junichiro KOIZUMI.jpg;2789;4253;5185;93;141;48
/net/per920a/export/das14a/satoh-lab/haolin/nhk/excerpts/2003_07_23_19_00_2.webm;Naoto KAN.jpg;713;805;12593;23;26;3
/net/per920a/export/das14a/satoh-lab/haolin/nhk/excerpts/2003_07_23_19_00_2.webm;Naoto KAN.jpg;821;821;12593;27;27;0
/net/per920a/export/das14a/satoh-lab/haolin/nhk/excerpts/2003_07_23_19_00_2.webm;Naoto KAN.jpg;869;881;12593;28;29;1
/net/per920a/export/das14a/satoh-lab/haolin/nhk/excerpts/2003_07_23_19_00_2.webm;Naoto KAN.jpg;897;965;12593;29;32;3
/net/per920a/export/das14a/satoh-lab/haolin/nhk/excerpts/2003_07_23_19_00_2.webm;Naoto KAN.jpg;985;1117;12593;32;37;5
/net/per920a/export/das14a/satoh-lab/haolin/nhk/excerpts/2003_07_23_19_00_2.webm;Naoto KAN.jpg;1133;1137;12593;37;37;0
/net/per920a/export/das14a/satoh-lab/haolin/nhk/excerpts/2003_07_23_19_00_2.webm;Naoto KAN.jpg;1165;1169;12593;38;38;0
/net/per920a/export/das14a/satoh-lab/haolin/nhk/excerpts/2003_07_23_19_00_2.webm;Naoto KAN.jpg;1185;1229;12593;39;40;1
/net/per920a/export/das14a/satoh-lab/haolin/nhk/excerpts/2003_07_23_19_00_2.webm;Naoto KAN.jpg;1265;1265;12593;42;42;0
/net/per920a/export/das14a/satoh-lab/haolin/nhk/excerpts/2003_07_23_19_00_2.webm;Naoto KAN.jpg;1313;1313;12593;43;43;0
/net/per920a/export/das14a/satoh-lab/haolin/nhk/excerpts/2003_07_23_19_00_2.webm;Naoto KAN.jpg;1333;1353;12593;44;45;1
/net/per920a/export/das14a/satoh-lab/haolin/nhk/excerpts/2003_07_23_19_00_2.webm;Naoto KAN.jpg;1385;1397;12593;46;46;0
/net/per920a/export/das14a/satoh-lab/haolin/nhk/excerpts/2003_07_23_19_00_2.webm;Naoto KAN.jpg;1417;1417;12593;47;47;0
/net/per920a/export/das14a/satoh-lab/haolin/nhk/excerpts/2003_07_23_19_00_2.webm;Naoto KAN.jpg;1433;1445;12593;47;48;1
/net/per920a/export/das14a/satoh-lab/haolin/nhk/excerpts/2003_07_23_19_00_2.webm;Naoto KAN.jpg;1457;1465;12593;48;48;0
/net/per920a/export/das14a/satoh-lab/haolin/nhk/excerpts/2003_07_23_19_00_2.webm;Naoto KAN.jpg;1509;1521;12593;50;50;0
/net/per920a/export/das14a/satoh-lab/haolin/nhk/excerpts/2003_07_23_19_00_2.webm;Naoto KAN.jpg;1569;1649;12593;52;54;2
/net/per920a/export/das14a/satoh-lab/haolin/nhk/excerpts/2003_07_23_19_00_2.webm;Naoto KAN.jpg;1669;1681;12593;55;56;1
/net/per920a/export/das14a/satoh-lab/haolin/nhk/excerpts/2003_07_23_19_00_2.webm;Naoto KAN.jpg;1697;1789;12593;56;59;3
/net/per920a/export/das14a/satoh-lab/haolin/nhk/excerpts/2003_07_23_19_00_2.webm;Naoto KAN.jpg;1817;1829;12593;60;61;1
/net/per920a/export/das14a/satoh-lab/haolin/nhk/excerpts/2003_07_23_19_00_2.webm;Naoto KAN.jpg;1901;1909;12593;63;63;0
/net/per920a/export/das14a/satoh-lab/haolin/nhk/excerpts/2003_07_23_19_00_2.webm;Naoto KAN.jpg;1929;1933;12593;64;64;0
/net/per920a/export/das14a/satoh-lab/haolin/nhk/excerpts/2003_07_23_19_00_2.webm;Naoto KAN.jpg;1945;1949;12593;64;65;1
/net/per920a/export/das14a/satoh-lab/haolin/nhk/excerpts/2003_07_23_19_00_2.webm;Naoto KAN.jpg;1961;1993;12593;65;66;1
/net/per920a/export/das14a/satoh-lab/haolin/nhk/excerpts/2003_07_23_19_00_2.webm;Naoto KAN.jpg;2209;2305;12593;73;76;3
/net/per920a/export/das14a/satoh-lab/haolin/nhk/excerpts/2003_07_23_19_00_2.webm;Naoto KAN.jpg;2481;3133;12593;82;104;22
/net/per920a/export/das14a/satoh-lab/haolin/nhk/excerpts/2003_07_23_19_00_2.webm;Naoto KAN.jpg;3145;3337;12593;104;111;7
/net/per920a/export/das14a/satoh-lab/haolin/nhk/excerpts/2003_07_23_19_00_2.webm;Naoto KAN.jpg;4265;4269;12593;142;142;0
/net/per920a/export/das14a/satoh-lab/haolin/nhk/excerpts/2003_07_23_19_00_2.webm;Naoto KAN.jpg;4285;4301;12593;142;143;1
/net/per920a/export/das14a/satoh-lab/haolin/nhk/excerpts/2003_07_23_19_00_2.webm;Naoto KAN.jpg;4329;4333;12593;144;144;0
/net/per920a/export/das14a/satoh-lab/haolin/nhk/excerpts/2003_07_23_19_00_2.webm;Naoto KAN.jpg;4381;4381;12593;146;146;0
/net/per920a/export/das14a/satoh-lab/haolin/nhk/excerpts/2003_07_23_19_00_2.webm;Naoto KAN.jpg;4409;4413;12593;147;147;0
/net/per920a/export/das14a/satoh-lab/haolin/nhk/excerpts/2003_07_23_19_00_2.webm;Naoto KAN.jpg;4425;4437;12593;147;147;0
/net/per920a/export/das14a/satoh-lab/haolin/nhk/excerpts/2003_07_23_19_00_2.webm;Naoto KAN.jpg;4761;4793;12593;158;159;1
/net/per920a/export/das14a/satoh-lab/haolin/nhk/excerpts/2003_07_23_19_00_2.webm;Naoto KAN.jpg;4809;5165;12593;160;172;12
/net/per920a/export/das14a/satoh-lab/haolin/nhk/excerpts/2003_07_23_19_00_2.webm;Naoto KAN.jpg;6473;6629;12593;215;221;6
/net/per920a/export/das14a/satoh-lab/haolin/nhk/excerpts/2003_07_23_19_00_2.webm;Naoto KAN.jpg;6641;6641;12593;221;221;0
/net/per920a/export/das14a/satoh-lab/haolin/nhk/excerpts/2003_07_23_19_00_2.webm;Naoto KAN.jpg;6653;6657;12593;221;222;1
/net/per920a/export/das14a/satoh-lab/haolin/nhk/excerpts/2003_07_23_19_00_2.webm;Naoto KAN.jpg;6669;6685;12593;222;222;0
/net/per920a/export/das14a/satoh-lab/haolin/nhk/excerpts/2003_07_23_19_00_2.webm;Naoto KAN.jpg;6713;6717;12593;223;224;1
/net/per920a/export/das14a/satoh-lab/haolin/nhk/excerpts/2003_07_23_19_00_2.webm;Naoto KAN.jpg;6729;6729;12593;224;224;0
/net/per920a/export/das14a/satoh-lab/haolin/nhk/excerpts/2003_07_23_19_00_2.webm;Naoto KAN.jpg;8081;8113;12593;269;270;1
/net/per920a/export/das14a/satoh-lab/haolin/nhk/excerpts/2003_07_23_19_00_2.webm;Naoto KAN.jpg;8149;8185;12593;271;272;1
/net/per920a/export/das14a/satoh-lab/haolin/nhk/excerpts/2003_07_23_19_00_2.webm;Naoto KAN.jpg;8197;8269;12593;273;275;2
/net/per920a/export/das14a/satoh-lab/haolin/nhk/excerpts/2003_07_23_19_00_2.webm;Naoto KAN.jpg;8285;8305;12593;276;276;0
/net/per920a/export/das14a/satoh-lab/haolin/nhk/excerpts/2003_07_23_19_00_2.webm;Naoto KAN.jpg;8329;8333;12593;277;277;0
/net/per920a/export/das14a/satoh-lab/haolin/nhk/excerpts/2003_07_23_19_00_2.webm;Naoto KAN.jpg;8369;8621;12593;279;287;8
/net/per920a/export/das14a/satoh-lab/haolin/nhk/excerpts/2003_07_23_19_00_2.webm;Naoto KAN.jpg;9205;9209;12593;307;307;0
/net/per920a/export/das14a/satoh-lab/haolin/nhk/excerpts/2003_07_23_19_00_2.webm;Naoto KAN.jpg;9233;9245;12593;307;308;1
/net/per920a/export/das14a/satoh-lab/haolin/nhk/excerpts/2003_07_23_19_00_2.webm;Naoto KAN.jpg;9261;9349;12593;308;311;3
/net/per920a/export/das14a/satoh-lab/haolin/nhk/excerpts/2003_07_23_19_00_2.webm;Naoto KAN.jpg;9397;9421;12593;313;314;1
/net/per920a/export/das14a/satoh-lab/haolin/nhk/excerpts/2003_07_23_19_00_2.webm;Naoto KAN.jpg;9441;9537;12593;314;318;4
/net/per920a/export/das14a/satoh-lab/haolin/nhk/excerpts/2003_07_23_19_00_2.webm;Naoto KAN.jpg;9561;9565;12593;318;319;1
/net/per920a/export/das14a/satoh-lab/haolin/nhk/excerpts/2003_07_23_19_00_2.webm;Naoto KAN.jpg;9577;9577;12593;319;319;0
/net/per920a/export/das14a/satoh-lab/haolin/nhk/excerpts/2003_07_23_19_00_2.webm;Naoto KAN.jpg;9869;9877;12593;329;329;0
/net/per920a/export/das14a/satoh-lab/haolin/nhk/excerpts/2003_07_23_19_00_2.webm;Naoto KAN.jpg;9897;9917;12593;330;330;0
/net/per920a/export/das14a/satoh-lab/haolin/nhk/excerpts/2003_07_23_19_00_2.webm;Naoto KAN.jpg;9933;9941;12593;331;331;0
/net/per920a/export/das14a/satoh-lab/haolin/nhk/excerpts/2003_07_23_19_00_2.webm;Naoto KAN.jpg;9957;9961;12593;332;332;0
/net/per920a/export/das14a/satoh-lab/haolin/nhk/excerpts/2003_07_23_19_00_2.webm;Naoto KAN.jpg;10005;10009;12593;333;333;0
/net/per920a/export/das14a/satoh-lab/haolin/nhk/excerpts/2003_07_23_19_00_2.webm;Naoto KAN.jpg;10453;10473;12593;348;349;1
/net/per920a/export/das14a/satoh-lab/haolin/nhk/excerpts/2003_07_23_19_00_2.webm;Naoto KAN.jpg;11349;11365;12593;378;379;1
/net/per920a/export/das14a/satoh-lab/haolin/nhk/excerpts/2003_07_23_19_00_2.webm;Ichiro OZAWA.jpg;2481;3133;12593;82;104;22
/net/per920a/export/das14a/satoh-lab/haolin/nhk/excerpts/2003_07_23_19_00_2.webm;Ichiro OZAWA.jpg;3145;3337;12593;104;111;7
/net/per920a/export/das14a/satoh-lab/haolin/nhk/excerpts/2003_07_23_19_00_2.webm;Junichiro KOIZUMI.jpg;7597;7705;12593;253;256;3
/net/per920a/export/das14a/satoh-lab/haolin/nhk/excerpts/2003_07_23_19_00_2.webm;Junichiro KOIZUMI.jpg;7721;7725;12593;257;257;0
/net/per920a/export/das14a/satoh-lab/haolin/nhk/excerpts/2003_07_23_19_00_2.webm;Junichiro KOIZUMI.jpg;7745;7749;12593;258;258;0
/net/per920a/export/das14a/satoh-lab/haolin/nhk/excerpts/2003_07_23_19_00_2.webm;Junichiro KOIZUMI.jpg;7777;7813;12593;259;260;1
/net/per920a/export/das14a/satoh-lab/haolin/nhk/excerpts/2003_07_23_19_00_2.webm;Junichiro KOIZUMI.jpg;7837;7845;12593;261;261;0
/net/per920a/export/das14a/satoh-lab/haolin/nhk/excerpts/2003_07_23_19_00_2.webm;Junichiro KOIZUMI.jpg;7865;7953;12593;262;265;3
/net/per920a/export/das14a/satoh-lab/haolin/nhk/excerpts/2003_07_23_19_00_2.webm;Junichiro KOIZUMI.jpg;7969;8069;12593;265;269;4
/net/per920a/export/das14a/satoh-lab/haolin/nhk/excerpts/2003_07_23_19_00_2.webm;Junichiro KOIZUMI.jpg;8081;8113;12593;269;270;1
/net/per920a/export/das14a/satoh-lab/haolin/nhk/excerpts/2003_07_23_19_00_2.webm;Junichiro KOIZUMI.jpg;8149;8185;12593;271;272;1
/net/per920a/export/das14a/satoh-lab/haolin/nhk/excerpts/2003_07_23_19_00_2.webm;Junichiro KOIZUMI.jpg;8637;9113;12593;288;303;15
/net/per920a/export/das14a/satoh-lab/haolin/nhk/excerpts/2003_07_23_19_00_2.webm;Junichiro KOIZUMI.jpg;9633;9697;12593;321;323;2
/net/per920a/export/das14a/satoh-lab/haolin/nhk/excerpts/2003_07_23_19_00_2.webm;Junichiro KOIZUMI.jpg;9713;9749;12593;323;325;2
/net/per920a/export/das14a/satoh-lab/haolin/nhk/excerpts/2003_07_23_19_00_2.webm;Junichiro KOIZUMI.jpg;9761;9777;12593;325;326;1
/net/per920a/export/das14a/satoh-lab/haolin/nhk/excerpts/2003_07_23_19_00_2.webm;Junichiro KOIZUMI.jpg;9789;9801;12593;326;326;0
/net/per920a/export/das14a/satoh-lab/haolin/nhk/excerpts/2003_07_23_19_00_2.webm;Junichiro KOIZUMI.jpg;9817;9853;12593;327;328;1
/net/per920a/export/das14a/satoh-lab/haolin/nhk/excerpts/2003_07_23_19_00_2.webm;Junichiro KOIZUMI.jpg;10049;10373;12593;335;345;10
/net/per920a/export/das14a/satoh-lab/haolin/nhk/excerpts/2003_07_23_19_00_2.webm;Junichiro KOIZUMI.jpg;11225;11229;12593;374;374;0
/net/per920a/export/das14a/satoh-lab/haolin/nhk/excerpts/2003_07_23_19_00_2.webm;Junichiro KOIZUMI.jpg;11245;11289;12593;375;376;1
/net/per920a/export/das14a/satoh-lab/haolin/nhk/excerpts/2003_07_23_19_00_2.webm;Junichiro KOIZUMI.jpg;11349;11365;12593;378;379;1
/net/per920a/export/das14a/satoh-lab/haolin/nhk/excerpts/2003_07_23_19_00_2.webm;Junichiro KOIZUMI.jpg;11405;11441;12593;380;381;1
/net/per920a/export/das14a/satoh-lab/haolin/nhk/excerpts/2003_07_23_19_00_2.webm;Junichiro KOIZUMI.jpg;11905;11905;12593;397;397;0
/net/per920a/export/das14a/satoh-lab/haolin/nhk/excerpts/2003_07_23_19_00_2.webm;Junichiro KOIZUMI.jpg;11917;11925;12593;397;397;0
/net/per920a/export/das14a/satoh-lab/haolin/nhk/excerpts/2003_07_23_19_00_2.webm;Junichiro KOIZUMI.jpg;11937;11993;12593;398;399;1
/net/per920a/export/das14a/satoh-lab/haolin/nhk/excerpts/2003_07_23_19_00_2.webm;Junichiro KOIZUMI.jpg;12009;12133;12593;400;404;4
/net/per920a/export/das14a/satoh-lab/haolin/nhk/excerpts/2003_07_23_19_00_2.webm;Junichiro KOIZUMI.jpg;12149;12237;12593;405;408;3
/net/per920a/export/das14a/satoh-lab/haolin/nhk/excerpts/2003_07_23_19_00_2.webm;Junichiro KOIZUMI.jpg;12253;12297;12593;408;410;2
/net/per920a/export/das14a/satoh-lab/haolin/nhk/excerpts/2003_07_23_19_00_2.webm;Junichiro KOIZUMI.jpg;12317;12321;12593;410;410;0
/net/per920a/export/das14a/satoh-lab/haolin/nhk/excerpts/2003_07_23_19_00_2.webm;Junichiro KOIZUMI.jpg;12333;12393;12593;411;413;2
/net/per920a/export/das14a/satoh-lab/haolin/nhk/excerpts/2003_07_23_19_00_2.webm;Junichiro KOIZUMI.jpg;12421;12477;12593;414;416;2
/net/per920a/export/das14a/satoh-lab/haolin/nhk/excerpts/2003_07_23_19_00_2.webm;Junichiro KOIZUMI.jpg;12529;12541;12593;417;418;1
/net/per920a/export/das14a/satoh-lab/haolin/nhk/excerpts/2003_07_23_19_00_2.webm;Kazuo SHII.jpg;10501;10517;12593;350;350;0
/net/per920a/export/das14a/satoh-lab/haolin/nhk/excerpts/2003_07_23_19_00_2.webm;Kazuo SHII.jpg;10769;10801;12593;359;360;1
/net/per920a/export/das14a/satoh-lab/haolin/nhk/excerpts/2003_07_23_19_00_2.webm;Kazuo SHII.jpg;10821;10837;12593;360;361;1
/net/per920a/export/das14a/satoh-lab/haolin/nhk/excerpts/2003_08_04_19_00_1.webm;Yasuo FUKUDA.jpg;2321;2329;2341;77;77;0
/net/per920a/export/das14a/satoh-lab/haolin/nhk/excerpts/2003_08_26_19_00_3.webm;Junichiro KOIZUMI.jpg;117;233;1001;3;7;4
/net/per920a/export/das14a/satoh-lab/haolin/nhk/excerpts/2003_08_26_19_00_3.webm;Junichiro KOIZUMI.jpg;245;245;1001;8;8;0
/net/per920a/export/das14a/satoh-lab/haolin/nhk/excerpts/2003_08_26_19_00_3.webm;Junichiro KOIZUMI.jpg;689;829;1001;22;27;5
/net/per920a/export/das14a/satoh-lab/haolin/nhk/excerpts/2003_09_04_19_00_2.webm;Junichiro KOIZUMI.jpg;9;65;11661;0;2;2
/net/per920a/export/das14a/satoh-lab/haolin/nhk/excerpts/2003_09_04_19_00_2.webm;Junichiro KOIZUMI.jpg;89;105;11661;2;3;1
/net/per920a/export/das14a/satoh-lab/haolin/nhk/excerpts/2003_09_04_19_00_2.webm;Junichiro KOIZUMI.jpg;121;481;11661;4;16;12
/net/per920a/export/das14a/satoh-lab/haolin/nhk/excerpts/2003_09_04_19_00_2.webm;Junichiro KOIZUMI.jpg;3077;3089;11661;102;103;1
/net/per920a/export/das14a/satoh-lab/haolin/nhk/excerpts/2003_09_04_19_00_2.webm;Junichiro KOIZUMI.jpg;3117;3245;11661;103;108;5
/net/per920a/export/das14a/satoh-lab/haolin/nhk/excerpts/2003_09_04_19_00_2.webm;Junichiro KOIZUMI.jpg;3257;3273;11661;108;109;1
/net/per920a/export/das14a/satoh-lab/haolin/nhk/excerpts/2003_09_04_19_00_2.webm;Junichiro KOIZUMI.jpg;3321;3321;11661;110;110;0
/net/per920a/export/das14a/satoh-lab/haolin/nhk/excerpts/2003_09_04_19_00_2.webm;Junichiro KOIZUMI.jpg;3337;3337;11661;111;111;0
/net/per920a/export/das14a/satoh-lab/haolin/nhk/excerpts/2003_09_04_19_00_2.webm;Junichiro KOIZUMI.jpg;3369;3385;11661;112;112;0
/net/per920a/export/das14a/satoh-lab/haolin/nhk/excerpts/2003_09_04_19_00_2.webm;Junichiro KOIZUMI.jpg;9877;10129;11661;329;337;8
/net/per920a/export/das14a/satoh-lab/haolin/nhk/excerpts/2003_09_04_19_00_2.webm;Junichiro KOIZUMI.jpg;10145;10421;11661;338;347;9
/net/per920a/export/das14a/satoh-lab/haolin/nhk/excerpts/2003_09_04_19_00_2.webm;Junichiro KOIZUMI.jpg;11421;11557;11661;380;385;5
/net/per920a/export/das14a/satoh-lab/haolin/nhk/excerpts/2003_09_04_19_00_2.webm;Naoto KAN.jpg;8305;8369;11661;277;279;2
/net/per920a/export/das14a/satoh-lab/haolin/nhk/excerpts/2003_09_04_19_00_2.webm;Naoto KAN.jpg;8381;8389;11661;279;279;0
/net/per920a/export/das14a/satoh-lab/haolin/nhk/excerpts/2003_09_04_19_00_2.webm;Naoto KAN.jpg;9309;9865;11661;310;329;19
/net/per920a/export/das14a/satoh-lab/haolin/nhk/excerpts/2003_09_04_19_00_2.webm;Yasuo FUKUDA.jpg;10433;11073;11661;348;369;21
/net/per920a/export/das14a/satoh-lab/haolin/nhk/excerpts/2003_09_04_19_00_2.webm;Yasuo FUKUDA.jpg;11085;11409;11661;369;380;11
/net/per920a/export/das14a/satoh-lab/haolin/nhk/excerpts/2003_09_20_19_00_2.webm;Shizuka KAMEI.jpg;1633;1733;5697;54;57;3
/net/per920a/export/das14a/satoh-lab/haolin/nhk/excerpts/2003_09_20_19_00_2.webm;Shizuka KAMEI.jpg;4761;4765;5697;158;158;0
/net/per920a/export/das14a/satoh-lab/haolin/nhk/excerpts/2003_09_20_19_00_2.webm;Shizuka KAMEI.jpg;4781;4789;5697;159;159;0
/net/per920a/export/das14a/satoh-lab/haolin/nhk/excerpts/2003_09_20_19_00_2.webm;Shizuka KAMEI.jpg;4805;4829;5697;160;161;1
/net/per920a/export/das14a/satoh-lab/haolin/nhk/excerpts/2003_09_20_19_00_2.webm;Shizuka KAMEI.jpg;4845;4849;5697;161;161;0
/net/per920a/export/das14a/satoh-lab/haolin/nhk/excerpts/2003_09_20_19_00_2.webm;Shizuka KAMEI.jpg;4865;4881;5697;162;162;0
/net/per920a/export/das14a/satoh-lab/haolin/nhk/excerpts/2003_09_20_19_00_2.webm;Shizuka KAMEI.jpg;4905;4917;5697;163;163;0
/net/per920a/export/das14a/satoh-lab/haolin/nhk/excerpts/2003_09_20_19_00_2.webm;Shizuka KAMEI.jpg;4937;4941;5697;164;164;0
/net/per920a/export/das14a/satoh-lab/haolin/nhk/excerpts/2003_09_20_19_00_2.webm;Shizuka KAMEI.jpg;4953;4957;5697;165;165;0
/net/per920a/export/das14a/satoh-lab/haolin/nhk/excerpts/2003_09_20_19_00_2.webm;Shizuka KAMEI.jpg;4977;5017;5697;165;167;2
/net/per920a/export/das14a/satoh-lab/haolin/nhk/excerpts/2003_09_20_19_00_2.webm;Shizuka KAMEI.jpg;5033;5033;5697;167;167;0
/net/per920a/export/das14a/satoh-lab/haolin/nhk/excerpts/2003_09_20_19_00_2.webm;Shizuka KAMEI.jpg;5053;5061;5697;168;168;0
/net/per920a/export/das14a/satoh-lab/haolin/nhk/excerpts/2003_09_20_19_00_2.webm;Shizuka KAMEI.jpg;5081;5133;5697;169;171;2
/net/per920a/export/das14a/satoh-lab/haolin/nhk/excerpts/2003_09_20_19_00_2.webm;Shizuka KAMEI.jpg;5169;5185;5697;172;172;0
/net/per920a/export/das14a/satoh-lab/haolin/nhk/excerpts/2003_09_20_19_00_2.webm;Junichiro KOIZUMI.jpg;1965;2145;5697;65;71;6
/net/per920a/export/das14a/satoh-lab/haolin/nhk/excerpts/2003_09_20_19_00_2.webm;Junichiro KOIZUMI.jpg;2161;2513;5697;72;83;11
/net/per920a/export/das14a/satoh-lab/haolin/nhk/excerpts/2003_09_20_19_00_2.webm;Junichiro KOIZUMI.jpg;3597;3597;5697;119;119;0
/net/per920a/export/das14a/satoh-lab/haolin/nhk/excerpts/2003_09_20_19_00_2.webm;Junichiro KOIZUMI.jpg;3609;3613;5697;120;120;0
/net/per920a/export/das14a/satoh-lab/haolin/nhk/excerpts/2003_09_20_19_00_2.webm;Junichiro KOIZUMI.jpg;3625;3633;5697;120;121;1
/net/per920a/export/das14a/satoh-lab/haolin/nhk/excerpts/2003_09_20_19_00_2.webm;Junichiro KOIZUMI.jpg;3649;3653;5697;121;121;0
/net/per920a/export/das14a/satoh-lab/haolin/nhk/excerpts/2003_09_20_19_00_2.webm;Junichiro KOIZUMI.jpg;3665;3665;5697;122;122;0
/net/per920a/export/das14a/satoh-lab/haolin/nhk/excerpts/2003_09_20_19_00_2.webm;Junichiro KOIZUMI.jpg;3677;3693;5697;122;123;1
/net/per920a/export/das14a/satoh-lab/haolin/nhk/excerpts/2003_09_20_19_00_2.webm;Junichiro KOIZUMI.jpg;3725;3749;5697;124;125;1
/net/per920a/export/das14a/satoh-lab/haolin/nhk/excerpts/2003_09_20_19_00_2.webm;Junichiro KOIZUMI.jpg;3765;3801;5697;125;126;1
/net/per920a/export/das14a/satoh-lab/haolin/nhk/excerpts/2003_09_20_19_00_2.webm;Junichiro KOIZUMI.jpg;3825;3829;5697;127;127;0
/net/per920a/export/das14a/satoh-lab/haolin/nhk/excerpts/2003_09_20_19_00_2.webm;Junichiro KOIZUMI.jpg;3853;3857;5697;128;128;0
/net/per920a/export/das14a/satoh-lab/haolin/nhk/excerpts/2003_09_20_19_00_2.webm;Junichiro KOIZUMI.jpg;3877;3881;5697;129;129;0
/net/per920a/export/das14a/satoh-lab/haolin/nhk/excerpts/2003_09_20_19_00_2.webm;Junichiro KOIZUMI.jpg;3893;3901;5697;129;130;1
/net/per920a/export/das14a/satoh-lab/haolin/nhk/excerpts/2003_09_20_19_00_2.webm;Junichiro KOIZUMI.jpg;5489;5497;5697;183;183;0
/net/per920a/export/das14a/satoh-lab/haolin/nhk/excerpts/2003_09_20_19_00_2.webm;Junichiro KOIZUMI.jpg;5509;5513;5697;183;183;0
/net/per920a/export/das14a/satoh-lab/haolin/nhk/excerpts/2003_09_21_19_00_1.webm;Junichiro KOIZUMI.jpg;117;181;15949;3;6;3
/net/per920a/export/das14a/satoh-lab/haolin/nhk/excerpts/2003_09_21_19_00_1.webm;Junichiro KOIZUMI.jpg;1181;3041;15949;39;101;62
/net/per920a/export/das14a/satoh-lab/haolin/nhk/excerpts/2003_09_21_19_00_1.webm;Junichiro KOIZUMI.jpg;13749;13817;15949;458;460;2
/net/per920a/export/das14a/satoh-lab/haolin/nhk/excerpts/2003_09_21_19_00_1.webm;Junichiro KOIZUMI.jpg;14041;14117;15949;468;470;2
/net/per920a/export/das14a/satoh-lab/haolin/nhk/excerpts/2003_09_21_19_00_1.webm;Junichiro KOIZUMI.jpg;15297;15897;15949;510;530;20
/net/per920a/export/das14a/satoh-lab/haolin/nhk/excerpts/2003_09_21_19_00_1.webm;Shinzo ABE.jpg;201;317;15949;6;10;4
/net/per920a/export/das14a/satoh-lab/haolin/nhk/excerpts/2003_09_21_19_00_1.webm;Shinzo ABE.jpg;3197;3457;15949;106;115;9
/net/per920a/export/das14a/satoh-lab/haolin/nhk/excerpts/2003_09_21_19_00_1.webm;Shinzo ABE.jpg;3869;3873;15949;129;129;0
/net/per920a/export/das14a/satoh-lab/haolin/nhk/excerpts/2003_09_21_19_00_1.webm;Shinzo ABE.jpg;3889;4389;15949;129;146;17
/net/per920a/export/das14a/satoh-lab/haolin/nhk/excerpts/2003_09_21_19_00_1.webm;Shinzo ABE.jpg;4413;4513;15949;147;150;3
/net/per920a/export/das14a/satoh-lab/haolin/nhk/excerpts/2003_09_21_19_00_1.webm;Shinzo ABE.jpg;4529;4561;15949;151;152;1
/net/per920a/export/das14a/satoh-lab/haolin/nhk/excerpts/2003_09_21_19_00_1.webm;Shinzo ABE.jpg;5273;5409;15949;175;180;5
/net/per920a/export/das14a/satoh-lab/haolin/nhk/excerpts/2003_09_21_19_00_1.webm;Shinzo ABE.jpg;5641;5641;15949;188;188;0
/net/per920a/export/das14a/satoh-lab/haolin/nhk/excerpts/2003_09_21_19_00_1.webm;Shinzo ABE.jpg;5653;5665;15949;188;188;0
/net/per920a/export/das14a/satoh-lab/haolin/nhk/excerpts/2003_09_21_19_00_1.webm;Shinzo ABE.jpg;5681;5681;15949;189;189;0
/net/per920a/export/das14a/satoh-lab/haolin/nhk/excerpts/2003_09_21_19_00_1.webm;Shinzo ABE.jpg;11649;11717;15949;388;390;2
/net/per920a/export/das14a/satoh-lab/haolin/nhk/excerpts/2003_09_21_19_00_1.webm;Shinzo ABE.jpg;11733;11765;15949;391;392;1
/net/per920a/export/das14a/satoh-lab/haolin/nhk/excerpts/2003_09_21_19_00_1.webm;Shinzo ABE.jpg;11781;13157;15949;392;438;46
/net/per920a/export/das14a/satoh-lab/haolin/nhk/excerpts/2003_09_21_19_00_1.webm;Shinzo ABE.jpg;14137;14193;15949;471;473;2
/net/per920a/export/das14a/satoh-lab/haolin/nhk/excerpts/2003_09_21_19_00_1.webm;Natsuo YAMAGUCHI.jpg;529;545;15949;17;18;1
/net/per920a/export/das14a/satoh-lab/haolin/nhk/excerpts/2003_09_21_19_00_1.webm;Natsuo YAMAGUCHI.jpg;9081;9121;15949;302;304;2
/net/per920a/export/das14a/satoh-lab/haolin/nhk/excerpts/2003_09_21_19_00_1.webm;Natsuo YAMAGUCHI.jpg;9165;9173;15949;305;305;0
/net/per920a/export/das14a/satoh-lab/haolin/nhk/excerpts/2003_09_21_19_00_1.webm;Natsuo YAMAGUCHI.jpg;9201;9201;15949;306;306;0
/net/per920a/export/das14a/satoh-lab/haolin/nhk/excerpts/2003_09_21_19_00_1.webm;Natsuo YAMAGUCHI.jpg;9233;9245;15949;307;308;1
/net/per920a/export/das14a/satoh-lab/haolin/nhk/excerpts/2003_09_21_19_00_1.webm;Natsuo YAMAGUCHI.jpg;9277;9277;15949;309;309;0
/net/per920a/export/das14a/satoh-lab/haolin/nhk/excerpts/2003_09_21_19_00_1.webm;Natsuo YAMAGUCHI.jpg;9297;9297;15949;310;310;0
/net/per920a/export/das14a/satoh-lab/haolin/nhk/excerpts/2003_09_21_19_00_1.webm;Natsuo YAMAGUCHI.jpg;9309;9309;15949;310;310;0
/net/per920a/export/das14a/satoh-lab/haolin/nhk/excerpts/2003_09_21_19_00_1.webm;Natsuo YAMAGUCHI.jpg;9365;9365;15949;312;312;0
/net/per920a/export/das14a/satoh-lab/haolin/nhk/excerpts/2003_09_21_19_00_1.webm;Natsuo YAMAGUCHI.jpg;9381;9385;15949;312;313;1
/net/per920a/export/das14a/satoh-lab/haolin/nhk/excerpts/2003_09_21_19_00_1.webm;Natsuo YAMAGUCHI.jpg;9409;9409;15949;313;313;0
/net/per920a/export/das14a/satoh-lab/haolin/nhk/excerpts/2003_09_21_19_00_1.webm;Natsuo YAMAGUCHI.jpg;9441;9461;15949;314;315;1
/net/per920a/export/das14a/satoh-lab/haolin/nhk/excerpts/2003_09_21_19_00_1.webm;Natsuo YAMAGUCHI.jpg;9477;9493;15949;316;316;0
/net/per920a/export/das14a/satoh-lab/haolin/nhk/excerpts/2003_09_21_19_00_1.webm;Natsuo YAMAGUCHI.jpg;13933;13993;15949;464;466;2
/net/per920a/export/das14a/satoh-lab/haolin/nhk/excerpts/2003_09_21_19_00_1.webm;Natsuo YAMAGUCHI.jpg;14005;14029;15949;467;467;0
/net/per920a/export/das14a/satoh-lab/haolin/nhk/excerpts/2003_09_30_19_00_3.webm;Junichiro KOIZUMI.jpg;3269;3329;3333;108;110;2
/net/per920a/export/das14a/satoh-lab/haolin/nhk/excerpts/2003_11_14_19_00_1.webm;Junichiro KOIZUMI.jpg;1405;1553;13281;46;51;5
/net/per920a/export/das14a/satoh-lab/haolin/nhk/excerpts/2003_11_14_19_00_1.webm;Junichiro KOIZUMI.jpg;1633;1665;13281;54;55;1
/net/per920a/export/das14a/satoh-lab/haolin/nhk/excerpts/2003_11_14_19_00_1.webm;Junichiro KOIZUMI.jpg;1905;1937;13281;63;64;1
/net/per920a/export/das14a/satoh-lab/haolin/nhk/excerpts/2003_11_14_19_00_1.webm;Junichiro KOIZUMI.jpg;1949;1965;13281;65;65;0
/net/per920a/export/das14a/satoh-lab/haolin/nhk/excerpts/2003_11_14_19_00_1.webm;Junichiro KOIZUMI.jpg;1985;2017;13281;66;67;1
/net/per920a/export/das14a/satoh-lab/haolin/nhk/excerpts/2003_11_14_19_00_1.webm;Junichiro KOIZUMI.jpg;2625;2677;13281;87;89;2
/net/per920a/export/das14a/satoh-lab/haolin/nhk/excerpts/2003_11_14_19_00_1.webm;Yasuo FUKUDA.jpg;5649;5681;13281;188;189;1
/net/per920a/export/das14a/satoh-lab/haolin/nhk/excerpts/2003_11_14_19_00_1.webm;Yasuo FUKUDA.jpg;5697;7513;13281;190;250;60
/net/per920a/export/das14a/satoh-lab/haolin/nhk/excerpts/2003_12_05_19_00_3.webm;Yukio EDANO.jpg;5517;5521;10221;184;184;0
/net/per920a/export/das14a/satoh-lab/haolin/nhk/excerpts/2003_12_05_19_00_3.webm;Yukio EDANO.jpg;5537;5541;10221;184;184;0
/net/per920a/export/das14a/satoh-lab/haolin/nhk/excerpts/2003_12_05_19_00_3.webm;Katsuya OKADA.jpg;6761;7401;10221;225;246;21
/net/per920a/export/das14a/satoh-lab/haolin/nhk/excerpts/2003_12_06_19_00_1.webm;Junichiro KOIZUMI.jpg;4669;4677;11249;155;155;0
/net/per920a/export/das14a/satoh-lab/haolin/nhk/excerpts/2003_12_06_19_00_1.webm;Junichiro KOIZUMI.jpg;4705;4709;11249;156;156;0
/net/per920a/export/das14a/satoh-lab/haolin/nhk/excerpts/2003_12_06_19_00_1.webm;Junichiro KOIZUMI.jpg;4725;4773;11249;157;159;2
/net/per920a/export/das14a/satoh-lab/haolin/nhk/excerpts/2003_12_08_19_00_2.webm;Shinzo ABE.jpg;1193;1261;2253;39;41;2
/net/per920a/export/das14a/satoh-lab/haolin/nhk/excerpts/2003_12_11_19_00_1.webm;Yasuo FUKUDA.jpg;6281;6357;9001;209;211;2
/net/per920a/export/das14a/satoh-lab/haolin/nhk/excerpts/2003_12_11_19_00_1.webm;Yasuo FUKUDA.jpg;6373;6509;9001;212;216;4
/net/per920a/export/das14a/satoh-lab/haolin/nhk/excerpts/2003_12_11_19_00_1.webm;Yasuo FUKUDA.jpg;6529;6565;9001;217;218;1
/net/per920a/export/das14a/satoh-lab/haolin/nhk/excerpts/2003_12_11_19_00_1.webm;Yasuo FUKUDA.jpg;6581;6609;9001;219;220;1
/net/per920a/export/das14a/satoh-lab/haolin/nhk/excerpts/2003_12_11_19_00_1.webm;Yasuo FUKUDA.jpg;6625;6725;9001;220;224;4
/net/per920a/export/das14a/satoh-lab/haolin/nhk/excerpts/2003_12_11_19_00_1.webm;Yasuo FUKUDA.jpg;6749;6749;9001;224;224;0
/net/per920a/export/das14a/satoh-lab/haolin/nhk/excerpts/2003_12_11_19_00_1.webm;Yasuo FUKUDA.jpg;6765;6789;9001;225;226;1
/net/per920a/export/das14a/satoh-lab/haolin/nhk/excerpts/2003_12_11_19_00_1.webm;Yasuo FUKUDA.jpg;6809;6837;9001;226;227;1
/net/per920a/export/das14a/satoh-lab/haolin/nhk/excerpts/2003_12_11_19_00_1.webm;Yasuo FUKUDA.jpg;6853;7493;9001;228;249;21
/net/per920a/export/das14a/satoh-lab/haolin/nhk/excerpts/2003_12_12_19_00_2.webm;Junichiro KOIZUMI.jpg;765;769;13941;25;25;0
/net/per920a/export/das14a/satoh-lab/haolin/nhk/excerpts/2003_12_12_19_00_2.webm;Junichiro KOIZUMI.jpg;785;797;13941;26;26;0
/net/per920a/export/das14a/satoh-lab/haolin/nhk/excerpts/2003_12_12_19_00_2.webm;Junichiro KOIZUMI.jpg;813;849;13941;27;28;1
/net/per920a/export/das14a/satoh-lab/haolin/nhk/excerpts/2003_12_12_19_00_2.webm;Junichiro KOIZUMI.jpg;2333;4033;13941;77;134;57
/net/per920a/export/das14a/satoh-lab/haolin/nhk/excerpts/2003_12_12_19_00_2.webm;Junichiro KOIZUMI.jpg;4593;4849;13941;153;161;8
/net/per920a/export/das14a/satoh-lab/haolin/nhk/excerpts/2003_12_12_19_00_2.webm;Junichiro KOIZUMI.jpg;4865;4977;13941;162;166;4
/net/per920a/export/das14a/satoh-lab/haolin/nhk/excerpts/2003_12_12_19_00_2.webm;Junichiro KOIZUMI.jpg;5137;5205;13941;171;173;2
/net/per920a/export/das14a/satoh-lab/haolin/nhk/excerpts/2003_12_12_19_00_2.webm;Junichiro KOIZUMI.jpg;5381;5381;13941;179;179;0
/net/per920a/export/das14a/satoh-lab/haolin/nhk/excerpts/2003_12_12_19_00_2.webm;Junichiro KOIZUMI.jpg;5393;5397;13941;179;180;1
/net/per920a/export/das14a/satoh-lab/haolin/nhk/excerpts/2003_12_12_19_00_2.webm;Junichiro KOIZUMI.jpg;5413;5425;13941;180;180;0
/net/per920a/export/das14a/satoh-lab/haolin/nhk/excerpts/2003_12_12_19_00_2.webm;Junichiro KOIZUMI.jpg;5669;6145;13941;189;204;15
/net/per920a/export/das14a/satoh-lab/haolin/nhk/excerpts/2003_12_22_19_00_1.webm;Junichiro KOIZUMI.jpg;25;665;14245;0;22;22
/net/per920a/export/das14a/satoh-lab/haolin/nhk/excerpts/2003_12_22_19_00_1.webm;Junichiro KOIZUMI.jpg;681;701;14245;22;23;1
/net/per920a/export/das14a/satoh-lab/haolin/nhk/excerpts/2003_12_22_19_00_1.webm;Junichiro KOIZUMI.jpg;3125;3221;14245;104;107;3
/net/per920a/export/das14a/satoh-lab/haolin/nhk/excerpts/2003_12_22_19_00_1.webm;Junichiro KOIZUMI.jpg;5393;5473;14245;179;182;3
/net/per920a/export/das14a/satoh-lab/haolin/nhk/excerpts/2003_12_22_19_00_1.webm;Junichiro KOIZUMI.jpg;7053;7201;14245;235;240;5
/net/per920a/export/das14a/satoh-lab/haolin/nhk/excerpts/2003_12_22_19_00_1.webm;Junichiro KOIZUMI.jpg;9221;9333;14245;307;311;4
/net/per920a/export/das14a/satoh-lab/haolin/nhk/excerpts/2003_12_22_19_00_1.webm;Junichiro KOIZUMI.jpg;11153;11413;14245;371;380;9
/net/per920a/export/das14a/satoh-lab/haolin/nhk/excerpts/2003_12_22_19_00_1.webm;Junichiro KOIZUMI.jpg;11749;11825;14245;391;394;3
/net/per920a/export/das14a/satoh-lab/haolin/nhk/excerpts/2003_12_22_19_00_1.webm;Junichiro KOIZUMI.jpg;11837;11913;14245;394;397;3
/net/per920a/export/das14a/satoh-lab/haolin/nhk/excerpts/2003_12_22_19_00_1.webm;Junichiro KOIZUMI.jpg;11925;11929;14245;397;397;0
/net/per920a/export/das14a/satoh-lab/haolin/nhk/excerpts/2003_12_22_19_00_1.webm;Junichiro KOIZUMI.jpg;11949;11953;14245;398;398;0
/net/per920a/export/das14a/satoh-lab/haolin/nhk/excerpts/2003_12_22_19_00_1.webm;Junichiro KOIZUMI.jpg;12653;12837;14245;421;428;7
/net/per920a/export/das14a/satoh-lab/haolin/nhk/excerpts/2003_12_22_19_00_1.webm;Shinzo ABE.jpg;833;869;14245;27;28;1
/net/per920a/export/das14a/satoh-lab/haolin/nhk/excerpts/2003_12_22_19_00_1.webm;Shinzo ABE.jpg;897;1013;14245;29;33;4
/net/per920a/export/das14a/satoh-lab/haolin/nhk/excerpts/2003_12_22_19_00_1.webm;Shinzo ABE.jpg;1253;1265;14245;41;42;1
/net/per920a/export/das14a/satoh-lab/haolin/nhk/excerpts/2003_12_22_19_00_1.webm;Shinzo ABE.jpg;1281;1281;14245;42;42;0
/net/per920a/export/das14a/satoh-lab/haolin/nhk/excerpts/2003_12_22_19_00_1.webm;Shinzo ABE.jpg;1297;1301;14245;43;43;0
/net/per920a/export/das14a/satoh-lab/haolin/nhk/excerpts/2003_12_22_19_00_1.webm;Shinzo ABE.jpg;1313;1361;14245;43;45;2
/net/per920a/export/das14a/satoh-lab/haolin/nhk/excerpts/2003_12_22_19_00_1.webm;Shinzo ABE.jpg;1397;1397;14245;46;46;0
/net/per920a/export/das14a/satoh-lab/haolin/nhk/excerpts/2003_12_22_19_00_1.webm;Shinzo ABE.jpg;1449;1449;14245;48;48;0
/net/per920a/export/das14a/satoh-lab/haolin/nhk/excerpts/2003_12_22_19_00_1.webm;Shinzo ABE.jpg;1465;1469;14245;48;48;0
/net/per920a/export/das14a/satoh-lab/haolin/nhk/excerpts/2003_12_22_19_00_1.webm;Yasuo FUKUDA.jpg;5485;5669;14245;182;189;7
/net/per920a/export/das14a/satoh-lab/haolin/nhk/excerpts/2003_12_22_19_00_1.webm;Yasuo FUKUDA.jpg;5685;6013;14245;189;200;11
/net/per920a/export/das14a/satoh-lab/haolin/nhk/excerpts/2003_12_22_19_00_1.webm;Yasuo FUKUDA.jpg;6029;6041;14245;201;201;0
/net/per920a/export/das14a/satoh-lab/haolin/nhk/excerpts/2003_12_22_19_00_1.webm;Yasuo FUKUDA.jpg;6057;6065;14245;201;202;1
/net/per920a/export/das14a/satoh-lab/haolin/nhk/excerpts/2003_12_22_19_00_1.webm;Yasuo FUKUDA.jpg;6081;6153;14245;202;205;3
/net/per920a/export/das14a/satoh-lab/haolin/nhk/excerpts/2003_12_22_19_00_1.webm;Yasuo FUKUDA.jpg;6181;6185;14245;206;206;0
/net/per920a/export/das14a/satoh-lab/haolin/nhk/excerpts/2003_12_22_19_00_1.webm;Yasuo FUKUDA.jpg;6201;6401;14245;206;213;7
/net/per920a/export/das14a/satoh-lab/haolin/nhk/excerpts/2003_12_22_19_00_1.webm;Yasuo FUKUDA.jpg;6417;6429;14245;213;214;1
/net/per920a/export/das14a/satoh-lab/haolin/nhk/excerpts/2004_01_21_19_00_2.webm;Junichiro KOIZUMI.jpg;269;269;17661;8;8;0
/net/per920a/export/das14a/satoh-lab/haolin/nhk/excerpts/2004_01_21_19_00_2.webm;Junichiro KOIZUMI.jpg;285;309;17661;9;10;1
/net/per920a/export/das14a/satoh-lab/haolin/nhk/excerpts/2004_01_21_19_00_2.webm;Junichiro KOIZUMI.jpg;325;365;17661;10;12;2
/net/per920a/export/das14a/satoh-lab/haolin/nhk/excerpts/2004_01_21_19_00_2.webm;Junichiro KOIZUMI.jpg;4365;4457;17661;145;148;3
/net/per920a/export/das14a/satoh-lab/haolin/nhk/excerpts/2004_01_21_19_00_2.webm;Junichiro KOIZUMI.jpg;5357;5377;17661;178;179;1
/net/per920a/export/das14a/satoh-lab/haolin/nhk/excerpts/2004_01_21_19_00_2.webm;Junichiro KOIZUMI.jpg;5409;6077;17661;180;202;22
/net/per920a/export/das14a/satoh-lab/haolin/nhk/excerpts/2004_01_21_19_00_2.webm;Junichiro KOIZUMI.jpg;7837;8513;17661;261;283;22
/net/per920a/export/das14a/satoh-lab/haolin/nhk/excerpts/2004_01_21_19_00_2.webm;Naoto KAN.jpg;417;609;17661;13;20;7
/net/per920a/export/das14a/satoh-lab/haolin/nhk/excerpts/2004_01_21_19_00_2.webm;Naoto KAN.jpg;625;773;17661;20;25;5
/net/per920a/export/das14a/satoh-lab/haolin/nhk/excerpts/2004_01_21_19_00_2.webm;Naoto KAN.jpg;845;845;17661;28;28;0
/net/per920a/export/das14a/satoh-lab/haolin/nhk/excerpts/2004_01_21_19_00_2.webm;Naoto KAN.jpg;861;861;17661;28;28;0
/net/per920a/export/das14a/satoh-lab/haolin/nhk/excerpts/2004_01_21_19_00_2.webm;Naoto KAN.jpg;877;881;17661;29;29;0
/net/per920a/export/das14a/satoh-lab/haolin/nhk/excerpts/2004_01_21_19_00_2.webm;Naoto KAN.jpg;897;913;17661;29;30;1
/net/per920a/export/das14a/satoh-lab/haolin/nhk/excerpts/2004_01_21_19_00_2.webm;Naoto KAN.jpg;929;929;17661;30;30;0
/net/per920a/export/das14a/satoh-lab/haolin/nhk/excerpts/2004_01_21_19_00_2.webm;Naoto KAN.jpg;945;1197;17661;31;39;8
/net/per920a/export/das14a/satoh-lab/haolin/nhk/excerpts/2004_01_21_19_00_2.webm;Naoto KAN.jpg;2181;2181;17661;72;72;0
/net/per920a/export/das14a/satoh-lab/haolin/nhk/excerpts/2004_01_21_19_00_2.webm;Naoto KAN.jpg;2193;3057;17661;73;101;28
/net/per920a/export/das14a/satoh-lab/haolin/nhk/excerpts/2004_01_21_19_00_2.webm;Naoto KAN.jpg;5053;5341;17661;168;178;10
/net/per920a/export/das14a/satoh-lab/haolin/nhk/excerpts/2004_01_21_19_00_2.webm;Takenori KANZAKI.jpg;14293;14401;17661;476;480;4
/net/per920a/export/das14a/satoh-lab/haolin/nhk/excerpts/2004_02_13_19_00_1.webm;Yasuo FUKUDA.jpg;1581;1825;6113;52;60;8
/net/per920a/export/das14a/satoh-lab/haolin/nhk/excerpts/2004_02_13_19_00_1.webm;Yasuo FUKUDA.jpg;1841;1841;6113;61;61;0
/net/per920a/export/das14a/satoh-lab/haolin/nhk/excerpts/2004_02_13_19_00_1.webm;Yasuo FUKUDA.jpg;1857;1865;6113;61;62;1
/net/per920a/export/das14a/satoh-lab/haolin/nhk/excerpts/2004_02_13_19_00_1.webm;Yasuo FUKUDA.jpg;1889;1909;6113;63;63;0
/net/per920a/export/das14a/satoh-lab/haolin/nhk/excerpts/2004_02_13_19_00_1.webm;Yasuo FUKUDA.jpg;1929;1981;6113;64;66;2
/net/per920a/export/das14a/satoh-lab/haolin/nhk/excerpts/2004_02_13_19_00_1.webm;Yasuo FUKUDA.jpg;2001;2013;6113;66;67;1
/net/per920a/export/das14a/satoh-lab/haolin/nhk/excerpts/2004_02_13_19_00_1.webm;Yasuo FUKUDA.jpg;2037;2045;6113;67;68;1
/net/per920a/export/das14a/satoh-lab/haolin/nhk/excerpts/2004_02_13_19_00_1.webm;Yasuo FUKUDA.jpg;2061;2073;6113;68;69;1
/net/per920a/export/das14a/satoh-lab/haolin/nhk/excerpts/2004_02_13_19_00_1.webm;Yasuo FUKUDA.jpg;2093;2117;6113;69;70;1
/net/per920a/export/das14a/satoh-lab/haolin/nhk/excerpts/2004_02_13_19_00_1.webm;Yasuo FUKUDA.jpg;2141;2169;6113;71;72;1
/net/per920a/export/das14a/satoh-lab/haolin/nhk/excerpts/2004_02_13_19_00_1.webm;Yasuo FUKUDA.jpg;2185;2253;6113;72;75;3
/net/per920a/export/das14a/satoh-lab/haolin/nhk/excerpts/2004_02_13_19_00_1.webm;Yasuo FUKUDA.jpg;2269;2269;6113;75;75;0
/net/per920a/export/das14a/satoh-lab/haolin/nhk/excerpts/2004_02_13_19_00_1.webm;Yasuo FUKUDA.jpg;2301;2305;6113;76;76;0
/net/per920a/export/das14a/satoh-lab/haolin/nhk/excerpts/2004_02_13_19_00_1.webm;Yasuo FUKUDA.jpg;2321;2329;6113;77;77;0
/net/per920a/export/das14a/satoh-lab/haolin/nhk/excerpts/2004_02_13_19_00_1.webm;Yasuo FUKUDA.jpg;2345;2373;6113;78;79;1
/net/per920a/export/das14a/satoh-lab/haolin/nhk/excerpts/2004_02_13_19_00_1.webm;Yasuo FUKUDA.jpg;2393;2461;6113;79;82;3
/net/per920a/export/das14a/satoh-lab/haolin/nhk/excerpts/2004_02_13_19_00_1.webm;Yasuo FUKUDA.jpg;2477;2485;6113;82;82;0
/net/per920a/export/das14a/satoh-lab/haolin/nhk/excerpts/2004_02_13_19_00_1.webm;Yasuo FUKUDA.jpg;2501;2525;6113;83;84;1
/net/per920a/export/das14a/satoh-lab/haolin/nhk/excerpts/2004_02_13_19_00_1.webm;Yasuo FUKUDA.jpg;2541;2589;6113;84;86;2
/net/per920a/export/das14a/satoh-lab/haolin/nhk/excerpts/2004_02_13_19_00_1.webm;Yasuo FUKUDA.jpg;2609;2609;6113;87;87;0
/net/per920a/export/das14a/satoh-lab/haolin/nhk/excerpts/2004_02_13_19_00_1.webm;Yasuo FUKUDA.jpg;2621;2649;6113;87;88;1
/net/per920a/export/das14a/satoh-lab/haolin/nhk/excerpts/2004_02_13_19_00_1.webm;Yasuo FUKUDA.jpg;2665;2673;6113;88;89;1
/net/per920a/export/das14a/satoh-lab/haolin/nhk/excerpts/2004_02_13_19_00_1.webm;Yasuo FUKUDA.jpg;2689;2693;6113;89;89;0
/net/per920a/export/das14a/satoh-lab/haolin/nhk/excerpts/2004_02_13_19_00_1.webm;Yasuo FUKUDA.jpg;2709;2881;6113;90;96;6
/net/per920a/export/das14a/satoh-lab/haolin/nhk/excerpts/2004_02_13_19_00_1.webm;Shinzo ABE.jpg;4477;4697;6113;149;156;7
/net/per920a/export/das14a/satoh-lab/haolin/nhk/excerpts/2004_02_13_19_00_1.webm;Shinzo ABE.jpg;4717;5013;6113;157;167;10
/net/per920a/export/das14a/satoh-lab/haolin/nhk/excerpts/2004_02_13_19_00_1.webm;Shinzo ABE.jpg;5029;5637;6113;167;188;21
/net/per920a/export/das14a/satoh-lab/haolin/nhk/excerpts/2004_02_15_19_00_1.webm;Junichiro KOIZUMI.jpg;9;461;7561;0;15;15
/net/per920a/export/das14a/satoh-lab/haolin/nhk/excerpts/2004_02_15_19_00_1.webm;Junichiro KOIZUMI.jpg;1313;2113;7561;43;70;27
/net/per920a/export/das14a/satoh-lab/haolin/nhk/excerpts/2004_02_15_19_00_1.webm;Junichiro KOIZUMI.jpg;4121;4349;7561;137;144;7
/net/per920a/export/das14a/satoh-lab/haolin/nhk/excerpts/2004_02_15_19_00_1.webm;Junichiro KOIZUMI.jpg;5741;6009;7561;191;200;9
/net/per920a/export/das14a/satoh-lab/haolin/nhk/excerpts/2004_02_15_19_00_1.webm;Yasuo FUKUDA.jpg;2501;2505;7561;83;83;0
/net/per920a/export/das14a/satoh-lab/haolin/nhk/excerpts/2004_02_15_19_00_1.webm;Yasuo FUKUDA.jpg;2521;2681;7561;84;89;5
/net/per920a/export/das14a/satoh-lab/haolin/nhk/excerpts/2004_02_15_19_00_1.webm;Yasuo FUKUDA.jpg;2697;2785;7561;89;92;3
/net/per920a/export/das14a/satoh-lab/haolin/nhk/excerpts/2004_02_15_19_00_1.webm;Yasuo FUKUDA.jpg;2817;2817;7561;93;93;0
/net/per920a/export/das14a/satoh-lab/haolin/nhk/excerpts/2004_02_15_19_00_1.webm;Yasuo FUKUDA.jpg;2837;2841;7561;94;94;0
/net/per920a/export/das14a/satoh-lab/haolin/nhk/excerpts/2004_02_15_19_00_1.webm;Yasuo FUKUDA.jpg;2857;2909;7561;95;96;1
/net/per920a/export/das14a/satoh-lab/haolin/nhk/excerpts/2004_02_15_19_00_1.webm;Yasuo FUKUDA.jpg;2925;2933;7561;97;97;0
/net/per920a/export/das14a/satoh-lab/haolin/nhk/excerpts/2004_02_15_19_00_1.webm;Yasuo FUKUDA.jpg;2957;2965;7561;98;98;0
/net/per920a/export/das14a/satoh-lab/haolin/nhk/excerpts/2004_02_15_19_00_1.webm;Yasuo FUKUDA.jpg;2981;3077;7561;99;102;3
/net/per920a/export/das14a/satoh-lab/haolin/nhk/excerpts/2004_02_15_19_00_1.webm;Yasuo FUKUDA.jpg;3093;3101;7561;103;103;0
/net/per920a/export/das14a/satoh-lab/haolin/nhk/excerpts/2004_02_15_19_00_1.webm;Yasuo FUKUDA.jpg;3117;3121;7561;103;104;1
/net/per920a/export/das14a/satoh-lab/haolin/nhk/excerpts/2004_02_15_19_00_1.webm;Yasuo FUKUDA.jpg;3137;3161;7561;104;105;1
/net/per920a/export/das14a/satoh-lab/haolin/nhk/excerpts/2004_02_15_19_00_1.webm;Yasuo FUKUDA.jpg;3181;3197;7561;106;106;0
/net/per920a/export/das14a/satoh-lab/haolin/nhk/excerpts/2004_02_15_19_00_1.webm;Yasuo FUKUDA.jpg;3213;3217;7561;107;107;0
/net/per920a/export/das14a/satoh-lab/haolin/nhk/excerpts/2004_02_15_19_00_1.webm;Yasuo FUKUDA.jpg;3233;3245;7561;107;108;1
/net/per920a/export/das14a/satoh-lab/haolin/nhk/excerpts/2004_02_15_19_00_1.webm;Yasuo FUKUDA.jpg;3261;3289;7561;108;109;1
/net/per920a/export/das14a/satoh-lab/haolin/nhk/excerpts/2004_02_15_19_00_1.webm;Yasuo FUKUDA.jpg;3309;3325;7561;110;110;0
/net/per920a/export/das14a/satoh-lab/haolin/nhk/excerpts/2004_02_15_19_00_1.webm;Yasuo FUKUDA.jpg;3345;3385;7561;111;112;1
/net/per920a/export/das14a/satoh-lab/haolin/nhk/excerpts/2004_02_15_19_00_1.webm;Yasuo FUKUDA.jpg;3401;3529;7561;113;117;4
/net/per920a/export/das14a/satoh-lab/haolin/nhk/excerpts/2004_02_15_19_00_1.webm;Yasuo FUKUDA.jpg;3569;3589;7561;118;119;1
/net/per920a/export/das14a/satoh-lab/haolin/nhk/excerpts/2004_02_15_19_00_1.webm;Yasuo FUKUDA.jpg;3605;3653;7561;120;121;1
/net/per920a/export/das14a/satoh-lab/haolin/nhk/excerpts/2004_02_15_19_00_1.webm;Yasuo FUKUDA.jpg;3665;3665;7561;122;122;0
/net/per920a/export/das14a/satoh-lab/haolin/nhk/excerpts/2004_02_15_19_00_1.webm;Yasuo FUKUDA.jpg;3677;4109;7561;122;136;14
/net/per920a/export/das14a/satoh-lab/haolin/nhk/excerpts/2004_02_15_19_00_1.webm;Takenori KANZAKI.jpg;4365;4365;7561;145;145;0
/net/per920a/export/das14a/satoh-lab/haolin/nhk/excerpts/2004_02_15_19_00_1.webm;Takenori KANZAKI.jpg;4405;4405;7561;146;146;0
/net/per920a/export/das14a/satoh-lab/haolin/nhk/excerpts/2004_02_15_19_00_1.webm;Takenori KANZAKI.jpg;4417;4417;7561;147;147;0
/net/per920a/export/das14a/satoh-lab/haolin/nhk/excerpts/2004_02_15_19_00_1.webm;Takenori KANZAKI.jpg;4437;4441;7561;147;148;1
/net/per920a/export/das14a/satoh-lab/haolin/nhk/excerpts/2004_02_15_19_00_1.webm;Takenori KANZAKI.jpg;4481;4481;7561;149;149;0
/net/per920a/export/das14a/satoh-lab/haolin/nhk/excerpts/2004_02_15_19_00_1.webm;Takenori KANZAKI.jpg;4525;4525;7561;150;150;0
/net/per920a/export/das14a/satoh-lab/haolin/nhk/excerpts/2004_02_15_19_00_1.webm;Takenori KANZAKI.jpg;4541;4549;7561;151;151;0
/net/per920a/export/das14a/satoh-lab/haolin/nhk/excerpts/2004_02_15_19_00_1.webm;Takenori KANZAKI.jpg;4565;4573;7561;152;152;0
/net/per920a/export/das14a/satoh-lab/haolin/nhk/excerpts/2004_02_15_19_00_1.webm;Takenori KANZAKI.jpg;4625;4625;7561;154;154;0
/net/per920a/export/das14a/satoh-lab/haolin/nhk/excerpts/2004_02_15_19_00_1.webm;Takenori KANZAKI.jpg;4637;4665;7561;154;155;1
/net/per920a/export/das14a/satoh-lab/haolin/nhk/excerpts/2004_02_15_19_00_1.webm;Takenori KANZAKI.jpg;4681;4713;7561;156;157;1
/net/per920a/export/das14a/satoh-lab/haolin/nhk/excerpts/2004_02_15_19_00_1.webm;Takenori KANZAKI.jpg;4737;4769;7561;157;158;1
/net/per920a/export/das14a/satoh-lab/haolin/nhk/excerpts/2004_02_15_19_00_1.webm;Takenori KANZAKI.jpg;4801;4833;7561;160;161;1
/net/per920a/export/das14a/satoh-lab/haolin/nhk/excerpts/2004_02_15_19_00_1.webm;Takenori KANZAKI.jpg;4849;4853;7561;161;161;0
/net/per920a/export/das14a/satoh-lab/haolin/nhk/excerpts/2004_02_15_19_00_1.webm;Takenori KANZAKI.jpg;4865;4865;7561;162;162;0
/net/per920a/export/das14a/satoh-lab/haolin/nhk/excerpts/2004_02_15_19_00_1.webm;Takenori KANZAKI.jpg;4877;4889;7561;162;162;0
/net/per920a/export/das14a/satoh-lab/haolin/nhk/excerpts/2004_02_15_19_00_1.webm;Takenori KANZAKI.jpg;4905;4933;7561;163;164;1
/net/per920a/export/das14a/satoh-lab/haolin/nhk/excerpts/2004_02_15_19_00_1.webm;Takenori KANZAKI.jpg;4949;4997;7561;164;166;2
/net/per920a/export/das14a/satoh-lab/haolin/nhk/excerpts/2004_02_15_19_00_1.webm;Naoto KAN.jpg;5061;5729;7561;168;190;22
/net/per920a/export/das14a/satoh-lab/haolin/nhk/excerpts/2004_03_11_19_00_3.webm;Shintaro ISHIHARA.jpg;9;393;1901;0;13;13
/net/per920a/export/das14a/satoh-lab/haolin/nhk/excerpts/2004_03_11_19_00_3.webm;Shintaro ISHIHARA.jpg;405;1285;1901;13;42;29
/net/per920a/export/das14a/satoh-lab/haolin/nhk/excerpts/2004_03_24_19_00_1.webm;Yasuo FUKUDA.jpg;2965;3653;13257;98;121;23
/net/per920a/export/das14a/satoh-lab/haolin/nhk/excerpts/2004_03_24_19_00_1.webm;Junichiro KOIZUMI.jpg;4377;4849;13257;145;161;16
/net/per920a/export/das14a/satoh-lab/haolin/nhk/excerpts/2004_03_24_19_00_1.webm;Junichiro KOIZUMI.jpg;4865;5013;13257;162;167;5
/net/per920a/export/das14a/satoh-lab/haolin/nhk/excerpts/2004_03_24_19_00_1.webm;Junichiro KOIZUMI.jpg;5029;5037;13257;167;167;0
/net/per920a/export/das14a/satoh-lab/haolin/nhk/excerpts/2004_03_24_19_00_1.webm;Junichiro KOIZUMI.jpg;5053;5061;13257;168;168;0
/net/per920a/export/das14a/satoh-lab/haolin/nhk/excerpts/2004_03_24_19_00_1.webm;Junichiro KOIZUMI.jpg;5077;5397;13257;169;179;10
/net/per920a/export/das14a/satoh-lab/haolin/nhk/excerpts/2004_05_07_19_00_1.webm;Yasuo FUKUDA.jpg;337;441;30129;11;14;3
/net/per920a/export/das14a/satoh-lab/haolin/nhk/excerpts/2004_05_07_19_00_1.webm;Yasuo FUKUDA.jpg;457;505;30129;15;16;1
/net/per920a/export/das14a/satoh-lab/haolin/nhk/excerpts/2004_05_07_19_00_1.webm;Yasuo FUKUDA.jpg;1073;1197;30129;35;39;4
/net/per920a/export/das14a/satoh-lab/haolin/nhk/excerpts/2004_05_07_19_00_1.webm;Yasuo FUKUDA.jpg;1213;1221;30129;40;40;0
/net/per920a/export/das14a/satoh-lab/haolin/nhk/excerpts/2004_05_07_19_00_1.webm;Yasuo FUKUDA.jpg;1237;1237;30129;41;41;0
/net/per920a/export/das14a/satoh-lab/haolin/nhk/excerpts/2004_05_07_19_00_1.webm;Yasuo FUKUDA.jpg;1269;1277;30129;42;42;0
/net/per920a/export/das14a/satoh-lab/haolin/nhk/excerpts/2004_05_07_19_00_1.webm;Yasuo FUKUDA.jpg;1293;2301;30129;43;76;33
/net/per920a/export/das14a/satoh-lab/haolin/nhk/excerpts/2004_05_07_19_00_1.webm;Yasuo FUKUDA.jpg;2317;2677;30129;77;89;12
/net/per920a/export/das14a/satoh-lab/haolin/nhk/excerpts/2004_05_07_19_00_1.webm;Yasuo FUKUDA.jpg;2693;4565;30129;89;152;63
/net/per920a/export/das14a/satoh-lab/haolin/nhk/excerpts/2004_05_07_19_00_1.webm;Yasuo FUKUDA.jpg;4893;4937;30129;163;164;1
/net/per920a/export/das14a/satoh-lab/haolin/nhk/excerpts/2004_05_07_19_00_1.webm;Yasuo FUKUDA.jpg;4973;5057;30129;165;168;3
/net/per920a/export/das14a/satoh-lab/haolin/nhk/excerpts/2004_05_07_19_00_1.webm;Yasuo FUKUDA.jpg;24405;24489;30129;814;816;2
/net/per920a/export/das14a/satoh-lab/haolin/nhk/excerpts/2004_05_07_19_00_1.webm;Yasuo FUKUDA.jpg;24505;24613;30129;817;821;4
/net/per920a/export/das14a/satoh-lab/haolin/nhk/excerpts/2004_05_07_19_00_1.webm;Yasuo FUKUDA.jpg;24625;24629;30129;821;821;0
/net/per920a/export/das14a/satoh-lab/haolin/nhk/excerpts/2004_05_07_19_00_1.webm;Yasuo FUKUDA.jpg;24641;24673;30129;821;823;2
/net/per920a/export/das14a/satoh-lab/haolin/nhk/excerpts/2004_05_07_19_00_1.webm;Yasuo FUKUDA.jpg;26333;26357;30129;878;879;1
/net/per920a/export/das14a/satoh-lab/haolin/nhk/excerpts/2004_05_07_19_00_1.webm;Yasuo FUKUDA.jpg;26381;26401;30129;879;880;1
/net/per920a/export/das14a/satoh-lab/haolin/nhk/excerpts/2004_05_07_19_00_1.webm;Yasuo FUKUDA.jpg;26417;26489;30129;881;883;2
/net/per920a/export/das14a/satoh-lab/haolin/nhk/excerpts/2004_05_07_19_00_1.webm;Yasuo FUKUDA.jpg;27893;28053;30129;930;935;5
/net/per920a/export/das14a/satoh-lab/haolin/nhk/excerpts/2004_05_07_19_00_1.webm;Yasuo FUKUDA.jpg;28065;28129;30129;936;938;2
/net/per920a/export/das14a/satoh-lab/haolin/nhk/excerpts/2004_05_07_19_00_1.webm;Yasuo FUKUDA.jpg;28145;28385;30129;938;946;8
/net/per920a/export/das14a/satoh-lab/haolin/nhk/excerpts/2004_05_07_19_00_1.webm;Yasuo FUKUDA.jpg;28401;28449;30129;947;948;1
/net/per920a/export/das14a/satoh-lab/haolin/nhk/excerpts/2004_05_07_19_00_1.webm;Yasuo FUKUDA.jpg;28469;28545;30129;949;952;3
/net/per920a/export/das14a/satoh-lab/haolin/nhk/excerpts/2004_05_07_19_00_1.webm;Yasuo FUKUDA.jpg;28561;28645;30129;952;955;3
/net/per920a/export/das14a/satoh-lab/haolin/nhk/excerpts/2004_05_07_19_00_1.webm;Yasuo FUKUDA.jpg;28661;28665;30129;956;956;0
/net/per920a/export/das14a/satoh-lab/haolin/nhk/excerpts/2004_05_07_19_00_1.webm;Yasuo FUKUDA.jpg;28681;28737;30129;956;958;2
/net/per920a/export/das14a/satoh-lab/haolin/nhk/excerpts/2004_05_07_19_00_1.webm;Yasuo FUKUDA.jpg;29477;29481;30129;983;983;0
/net/per920a/export/das14a/satoh-lab/haolin/nhk/excerpts/2004_05_07_19_00_1.webm;Yasuo FUKUDA.jpg;29493;29533;30129;983;985;2
/net/per920a/export/das14a/satoh-lab/haolin/nhk/excerpts/2004_05_07_19_00_1.webm;Yasuo FUKUDA.jpg;29549;29601;30129;985;987;2
/net/per920a/export/das14a/satoh-lab/haolin/nhk/excerpts/2004_05_07_19_00_1.webm;Yasuo FUKUDA.jpg;29629;29637;30129;988;988;0
/net/per920a/export/das14a/satoh-lab/haolin/nhk/excerpts/2004_05_07_19_00_1.webm;Junichiro KOIZUMI.jpg;5465;5465;30129;182;182;0
/net/per920a/export/das14a/satoh-lab/haolin/nhk/excerpts/2004_05_07_19_00_1.webm;Junichiro KOIZUMI.jpg;5549;5553;30129;185;185;0
/net/per920a/export/das14a/satoh-lab/haolin/nhk/excerpts/2004_05_07_19_00_1.webm;Junichiro KOIZUMI.jpg;5565;5569;30129;185;185;0
/net/per920a/export/das14a/satoh-lab/haolin/nhk/excerpts/2004_05_07_19_00_1.webm;Junichiro KOIZUMI.jpg;5589;5605;30129;186;186;0
/net/per920a/export/das14a/satoh-lab/haolin/nhk/excerpts/2004_05_07_19_00_1.webm;Junichiro KOIZUMI.jpg;5617;5625;30129;187;187;0
/net/per920a/export/das14a/satoh-lab/haolin/nhk/excerpts/2004_05_07_19_00_1.webm;Junichiro KOIZUMI.jpg;5645;5669;30129;188;189;1
/net/per920a/export/das14a/satoh-lab/haolin/nhk/excerpts/2004_05_07_19_00_1.webm;Junichiro KOIZUMI.jpg;5705;5729;30129;190;191;1
/net/per920a/export/das14a/satoh-lab/haolin/nhk/excerpts/2004_05_07_19_00_1.webm;Junichiro KOIZUMI.jpg;5745;5973;30129;191;199;8
/net/per920a/export/das14a/satoh-lab/haolin/nhk/excerpts/2004_05_07_19_00_1.webm;Junichiro KOIZUMI.jpg;14685;15581;30129;489;519;30
/net/per920a/export/das14a/satoh-lab/haolin/nhk/excerpts/2004_05_07_19_00_1.webm;Junichiro KOIZUMI.jpg;15605;15605;30129;520;520;0
/net/per920a/export/das14a/satoh-lab/haolin/nhk/excerpts/2004_05_07_19_00_1.webm;Junichiro KOIZUMI.jpg;15621;15673;30129;521;522;1
/net/per920a/export/das14a/satoh-lab/haolin/nhk/excerpts/2004_05_07_19_00_1.webm;Junichiro KOIZUMI.jpg;15689;15721;30129;523;524;1
/net/per920a/export/das14a/satoh-lab/haolin/nhk/excerpts/2004_05_07_19_00_1.webm;Junichiro KOIZUMI.jpg;15737;16589;30129;524;553;29
/net/per920a/export/das14a/satoh-lab/haolin/nhk/excerpts/2004_05_07_19_00_1.webm;Junichiro KOIZUMI.jpg;16605;17273;30129;553;576;23
/net/per920a/export/das14a/satoh-lab/haolin/nhk/excerpts/2004_05_07_19_00_1.webm;Junichiro KOIZUMI.jpg;17289;17385;30129;576;579;3
/net/per920a/export/das14a/satoh-lab/haolin/nhk/excerpts/2004_05_07_19_00_1.webm;Junichiro KOIZUMI.jpg;17401;17909;30129;580;597;17
/net/per920a/export/das14a/satoh-lab/haolin/nhk/excerpts/2004_05_07_19_00_1.webm;Junichiro KOIZUMI.jpg;17925;18525;30129;597;617;20
/net/per920a/export/das14a/satoh-lab/haolin/nhk/excerpts/2004_05_07_19_00_1.webm;Junichiro KOIZUMI.jpg;27049;27101;30129;902;903;1
/net/per920a/export/das14a/satoh-lab/haolin/nhk/excerpts/2004_05_07_19_00_1.webm;Junichiro KOIZUMI.jpg;27125;27137;30129;904;905;1
/net/per920a/export/das14a/satoh-lab/haolin/nhk/excerpts/2004_05_07_19_00_1.webm;Sadakazu TANIGAKI.jpg;9833;10129;30129;327;337;10
/net/per920a/export/das14a/satoh-lab/haolin/nhk/excerpts/2004_05_07_19_00_1.webm;Sadakazu TANIGAKI.jpg;11365;11369;30129;379;379;0
/net/per920a/export/das14a/satoh-lab/haolin/nhk/excerpts/2004_05_07_19_00_1.webm;Sadakazu TANIGAKI.jpg;11445;11461;30129;381;382;1
/net/per920a/export/das14a/satoh-lab/haolin/nhk/excerpts/2004_05_07_19_00_1.webm;Taro ASO.jpg;10417;10425;30129;347;347;0
/net/per920a/export/das14a/satoh-lab/haolin/nhk/excerpts/2004_05_07_19_00_1.webm;Taro ASO.jpg;10489;10497;30129;349;350;1
/net/per920a/export/das14a/satoh-lab/haolin/nhk/excerpts/2004_05_07_19_00_1.webm;Taro ASO.jpg;10537;10541;30129;351;351;0
/net/per920a/export/das14a/satoh-lab/haolin/nhk/excerpts/2004_05_07_19_00_1.webm;Taro ASO.jpg;10625;10625;30129;354;354;0
/net/per920a/export/das14a/satoh-lab/haolin/nhk/excerpts/2004_05_07_19_00_1.webm;Taro ASO.jpg;10669;10673;30129;355;356;1
/net/per920a/export/das14a/satoh-lab/haolin/nhk/excerpts/2004_05_07_19_00_1.webm;Taro ASO.jpg;10685;10685;30129;356;356;0
/net/per920a/export/das14a/satoh-lab/haolin/nhk/excerpts/2004_05_07_19_00_1.webm;Taro ASO.jpg;10701;10705;30129;356;357;1
/net/per920a/export/das14a/satoh-lab/haolin/nhk/excerpts/2004_05_07_19_00_1.webm;Taro ASO.jpg;10717;10721;30129;357;357;0
/net/per920a/export/das14a/satoh-lab/haolin/nhk/excerpts/2004_05_07_19_00_1.webm;Taro ASO.jpg;10805;10833;30129;360;361;1
/net/per920a/export/das14a/satoh-lab/haolin/nhk/excerpts/2004_05_07_19_00_1.webm;Taro ASO.jpg;10849;10853;30129;361;362;1
/net/per920a/export/das14a/satoh-lab/haolin/nhk/excerpts/2004_05_07_19_00_1.webm;Taro ASO.jpg;10869;10877;30129;362;362;0
/net/per920a/export/das14a/satoh-lab/haolin/nhk/excerpts/2004_05_07_19_00_1.webm;Taro ASO.jpg;10917;10921;30129;364;364;0
/net/per920a/export/das14a/satoh-lab/haolin/nhk/excerpts/2004_05_07_19_00_1.webm;Taro ASO.jpg;10933;10937;30129;364;364;0
/net/per920a/export/das14a/satoh-lab/haolin/nhk/excerpts/2004_05_07_19_00_1.webm;Toru Hashimoto.jpg;12981;12981;30129;433;433;0
/net/per920a/export/das14a/satoh-lab/haolin/nhk/excerpts/2004_05_07_19_00_1.webm;Toru Hashimoto.jpg;12997;13001;30129;433;433;0
/net/per920a/export/das14a/satoh-lab/haolin/nhk/excerpts/2004_05_07_19_00_1.webm;Toru Hashimoto.jpg;13013;13021;30129;434;434;0
/net/per920a/export/das14a/satoh-lab/haolin/nhk/excerpts/2004_05_07_19_00_1.webm;Naoto KAN.jpg;18553;19073;30129;618;636;18
/net/per920a/export/das14a/satoh-lab/haolin/nhk/excerpts/2004_05_07_19_00_1.webm;Naoto KAN.jpg;19121;19125;30129;637;637;0
/net/per920a/export/das14a/satoh-lab/haolin/nhk/excerpts/2004_05_07_19_00_1.webm;Naoto KAN.jpg;19137;19137;30129;638;638;0
/net/per920a/export/das14a/satoh-lab/haolin/nhk/excerpts/2004_05_07_19_00_1.webm;Naoto KAN.jpg;19153;19161;30129;638;639;1
/net/per920a/export/das14a/satoh-lab/haolin/nhk/excerpts/2004_05_07_19_00_1.webm;Naoto KAN.jpg;19225;19233;30129;641;641;0
/net/per920a/export/das14a/satoh-lab/haolin/nhk/excerpts/2004_05_07_19_00_1.webm;Naoto KAN.jpg;19341;19365;30129;645;645;0
/net/per920a/export/das14a/satoh-lab/haolin/nhk/excerpts/2004_05_07_19_00_1.webm;Naoto KAN.jpg;19405;19453;30129;647;648;1
/net/per920a/export/das14a/satoh-lab/haolin/nhk/excerpts/2004_05_07_19_00_1.webm;Naoto KAN.jpg;19533;19661;30129;651;655;4
/net/per920a/export/das14a/satoh-lab/haolin/nhk/excerpts/2004_05_07_19_00_1.webm;Naoto KAN.jpg;19677;19677;30129;656;656;0
/net/per920a/export/das14a/satoh-lab/haolin/nhk/excerpts/2004_05_07_19_00_1.webm;Naoto KAN.jpg;19701;19793;30129;657;660;3
/net/per920a/export/das14a/satoh-lab/haolin/nhk/excerpts/2004_05_07_19_00_1.webm;Naoto KAN.jpg;20313;20373;30129;677;679;2
/net/per920a/export/das14a/satoh-lab/haolin/nhk/excerpts/2004_05_07_19_00_1.webm;Naoto KAN.jpg;20385;20389;30129;679;680;1
/net/per920a/export/das14a/satoh-lab/haolin/nhk/excerpts/2004_05_07_19_00_1.webm;Naoto KAN.jpg;20621;20649;30129;687;688;1
/net/per920a/export/das14a/satoh-lab/haolin/nhk/excerpts/2004_05_07_19_00_1.webm;Naoto KAN.jpg;20677;20765;30129;689;692;3
/net/per920a/export/das14a/satoh-lab/haolin/nhk/excerpts/2004_05_07_19_00_1.webm;Naoto KAN.jpg;20805;20901;30129;693;697;4
/net/per920a/export/das14a/satoh-lab/haolin/nhk/excerpts/2004_05_07_19_00_1.webm;Naoto KAN.jpg;21865;21921;30129;729;731;2
/net/per920a/export/das14a/satoh-lab/haolin/nhk/excerpts/2004_05_07_19_00_1.webm;Naoto KAN.jpg;23361;23425;30129;779;781;2
/net/per920a/export/das14a/satoh-lab/haolin/nhk/excerpts/2004_05_07_19_00_1.webm;Naoto KAN.jpg;23881;24021;30129;796;801;5
/net/per920a/export/das14a/satoh-lab/haolin/nhk/excerpts/2004_05_07_19_00_1.webm;Naoto KAN.jpg;24037;24393;30129;801;813;12
/net/per920a/export/das14a/satoh-lab/haolin/nhk/excerpts/2004_05_07_19_00_1.webm;Naoto KAN.jpg;29849;29981;30129;995;1000;5
/net/per920a/export/das14a/satoh-lab/haolin/nhk/excerpts/2004_05_07_19_00_1.webm;Naoto KAN.jpg;29997;29997;30129;1000;1000;0
/net/per920a/export/das14a/satoh-lab/haolin/nhk/excerpts/2004_05_07_19_00_1.webm;Naoto KAN.jpg;30033;30125;30129;1001;1004;3
/net/per920a/export/das14a/satoh-lab/haolin/nhk/excerpts/2004_05_07_19_00_1.webm;Katsuya OKADA.jpg;22809;22833;30129;760;761;1
/net/per920a/export/das14a/satoh-lab/haolin/nhk/excerpts/2004_05_07_19_00_1.webm;Katsuya OKADA.jpg;22845;22857;30129;762;762;0
/net/per920a/export/das14a/satoh-lab/haolin/nhk/excerpts/2004_05_07_19_00_1.webm;Katsuya OKADA.jpg;23049;23065;30129;768;769;1
/net/per920a/export/das14a/satoh-lab/haolin/nhk/excerpts/2004_05_07_19_00_1.webm;Katsuya OKADA.jpg;23081;23093;30129;769;770;1
/net/per920a/export/das14a/satoh-lab/haolin/nhk/excerpts/2004_05_07_19_00_1.webm;Katsuya OKADA.jpg;23641;23681;30129;788;789;1
/net/per920a/export/das14a/satoh-lab/haolin/nhk/excerpts/2004_05_07_19_00_1.webm;Katsuya OKADA.jpg;25841;25893;30129;861;863;2
/net/per920a/export/das14a/satoh-lab/haolin/nhk/excerpts/2004_05_07_19_00_1.webm;Shinzo ABE.jpg;25793;25821;30129;860;861;1
/net/per920a/export/das14a/satoh-lab/haolin/nhk/excerpts/2004_05_07_19_00_1.webm;Natsuo YAMAGUCHI.jpg;29097;29397;30129;970;980;10
/net/per920a/export/das14a/satoh-lab/haolin/nhk/excerpts/2004_05_09_19_00_1.webm;Naoto KAN.jpg;253;349;19721;8;11;3
/net/per920a/export/das14a/satoh-lab/haolin/nhk/excerpts/2004_05_09_19_00_1.webm;Naoto KAN.jpg;377;465;19721;12;15;3
/net/per920a/export/das14a/satoh-lab/haolin/nhk/excerpts/2004_05_09_19_00_1.webm;Naoto KAN.jpg;513;565;19721;17;18;1
/net/per920a/export/das14a/satoh-lab/haolin/nhk/excerpts/2004_05_09_19_00_1.webm;Naoto KAN.jpg;577;577;19721;19;19;0
/net/per920a/export/das14a/satoh-lab/haolin/nhk/excerpts/2004_05_09_19_00_1.webm;Naoto KAN.jpg;597;681;19721;19;22;3
/net/per920a/export/das14a/satoh-lab/haolin/nhk/excerpts/2004_05_09_19_00_1.webm;Naoto KAN.jpg;1253;1257;19721;41;41;0
/net/per920a/export/das14a/satoh-lab/haolin/nhk/excerpts/2004_05_09_19_00_1.webm;Naoto KAN.jpg;1269;1281;19721;42;42;0
/net/per920a/export/das14a/satoh-lab/haolin/nhk/excerpts/2004_05_09_19_00_1.webm;Naoto KAN.jpg;1301;1305;19721;43;43;0
/net/per920a/export/das14a/satoh-lab/haolin/nhk/excerpts/2004_05_09_19_00_1.webm;Naoto KAN.jpg;1317;1317;19721;43;43;0
/net/per920a/export/das14a/satoh-lab/haolin/nhk/excerpts/2004_05_09_19_00_1.webm;Naoto KAN.jpg;1329;1329;19721;44;44;0
/net/per920a/export/das14a/satoh-lab/haolin/nhk/excerpts/2004_05_09_19_00_1.webm;Naoto KAN.jpg;1677;1689;19721;55;56;1
/net/per920a/export/das14a/satoh-lab/haolin/nhk/excerpts/2004_05_09_19_00_1.webm;Naoto KAN.jpg;1705;1713;19721;56;57;1
/net/per920a/export/das14a/satoh-lab/haolin/nhk/excerpts/2004_05_09_19_00_1.webm;Naoto KAN.jpg;1725;1769;19721;57;59;2
/net/per920a/export/das14a/satoh-lab/haolin/nhk/excerpts/2004_05_09_19_00_1.webm;Naoto KAN.jpg;1781;1785;19721;59;59;0
/net/per920a/export/das14a/satoh-lab/haolin/nhk/excerpts/2004_05_09_19_00_1.webm;Naoto KAN.jpg;1829;1849;19721;61;61;0
/net/per920a/export/das14a/satoh-lab/haolin/nhk/excerpts/2004_05_09_19_00_1.webm;Naoto KAN.jpg;1861;1897;19721;62;63;1
/net/per920a/export/das14a/satoh-lab/haolin/nhk/excerpts/2004_05_09_19_00_1.webm;Naoto KAN.jpg;1913;1925;19721;63;64;1
/net/per920a/export/das14a/satoh-lab/haolin/nhk/excerpts/2004_05_09_19_00_1.webm;Naoto KAN.jpg;1941;1961;19721;64;65;1
/net/per920a/export/das14a/satoh-lab/haolin/nhk/excerpts/2004_05_09_19_00_1.webm;Naoto KAN.jpg;1977;2077;19721;65;69;4
/net/per920a/export/das14a/satoh-lab/haolin/nhk/excerpts/2004_05_09_19_00_1.webm;Naoto KAN.jpg;2093;2109;19721;69;70;1
/net/per920a/export/das14a/satoh-lab/haolin/nhk/excerpts/2004_05_09_19_00_1.webm;Naoto KAN.jpg;2125;2133;19721;70;71;1
/net/per920a/export/das14a/satoh-lab/haolin/nhk/excerpts/2004_05_09_19_00_1.webm;Naoto KAN.jpg;2149;2173;19721;71;72;1
/net/per920a/export/das14a/satoh-lab/haolin/nhk/excerpts/2004_05_09_19_00_1.webm;Naoto KAN.jpg;2197;2213;19721;73;73;0
/net/per920a/export/das14a/satoh-lab/haolin/nhk/excerpts/2004_05_09_19_00_1.webm;Naoto KAN.jpg;2229;2313;19721;74;77;3
/net/per920a/export/das14a/satoh-lab/haolin/nhk/excerpts/2004_05_09_19_00_1.webm;Naoto KAN.jpg;2325;2325;19721;77;77;0
/net/per920a/export/das14a/satoh-lab/haolin/nhk/excerpts/2004_05_09_19_00_1.webm;Naoto KAN.jpg;2345;2365;19721;78;78;0
/net/per920a/export/das14a/satoh-lab/haolin/nhk/excerpts/2004_05_09_19_00_1.webm;Naoto KAN.jpg;2381;2417;19721;79;80;1
/net/per920a/export/das14a/satoh-lab/haolin/nhk/excerpts/2004_05_09_19_00_1.webm;Naoto KAN.jpg;2437;2437;19721;81;81;0
/net/per920a/export/das14a/satoh-lab/haolin/nhk/excerpts/2004_05_09_19_00_1.webm;Naoto KAN.jpg;2449;2449;19721;81;81;0
/net/per920a/export/das14a/satoh-lab/haolin/nhk/excerpts/2004_05_09_19_00_1.webm;Naoto KAN.jpg;2465;2513;19721;82;83;1
/net/per920a/export/das14a/satoh-lab/haolin/nhk/excerpts/2004_05_09_19_00_1.webm;Naoto KAN.jpg;2529;2573;19721;84;85;1
/net/per920a/export/das14a/satoh-lab/haolin/nhk/excerpts/2004_05_09_19_00_1.webm;Naoto KAN.jpg;2689;2733;19721;89;91;2
/net/per920a/export/das14a/satoh-lab/haolin/nhk/excerpts/2004_05_09_19_00_1.webm;Naoto KAN.jpg;2773;2789;19721;92;93;1
/net/per920a/export/das14a/satoh-lab/haolin/nhk/excerpts/2004_05_09_19_00_1.webm;Naoto KAN.jpg;2801;2829;19721;93;94;1
/net/per920a/export/das14a/satoh-lab/haolin/nhk/excerpts/2004_05_09_19_00_1.webm;Naoto KAN.jpg;2845;2909;19721;94;97;3
/net/per920a/export/das14a/satoh-lab/haolin/nhk/excerpts/2004_05_09_19_00_1.webm;Naoto KAN.jpg;2925;2933;19721;97;97;0
/net/per920a/export/das14a/satoh-lab/haolin/nhk/excerpts/2004_05_09_19_00_1.webm;Naoto KAN.jpg;2949;3005;19721;98;100;2
/net/per920a/export/das14a/satoh-lab/haolin/nhk/excerpts/2004_05_09_19_00_1.webm;Naoto KAN.jpg;3025;3045;19721;100;101;1
/net/per920a/export/das14a/satoh-lab/haolin/nhk/excerpts/2004_05_09_19_00_1.webm;Naoto KAN.jpg;3061;3113;19721;102;103;1
/net/per920a/export/das14a/satoh-lab/haolin/nhk/excerpts/2004_05_09_19_00_1.webm;Naoto KAN.jpg;3125;3125;19721;104;104;0
/net/per920a/export/das14a/satoh-lab/haolin/nhk/excerpts/2004_05_09_19_00_1.webm;Naoto KAN.jpg;3137;3141;19721;104;104;0
/net/per920a/export/das14a/satoh-lab/haolin/nhk/excerpts/2004_05_09_19_00_1.webm;Naoto KAN.jpg;3169;3221;19721;105;107;2
/net/per920a/export/das14a/satoh-lab/haolin/nhk/excerpts/2004_05_09_19_00_1.webm;Naoto KAN.jpg;3233;3233;19721;107;107;0
/net/per920a/export/das14a/satoh-lab/haolin/nhk/excerpts/2004_05_09_19_00_1.webm;Naoto KAN.jpg;3245;3257;19721;108;108;0
/net/per920a/export/das14a/satoh-lab/haolin/nhk/excerpts/2004_05_09_19_00_1.webm;Naoto KAN.jpg;3273;3289;19721;109;109;0
/net/per920a/export/das14a/satoh-lab/haolin/nhk/excerpts/2004_05_09_19_00_1.webm;Naoto KAN.jpg;3321;3321;19721;110;110;0
/net/per920a/export/das14a/satoh-lab/haolin/nhk/excerpts/2004_05_09_19_00_1.webm;Naoto KAN.jpg;3353;3353;19721;111;111;0
/net/per920a/export/das14a/satoh-lab/haolin/nhk/excerpts/2004_05_09_19_00_1.webm;Naoto KAN.jpg;3369;3465;19721;112;115;3
/net/per920a/export/das14a/satoh-lab/haolin/nhk/excerpts/2004_05_09_19_00_1.webm;Naoto KAN.jpg;3505;3521;19721;116;117;1
/net/per920a/export/das14a/satoh-lab/haolin/nhk/excerpts/2004_05_09_19_00_1.webm;Naoto KAN.jpg;3537;3541;19721;118;118;0
/net/per920a/export/das14a/satoh-lab/haolin/nhk/excerpts/2004_05_09_19_00_1.webm;Naoto KAN.jpg;3561;3585;19721;118;119;1
/net/per920a/export/das14a/satoh-lab/haolin/nhk/excerpts/2004_05_09_19_00_1.webm;Naoto KAN.jpg;3601;3613;19721;120;120;0
/net/per920a/export/das14a/satoh-lab/haolin/nhk/excerpts/2004_05_09_19_00_1.webm;Naoto KAN.jpg;3633;3633;19721;121;121;0
/net/per920a/export/das14a/satoh-lab/haolin/nhk/excerpts/2004_05_09_19_00_1.webm;Naoto KAN.jpg;3657;3665;19721;122;122;0
/net/per920a/export/das14a/satoh-lab/haolin/nhk/excerpts/2004_05_09_19_00_1.webm;Naoto KAN.jpg;3685;3705;19721;122;123;1
/net/per920a/export/das14a/satoh-lab/haolin/nhk/excerpts/2004_05_09_19_00_1.webm;Naoto KAN.jpg;3749;3765;19721;125;125;0
/net/per920a/export/das14a/satoh-lab/haolin/nhk/excerpts/2004_05_09_19_00_1.webm;Naoto KAN.jpg;3817;3821;19721;127;127;0
/net/per920a/export/das14a/satoh-lab/haolin/nhk/excerpts/2004_05_09_19_00_1.webm;Naoto KAN.jpg;3869;3869;19721;129;129;0
/net/per920a/export/das14a/satoh-lab/haolin/nhk/excerpts/2004_05_09_19_00_1.webm;Naoto KAN.jpg;3945;3949;19721;131;131;0
/net/per920a/export/das14a/satoh-lab/haolin/nhk/excerpts/2004_05_09_19_00_1.webm;Naoto KAN.jpg;3973;3985;19721;132;132;0
/net/per920a/export/das14a/satoh-lab/haolin/nhk/excerpts/2004_05_09_19_00_1.webm;Naoto KAN.jpg;3997;3997;19721;133;133;0
/net/per920a/export/das14a/satoh-lab/haolin/nhk/excerpts/2004_05_09_19_00_1.webm;Naoto KAN.jpg;4013;4017;19721;133;134;1
/net/per920a/export/das14a/satoh-lab/haolin/nhk/excerpts/2004_05_09_19_00_1.webm;Naoto KAN.jpg;4037;4041;19721;134;134;0
/net/per920a/export/das14a/satoh-lab/haolin/nhk/excerpts/2004_05_09_19_00_1.webm;Naoto KAN.jpg;4057;4073;19721;135;135;0
/net/per920a/export/das14a/satoh-lab/haolin/nhk/excerpts/2004_05_09_19_00_1.webm;Naoto KAN.jpg;4113;4113;19721;137;137;0
/net/per920a/export/das14a/satoh-lab/haolin/nhk/excerpts/2004_05_09_19_00_1.webm;Naoto KAN.jpg;4145;4145;19721;138;138;0
/net/per920a/export/das14a/satoh-lab/haolin/nhk/excerpts/2004_05_09_19_00_1.webm;Naoto KAN.jpg;4169;4169;19721;139;139;0
/net/per920a/export/das14a/satoh-lab/haolin/nhk/excerpts/2004_05_09_19_00_1.webm;Naoto KAN.jpg;4185;4185;19721;139;139;0
/net/per920a/export/das14a/satoh-lab/haolin/nhk/excerpts/2004_05_09_19_00_1.webm;Naoto KAN.jpg;4205;4209;19721;140;140;0
/net/per920a/export/das14a/satoh-lab/haolin/nhk/excerpts/2004_05_09_19_00_1.webm;Naoto KAN.jpg;4285;4333;19721;142;144;2
/net/per920a/export/das14a/satoh-lab/haolin/nhk/excerpts/2004_05_09_19_00_1.webm;Naoto KAN.jpg;4377;4377;19721;146;146;0
/net/per920a/export/das14a/satoh-lab/haolin/nhk/excerpts/2004_05_09_19_00_1.webm;Naoto KAN.jpg;4401;4449;19721;146;148;2
/net/per920a/export/das14a/satoh-lab/haolin/nhk/excerpts/2004_05_09_19_00_1.webm;Naoto KAN.jpg;4461;4473;19721;148;149;1
/net/per920a/export/das14a/satoh-lab/haolin/nhk/excerpts/2004_05_09_19_00_1.webm;Naoto KAN.jpg;4501;4541;19721;150;151;1
/net/per920a/export/das14a/satoh-lab/haolin/nhk/excerpts/2004_05_09_19_00_1.webm;Naoto KAN.jpg;4565;4569;19721;152;152;0
/net/per920a/export/das14a/satoh-lab/haolin/nhk/excerpts/2004_05_09_19_00_1.webm;Naoto KAN.jpg;4593;4601;19721;153;153;0
/net/per920a/export/das14a/satoh-lab/haolin/nhk/excerpts/2004_05_09_19_00_1.webm;Naoto KAN.jpg;4653;4657;19721;155;155;0
/net/per920a/export/das14a/satoh-lab/haolin/nhk/excerpts/2004_05_09_19_00_1.webm;Naoto KAN.jpg;4697;4701;19721;156;156;0
/net/per920a/export/das14a/satoh-lab/haolin/nhk/excerpts/2004_05_09_19_00_1.webm;Naoto KAN.jpg;4729;4733;19721;157;157;0
/net/per920a/export/das14a/satoh-lab/haolin/nhk/excerpts/2004_05_09_19_00_1.webm;Naoto KAN.jpg;4765;4777;19721;158;159;1
/net/per920a/export/das14a/satoh-lab/haolin/nhk/excerpts/2004_05_09_19_00_1.webm;Naoto KAN.jpg;4809;4841;19721;160;161;1
/net/per920a/export/das14a/satoh-lab/haolin/nhk/excerpts/2004_05_09_19_00_1.webm;Naoto KAN.jpg;4893;4941;19721;163;164;1
/net/per920a/export/das14a/satoh-lab/haolin/nhk/excerpts/2004_05_09_19_00_1.webm;Naoto KAN.jpg;5009;5025;19721;167;167;0
/net/per920a/export/das14a/satoh-lab/haolin/nhk/excerpts/2004_05_09_19_00_1.webm;Naoto KAN.jpg;5037;5045;19721;168;168;0
/net/per920a/export/das14a/satoh-lab/haolin/nhk/excerpts/2004_05_09_19_00_1.webm;Naoto KAN.jpg;5061;5061;19721;168;168;0
/net/per920a/export/das14a/satoh-lab/haolin/nhk/excerpts/2004_05_09_19_00_1.webm;Naoto KAN.jpg;5073;5149;19721;169;171;2
/net/per920a/export/das14a/satoh-lab/haolin/nhk/excerpts/2004_05_09_19_00_1.webm;Naoto KAN.jpg;5185;5185;19721;172;172;0
/net/per920a/export/das14a/satoh-lab/haolin/nhk/excerpts/2004_05_09_19_00_1.webm;Naoto KAN.jpg;5225;5245;19721;174;175;1
/net/per920a/export/das14a/satoh-lab/haolin/nhk/excerpts/2004_05_09_19_00_1.webm;Naoto KAN.jpg;5261;5289;19721;175;176;1
/net/per920a/export/das14a/satoh-lab/haolin/nhk/excerpts/2004_05_09_19_00_1.webm;Naoto KAN.jpg;5301;5313;19721;176;177;1
/net/per920a/export/das14a/satoh-lab/haolin/nhk/excerpts/2004_05_09_19_00_1.webm;Naoto KAN.jpg;5325;5353;19721;177;178;1
/net/per920a/export/das14a/satoh-lab/haolin/nhk/excerpts/2004_05_09_19_00_1.webm;Naoto KAN.jpg;5437;5481;19721;181;182;1
/net/per920a/export/das14a/satoh-lab/haolin/nhk/excerpts/2004_05_09_19_00_1.webm;Naoto KAN.jpg;5493;5665;19721;183;189;6
/net/per920a/export/das14a/satoh-lab/haolin/nhk/excerpts/2004_05_09_19_00_1.webm;Naoto KAN.jpg;5681;5889;19721;189;196;7
/net/per920a/export/das14a/satoh-lab/haolin/nhk/excerpts/2004_05_09_19_00_1.webm;Naoto KAN.jpg;6709;7009;19721;223;233;10
/net/per920a/export/das14a/satoh-lab/haolin/nhk/excerpts/2004_05_09_19_00_1.webm;Naoto KAN.jpg;7589;7589;19721;253;253;0
/net/per920a/export/das14a/satoh-lab/haolin/nhk/excerpts/2004_05_09_19_00_1.webm;Naoto KAN.jpg;7601;7601;19721;253;253;0
/net/per920a/export/das14a/satoh-lab/haolin/nhk/excerpts/2004_05_09_19_00_1.webm;Naoto KAN.jpg;7621;7625;19721;254;254;0
/net/per920a/export/das14a/satoh-lab/haolin/nhk/excerpts/2004_05_09_19_00_1.webm;Naoto KAN.jpg;7641;7661;19721;254;255;1
/net/per920a/export/das14a/satoh-lab/haolin/nhk/excerpts/2004_05_09_19_00_1.webm;Naoto KAN.jpg;7693;7693;19721;256;256;0
/net/per920a/export/das14a/satoh-lab/haolin/nhk/excerpts/2004_05_09_19_00_1.webm;Naoto KAN.jpg;7705;7705;19721;257;257;0
/net/per920a/export/das14a/satoh-lab/haolin/nhk/excerpts/2004_05_09_19_00_1.webm;Naoto KAN.jpg;7721;7893;19721;257;263;6
/net/per920a/export/das14a/satoh-lab/haolin/nhk/excerpts/2004_05_09_19_00_1.webm;Naoto KAN.jpg;7909;8021;19721;263;267;4
/net/per920a/export/das14a/satoh-lab/haolin/nhk/excerpts/2004_05_09_19_00_1.webm;Naoto KAN.jpg;8045;8045;19721;268;268;0
/net/per920a/export/das14a/satoh-lab/haolin/nhk/excerpts/2004_05_09_19_00_1.webm;Naoto KAN.jpg;8057;8073;19721;268;269;1
/net/per920a/export/das14a/satoh-lab/haolin/nhk/excerpts/2004_05_09_19_00_1.webm;Naoto KAN.jpg;8097;8105;19721;270;270;0
/net/per920a/export/das14a/satoh-lab/haolin/nhk/excerpts/2004_05_09_19_00_1.webm;Naoto KAN.jpg;8121;8137;19721;270;271;1
/net/per920a/export/das14a/satoh-lab/haolin/nhk/excerpts/2004_05_09_19_00_1.webm;Naoto KAN.jpg;10113;10285;19721;337;343;6
/net/per920a/export/das14a/satoh-lab/haolin/nhk/excerpts/2004_05_09_19_00_1.webm;Naoto KAN.jpg;10981;10989;19721;366;366;0
/net/per920a/export/das14a/satoh-lab/haolin/nhk/excerpts/2004_05_09_19_00_1.webm;Naoto KAN.jpg;11005;11089;19721;367;369;2
/net/per920a/export/das14a/satoh-lab/haolin/nhk/excerpts/2004_05_09_19_00_1.webm;Naoto KAN.jpg;11177;11181;19721;372;373;1
/net/per920a/export/das14a/satoh-lab/haolin/nhk/excerpts/2004_05_09_19_00_1.webm;Naoto KAN.jpg;11193;11201;19721;373;373;0
/net/per920a/export/das14a/satoh-lab/haolin/nhk/excerpts/2004_05_09_19_00_1.webm;Naoto KAN.jpg;11221;11237;19721;374;374;0
/net/per920a/export/das14a/satoh-lab/haolin/nhk/excerpts/2004_05_09_19_00_1.webm;Naoto KAN.jpg;11253;11261;19721;375;375;0
/net/per920a/export/das14a/satoh-lab/haolin/nhk/excerpts/2004_05_09_19_00_1.webm;Naoto KAN.jpg;11277;11341;19721;376;378;2
/net/per920a/export/das14a/satoh-lab/haolin/nhk/excerpts/2004_05_09_19_00_1.webm;Naoto KAN.jpg;11369;11369;19721;379;379;0
/net/per920a/export/das14a/satoh-lab/haolin/nhk/excerpts/2004_05_09_19_00_1.webm;Naoto KAN.jpg;11381;11385;19721;379;379;0
/net/per920a/export/das14a/satoh-lab/haolin/nhk/excerpts/2004_05_09_19_00_1.webm;Naoto KAN.jpg;11397;11397;19721;380;380;0
/net/per920a/export/das14a/satoh-lab/haolin/nhk/excerpts/2004_05_09_19_00_1.webm;Naoto KAN.jpg;11409;11733;19721;380;391;11
/net/per920a/export/das14a/satoh-lab/haolin/nhk/excerpts/2004_05_09_19_00_1.webm;Naoto KAN.jpg;11757;11773;19721;392;392;0
/net/per920a/export/das14a/satoh-lab/haolin/nhk/excerpts/2004_05_09_19_00_1.webm;Naoto KAN.jpg;11785;11785;19721;393;393;0
/net/per920a/export/das14a/satoh-lab/haolin/nhk/excerpts/2004_05_09_19_00_1.webm;Naoto KAN.jpg;11797;11817;19721;393;394;1
/net/per920a/export/das14a/satoh-lab/haolin/nhk/excerpts/2004_05_09_19_00_1.webm;Naoto KAN.jpg;11829;11829;19721;394;394;0
/net/per920a/export/das14a/satoh-lab/haolin/nhk/excerpts/2004_05_09_19_00_1.webm;Naoto KAN.jpg;11845;11849;19721;395;395;0
/net/per920a/export/das14a/satoh-lab/haolin/nhk/excerpts/2004_05_09_19_00_1.webm;Naoto KAN.jpg;11861;11861;19721;395;395;0
/net/per920a/export/das14a/satoh-lab/haolin/nhk/excerpts/2004_05_09_19_00_1.webm;Naoto KAN.jpg;11881;11893;19721;396;396;0
/net/per920a/export/das14a/satoh-lab/haolin/nhk/excerpts/2004_05_09_19_00_1.webm;Naoto KAN.jpg;11913;11945;19721;397;398;1
/net/per920a/export/das14a/satoh-lab/haolin/nhk/excerpts/2004_05_09_19_00_1.webm;Naoto KAN.jpg;11973;12025;19721;399;401;2
/net/per920a/export/das14a/satoh-lab/haolin/nhk/excerpts/2004_05_09_19_00_1.webm;Naoto KAN.jpg;12037;12037;19721;401;401;0
/net/per920a/export/das14a/satoh-lab/haolin/nhk/excerpts/2004_05_09_19_00_1.webm;Naoto KAN.jpg;12377;12377;19721;412;412;0
/net/per920a/export/das14a/satoh-lab/haolin/nhk/excerpts/2004_05_09_19_00_1.webm;Naoto KAN.jpg;13333;13405;19721;444;447;3
/net/per920a/export/das14a/satoh-lab/haolin/nhk/excerpts/2004_05_09_19_00_1.webm;Naoto KAN.jpg;13421;13549;19721;447;452;5
/net/per920a/export/das14a/satoh-lab/haolin/nhk/excerpts/2004_05_09_19_00_1.webm;Naoto KAN.jpg;13565;13581;19721;452;453;1
/net/per920a/export/das14a/satoh-lab/haolin/nhk/excerpts/2004_05_09_19_00_1.webm;Naoto KAN.jpg;13601;13609;19721;453;454;1
/net/per920a/export/das14a/satoh-lab/haolin/nhk/excerpts/2004_05_09_19_00_1.webm;Naoto KAN.jpg;13629;13649;19721;454;455;1
/net/per920a/export/das14a/satoh-lab/haolin/nhk/excerpts/2004_05_09_19_00_1.webm;Naoto KAN.jpg;14933;14945;19721;498;498;0
/net/per920a/export/das14a/satoh-lab/haolin/nhk/excerpts/2004_05_09_19_00_1.webm;Naoto KAN.jpg;14965;14965;19721;499;499;0
/net/per920a/export/das14a/satoh-lab/haolin/nhk/excerpts/2004_05_09_19_00_1.webm;Naoto KAN.jpg;14977;14977;19721;499;499;0
/net/per920a/export/das14a/satoh-lab/haolin/nhk/excerpts/2004_05_09_19_00_1.webm;Naoto KAN.jpg;15005;15005;19721;500;500;0
/net/per920a/export/das14a/satoh-lab/haolin/nhk/excerpts/2004_05_09_19_00_1.webm;Naoto KAN.jpg;15037;15037;19721;501;501;0
/net/per920a/export/das14a/satoh-lab/haolin/nhk/excerpts/2004_05_09_19_00_1.webm;Naoto KAN.jpg;15169;15333;19721;506;511;5
/net/per920a/export/das14a/satoh-lab/haolin/nhk/excerpts/2004_05_09_19_00_1.webm;Naoto KAN.jpg;15453;15465;19721;515;515;0
/net/per920a/export/das14a/satoh-lab/haolin/nhk/excerpts/2004_05_09_19_00_1.webm;Naoto KAN.jpg;15493;15513;19721;516;517;1
/net/per920a/export/das14a/satoh-lab/haolin/nhk/excerpts/2004_05_09_19_00_1.webm;Naoto KAN.jpg;15529;15545;19721;518;518;0
/net/per920a/export/das14a/satoh-lab/haolin/nhk/excerpts/2004_05_09_19_00_1.webm;Naoto KAN.jpg;15561;15569;19721;519;519;0
/net/per920a/export/das14a/satoh-lab/haolin/nhk/excerpts/2004_05_09_19_00_1.webm;Naoto KAN.jpg;15585;15585;19721;520;520;0
/net/per920a/export/das14a/satoh-lab/haolin/nhk/excerpts/2004_05_09_19_00_1.webm;Naoto KAN.jpg;15617;15629;19721;521;521;0
/net/per920a/export/das14a/satoh-lab/haolin/nhk/excerpts/2004_05_09_19_00_1.webm;Naoto KAN.jpg;15673;15685;19721;522;523;1
/net/per920a/export/das14a/satoh-lab/haolin/nhk/excerpts/2004_05_09_19_00_1.webm;Naoto KAN.jpg;15701;15701;19721;523;523;0
/net/per920a/export/das14a/satoh-lab/haolin/nhk/excerpts/2004_05_09_19_00_1.webm;Naoto KAN.jpg;15717;15717;19721;524;524;0
/net/per920a/export/das14a/satoh-lab/haolin/nhk/excerpts/2004_05_09_19_00_1.webm;Naoto KAN.jpg;16569;16573;19721;552;552;0
/net/per920a/export/das14a/satoh-lab/haolin/nhk/excerpts/2004_05_09_19_00_1.webm;Naoto KAN.jpg;16609;16637;19721;554;555;1
/net/per920a/export/das14a/satoh-lab/haolin/nhk/excerpts/2004_05_09_19_00_1.webm;Naoto KAN.jpg;16665;16717;19721;556;557;1
/net/per920a/export/das14a/satoh-lab/haolin/nhk/excerpts/2004_05_09_19_00_1.webm;Naoto KAN.jpg;16733;16741;19721;558;558;0
/net/per920a/export/das14a/satoh-lab/haolin/nhk/excerpts/2004_05_09_19_00_1.webm;Naoto KAN.jpg;16757;16765;19721;559;559;0
/net/per920a/export/das14a/satoh-lab/haolin/nhk/excerpts/2004_05_09_19_00_1.webm;Naoto KAN.jpg;16897;16897;19721;563;563;0
/net/per920a/export/das14a/satoh-lab/haolin/nhk/excerpts/2004_05_09_19_00_1.webm;Naoto KAN.jpg;18861;19621;19721;629;654;25
/net/per920a/export/das14a/satoh-lab/haolin/nhk/excerpts/2004_05_09_19_00_1.webm;Yoshihiko Noda.jpg;7109;7149;19721;237;238;1
/net/per920a/export/das14a/satoh-lab/haolin/nhk/excerpts/2004_05_09_19_00_1.webm;Yoshihiko Noda.jpg;7165;7273;19721;239;242;3
/net/per920a/export/das14a/satoh-lab/haolin/nhk/excerpts/2004_05_09_19_00_1.webm;Yoshihiko Noda.jpg;7289;7433;19721;243;248;5
/net/per920a/export/das14a/satoh-lab/haolin/nhk/excerpts/2004_05_09_19_00_1.webm;Yoshihiko Noda.jpg;7449;7493;19721;248;250;2
/net/per920a/export/das14a/satoh-lab/haolin/nhk/excerpts/2004_05_09_19_00_1.webm;Yoshihiko Noda.jpg;7509;7517;19721;250;250;0
/net/per920a/export/das14a/satoh-lab/haolin/nhk/excerpts/2004_05_09_19_00_1.webm;Yoshihiko Noda.jpg;7533;7573;19721;251;252;1
/net/per920a/export/das14a/satoh-lab/haolin/nhk/excerpts/2004_05_09_19_00_1.webm;Yoshihiko Noda.jpg;7589;7589;19721;253;253;0
/net/per920a/export/das14a/satoh-lab/haolin/nhk/excerpts/2004_05_09_19_00_1.webm;Yoshihiko Noda.jpg;7601;7601;19721;253;253;0
/net/per920a/export/das14a/satoh-lab/haolin/nhk/excerpts/2004_05_09_19_00_1.webm;Yoshihiko Noda.jpg;7621;7625;19721;254;254;0
/net/per920a/export/das14a/satoh-lab/haolin/nhk/excerpts/2004_05_09_19_00_1.webm;Yoshihiko Noda.jpg;7641;7661;19721;254;255;1
/net/per920a/export/das14a/satoh-lab/haolin/nhk/excerpts/2004_05_09_19_00_1.webm;Yoshihiko Noda.jpg;7693;7693;19721;256;256;0
/net/per920a/export/das14a/satoh-lab/haolin/nhk/excerpts/2004_05_09_19_00_1.webm;Yoshihiko Noda.jpg;7705;7705;19721;257;257;0
/net/per920a/export/das14a/satoh-lab/haolin/nhk/excerpts/2004_05_09_19_00_1.webm;Yoshihiko Noda.jpg;7721;7893;19721;257;263;6
/net/per920a/export/das14a/satoh-lab/haolin/nhk/excerpts/2004_05_09_19_00_1.webm;Yoshihiko Noda.jpg;7909;8021;19721;263;267;4
/net/per920a/export/das14a/satoh-lab/haolin/nhk/excerpts/2004_05_09_19_00_1.webm;Yoshihiko Noda.jpg;8045;8045;19721;268;268;0
/net/per920a/export/das14a/satoh-lab/haolin/nhk/excerpts/2004_05_09_19_00_1.webm;Yoshihiko Noda.jpg;8057;8073;19721;268;269;1
/net/per920a/export/das14a/satoh-lab/haolin/nhk/excerpts/2004_05_09_19_00_1.webm;Yoshihiko Noda.jpg;8097;8105;19721;270;270;0
/net/per920a/export/das14a/satoh-lab/haolin/nhk/excerpts/2004_05_09_19_00_1.webm;Yoshihiko Noda.jpg;8121;8137;19721;270;271;1
/net/per920a/export/das14a/satoh-lab/haolin/nhk/excerpts/2004_05_09_19_00_1.webm;Yoshihiko Noda.jpg;8149;8193;19721;271;273;2
/net/per920a/export/das14a/satoh-lab/haolin/nhk/excerpts/2004_05_09_19_00_1.webm;Yoshihiko Noda.jpg;8209;8469;19721;273;282;9
/net/per920a/export/das14a/satoh-lab/haolin/nhk/excerpts/2004_05_09_19_00_1.webm;Yoshihiko Noda.jpg;8485;8485;19721;283;283;0
/net/per920a/export/das14a/satoh-lab/haolin/nhk/excerpts/2004_05_09_19_00_1.webm;Yoshihiko Noda.jpg;8557;8701;19721;285;290;5
/net/per920a/export/das14a/satoh-lab/haolin/nhk/excerpts/2004_05_09_19_00_1.webm;Yoshihiko Noda.jpg;8717;8785;19721;290;293;3
/net/per920a/export/das14a/satoh-lab/haolin/nhk/excerpts/2004_05_09_19_00_1.webm;Yoshihiko Noda.jpg;8821;8841;19721;294;294;0
/net/per920a/export/das14a/satoh-lab/haolin/nhk/excerpts/2004_05_09_19_00_1.webm;Yoshihiko Noda.jpg;8857;9057;19721;295;302;7
/net/per920a/export/das14a/satoh-lab/haolin/nhk/excerpts/2004_05_09_19_00_1.webm;Yoshihiko Noda.jpg;9073;9161;19721;302;305;3
/net/per920a/export/das14a/satoh-lab/haolin/nhk/excerpts/2004_05_09_19_00_1.webm;Junichiro KOIZUMI.jpg;13681;14001;19721;456;467;11
/net/per920a/export/das14a/satoh-lab/haolin/nhk/excerpts/2004_05_09_19_00_1.webm;Yasuo FUKUDA.jpg;16341;16469;19721;545;549;4
/net/per920a/export/das14a/satoh-lab/haolin/nhk/excerpts/2004_06_18_19_00_2.webm;Junichiro KOIZUMI.jpg;53;205;2877;1;6;5
/net/per920a/export/das14a/satoh-lab/haolin/nhk/excerpts/2004_06_18_19_00_2.webm;Junichiro KOIZUMI.jpg;225;625;2877;7;20;13
/net/per920a/export/das14a/satoh-lab/haolin/nhk/excerpts/2004_06_18_19_00_2.webm;Junichiro KOIZUMI.jpg;1441;1593;2877;48;53;5
/net/per920a/export/das14a/satoh-lab/haolin/nhk/excerpts/2004_06_18_19_00_2.webm;Junichiro KOIZUMI.jpg;1609;1637;2877;53;54;1
/net/per920a/export/das14a/satoh-lab/haolin/nhk/excerpts/2004_06_18_19_00_2.webm;Junichiro KOIZUMI.jpg;2373;2549;2877;79;85;6
/net/per920a/export/das14a/satoh-lab/haolin/nhk/excerpts/2004_06_18_19_00_2.webm;Junichiro KOIZUMI.jpg;2845;2873;2877;94;95;1
/net/per920a/export/das14a/satoh-lab/haolin/nhk/excerpts/2004_06_26_19_00_1.webm;Kazuo SHII.jpg;8645;8953;15537;288;298;10
/net/per920a/export/das14a/satoh-lab/haolin/nhk/excerpts/2004_06_26_19_00_1.webm;Kazuo SHII.jpg;13141;13161;15537;438;438;0
/net/per920a/export/das14a/satoh-lab/haolin/nhk/excerpts/2004_06_26_19_00_1.webm;Kazuo SHII.jpg;13177;13309;15537;439;443;4
/net/per920a/export/das14a/satoh-lab/haolin/nhk/excerpts/2004_06_26_19_00_1.webm;Kazuo SHII.jpg;13461;14269;15537;448;475;27
/net/per920a/export/das14a/satoh-lab/haolin/nhk/excerpts/2004_06_26_19_00_1.webm;Kazuo SHII.jpg;14297;14341;15537;476;478;2
/net/per920a/export/das14a/satoh-lab/haolin/nhk/excerpts/2004_06_26_19_00_1.webm;Junichiro KOIZUMI.jpg;9029;9097;15537;301;303;2
/net/per920a/export/das14a/satoh-lab/haolin/nhk/excerpts/2004_06_26_19_00_1.webm;Junichiro KOIZUMI.jpg;9389;9405;15537;313;313;0
/net/per920a/export/das14a/satoh-lab/haolin/nhk/excerpts/2004_06_26_19_00_1.webm;Junichiro KOIZUMI.jpg;9417;9445;15537;313;314;1
/net/per920a/export/das14a/satoh-lab/haolin/nhk/excerpts/2004_06_26_19_00_1.webm;Junichiro KOIZUMI.jpg;9457;9489;15537;315;316;1
/net/per920a/export/das14a/satoh-lab/haolin/nhk/excerpts/2004_06_26_19_00_1.webm;Junichiro KOIZUMI.jpg;9501;9505;15537;316;316;0
/net/per920a/export/das14a/satoh-lab/haolin/nhk/excerpts/2004_06_26_19_00_1.webm;Junichiro KOIZUMI.jpg;9517;9633;15537;317;321;4
/net/per920a/export/das14a/satoh-lab/haolin/nhk/excerpts/2004_06_26_19_00_1.webm;Junichiro KOIZUMI.jpg;9645;9645;15537;321;321;0
/net/per920a/export/das14a/satoh-lab/haolin/nhk/excerpts/2004_06_26_19_00_1.webm;Junichiro KOIZUMI.jpg;9657;9657;15537;321;321;0
/net/per920a/export/das14a/satoh-lab/haolin/nhk/excerpts/2004_06_26_19_00_1.webm;Junichiro KOIZUMI.jpg;9721;9745;15537;324;324;0
/net/per920a/export/das14a/satoh-lab/haolin/nhk/excerpts/2004_06_26_19_00_1.webm;Junichiro KOIZUMI.jpg;9761;9761;15537;325;325;0
/net/per920a/export/das14a/satoh-lab/haolin/nhk/excerpts/2004_06_26_19_00_1.webm;Junichiro KOIZUMI.jpg;9817;9913;15537;327;330;3
/net/per920a/export/das14a/satoh-lab/haolin/nhk/excerpts/2004_06_26_19_00_1.webm;Junichiro KOIZUMI.jpg;9937;10093;15537;331;336;5
/net/per920a/export/das14a/satoh-lab/haolin/nhk/excerpts/2004_06_26_19_00_1.webm;Junichiro KOIZUMI.jpg;10105;10229;15537;336;341;5
/net/per920a/export/das14a/satoh-lab/haolin/nhk/excerpts/2004_06_26_19_00_1.webm;Junichiro KOIZUMI.jpg;10245;10253;15537;341;341;0
/net/per920a/export/das14a/satoh-lab/haolin/nhk/excerpts/2004_06_26_19_00_1.webm;Junichiro KOIZUMI.jpg;10265;10305;15537;342;343;1
/net/per920a/export/das14a/satoh-lab/haolin/nhk/excerpts/2004_06_26_19_00_1.webm;Katsuya OKADA.jpg;10813;10969;15537;360;365;5
/net/per920a/export/das14a/satoh-lab/haolin/nhk/excerpts/2004_06_26_19_00_1.webm;Katsuya OKADA.jpg;11069;11289;15537;369;376;7
/net/per920a/export/das14a/satoh-lab/haolin/nhk/excerpts/2004_06_26_19_00_1.webm;Katsuya OKADA.jpg;11325;11461;15537;377;382;5
/net/per920a/export/das14a/satoh-lab/haolin/nhk/excerpts/2004_06_26_19_00_1.webm;Katsuya OKADA.jpg;11701;11773;15537;390;392;2
/net/per920a/export/das14a/satoh-lab/haolin/nhk/excerpts/2004_06_26_19_00_1.webm;Takenori KANZAKI.jpg;12177;12181;15537;405;406;1
/net/per920a/export/das14a/satoh-lab/haolin/nhk/excerpts/2004_06_26_19_00_1.webm;Takenori KANZAKI.jpg;12193;12249;15537;406;408;2
/net/per920a/export/das14a/satoh-lab/haolin/nhk/excerpts/2004_06_26_19_00_1.webm;Takenori KANZAKI.jpg;12269;12281;15537;409;409;0
/net/per920a/export/das14a/satoh-lab/haolin/nhk/excerpts/2004_06_26_19_00_1.webm;Takenori KANZAKI.jpg;12293;12393;15537;409;413;4
/net/per920a/export/das14a/satoh-lab/haolin/nhk/excerpts/2004_06_26_19_00_1.webm;Takenori KANZAKI.jpg;12405;12405;15537;413;413;0
/net/per920a/export/das14a/satoh-lab/haolin/nhk/excerpts/2004_06_26_19_00_1.webm;Takenori KANZAKI.jpg;12417;12505;15537;413;416;3
/net/per920a/export/das14a/satoh-lab/haolin/nhk/excerpts/2004_06_26_19_00_1.webm;Takenori KANZAKI.jpg;12517;12569;15537;417;419;2
/net/per920a/export/das14a/satoh-lab/haolin/nhk/excerpts/2004_06_26_19_00_1.webm;Takenori KANZAKI.jpg;12581;12737;15537;419;424;5
/net/per920a/export/das14a/satoh-lab/haolin/nhk/excerpts/2004_06_26_19_00_1.webm;Takenori KANZAKI.jpg;12749;12773;15537;425;425;0
/net/per920a/export/das14a/satoh-lab/haolin/nhk/excerpts/2004_06_26_19_00_1.webm;Takenori KANZAKI.jpg;12785;12793;15537;426;426;0
/net/per920a/export/das14a/satoh-lab/haolin/nhk/excerpts/2004_06_26_19_00_1.webm;Takenori KANZAKI.jpg;12805;12849;15537;426;428;2
/net/per920a/export/das14a/satoh-lab/haolin/nhk/excerpts/2004_06_26_19_00_1.webm;Takenori KANZAKI.jpg;12861;12913;15537;428;430;2
/net/per920a/export/das14a/satoh-lab/haolin/nhk/excerpts/2004_06_26_19_00_1.webm;Takenori KANZAKI.jpg;12961;13021;15537;432;434;2
/net/per920a/export/das14a/satoh-lab/haolin/nhk/excerpts/2004_06_26_19_00_1.webm;Takenori KANZAKI.jpg;13033;13065;15537;434;435;1
/net/per920a/export/das14a/satoh-lab/haolin/nhk/excerpts/2004_06_26_19_00_1.webm;Takenori KANZAKI.jpg;13097;13101;15537;436;436;0
/net/per920a/export/das14a/satoh-lab/haolin/nhk/excerpts/2004_11_15_19_00_1.webm;Junichiro KOIZUMI.jpg;2145;2197;23833;71;73;2
/net/per920a/export/das14a/satoh-lab/haolin/nhk/excerpts/2004_11_15_19_00_1.webm;Junichiro KOIZUMI.jpg;2213;2233;23833;73;74;1
/net/per920a/export/das14a/satoh-lab/haolin/nhk/excerpts/2004_11_15_19_00_1.webm;Junichiro KOIZUMI.jpg;2249;2265;23833;75;75;0
/net/per920a/export/das14a/satoh-lab/haolin/nhk/excerpts/2004_11_15_19_00_1.webm;Junichiro KOIZUMI.jpg;20185;20257;23833;673;675;2
/net/per920a/export/das14a/satoh-lab/haolin/nhk/excerpts/2004_11_15_19_00_1.webm;Junichiro KOIZUMI.jpg;20273;20297;23833;676;677;1
/net/per920a/export/das14a/satoh-lab/haolin/nhk/excerpts/2004_11_15_19_00_1.webm;Junichiro KOIZUMI.jpg;20413;20437;23833;680;681;1
/net/per920a/export/das14a/satoh-lab/haolin/nhk/excerpts/2004_11_30_19_00_3.webm;Junichiro KOIZUMI.jpg;709;737;11845;23;24;1
/net/per920a/export/das14a/satoh-lab/haolin/nhk/excerpts/2004_11_30_19_00_3.webm;Junichiro KOIZUMI.jpg;1577;1653;11845;52;55;3
/net/per920a/export/das14a/satoh-lab/haolin/nhk/excerpts/2004_11_30_19_00_3.webm;Junichiro KOIZUMI.jpg;1677;1677;11845;55;55;0
/net/per920a/export/das14a/satoh-lab/haolin/nhk/excerpts/2004_11_30_19_00_3.webm;Junichiro KOIZUMI.jpg;1689;1689;11845;56;56;0
/net/per920a/export/das14a/satoh-lab/haolin/nhk/excerpts/2004_11_30_19_00_3.webm;Junichiro KOIZUMI.jpg;1913;1921;11845;63;64;1
/net/per920a/export/das14a/satoh-lab/haolin/nhk/excerpts/2004_11_30_19_00_3.webm;Junichiro KOIZUMI.jpg;1937;1973;11845;64;65;1
/net/per920a/export/das14a/satoh-lab/haolin/nhk/excerpts/2004_11_30_19_00_3.webm;Junichiro KOIZUMI.jpg;1989;2009;11845;66;66;0
/net/per920a/export/das14a/satoh-lab/haolin/nhk/excerpts/2004_12_09_19_00_1.webm;Junichiro KOIZUMI.jpg;14581;15233;30689;486;508;22
/net/per920a/export/das14a/satoh-lab/haolin/nhk/excerpts/2004_12_09_19_00_1.webm;Junichiro KOIZUMI.jpg;15249;15325;30689;508;511;3
/net/per920a/export/das14a/satoh-lab/haolin/nhk/excerpts/2004_12_09_19_00_1.webm;Junichiro KOIZUMI.jpg;15437;15565;30689;515;519;4
/net/per920a/export/das14a/satoh-lab/haolin/nhk/excerpts/2004_12_09_19_00_1.webm;Junichiro KOIZUMI.jpg;15581;15897;30689;519;530;11
/net/per920a/export/das14a/satoh-lab/haolin/nhk/excerpts/2004_12_09_19_00_1.webm;Junichiro KOIZUMI.jpg;17261;17573;30689;575;586;11
/net/per920a/export/das14a/satoh-lab/haolin/nhk/excerpts/2004_12_09_19_00_1.webm;Junichiro KOIZUMI.jpg;17589;18149;30689;586;605;19
/net/per920a/export/das14a/satoh-lab/haolin/nhk/excerpts/2004_12_09_19_00_1.webm;Junichiro KOIZUMI.jpg;18285;18525;30689;610;618;8
/net/per920a/export/das14a/satoh-lab/haolin/nhk/excerpts/2004_12_09_19_00_1.webm;Junichiro KOIZUMI.jpg;18541;18553;30689;618;619;1
/net/per920a/export/das14a/satoh-lab/haolin/nhk/excerpts/2004_12_09_19_00_1.webm;Junichiro KOIZUMI.jpg;18581;18597;30689;619;620;1
/net/per920a/export/das14a/satoh-lab/haolin/nhk/excerpts/2004_12_09_19_00_1.webm;Junichiro KOIZUMI.jpg;18613;18809;30689;621;627;6
/net/per920a/export/das14a/satoh-lab/haolin/nhk/excerpts/2004_12_09_19_00_1.webm;Junichiro KOIZUMI.jpg;18825;18865;30689;628;629;1
/net/per920a/export/das14a/satoh-lab/haolin/nhk/excerpts/2004_12_09_19_00_1.webm;Junichiro KOIZUMI.jpg;18881;18885;30689;630;630;0
/net/per920a/export/das14a/satoh-lab/haolin/nhk/excerpts/2004_12_09_19_00_1.webm;Junichiro KOIZUMI.jpg;18901;19041;30689;630;635;5
/net/per920a/export/das14a/satoh-lab/haolin/nhk/excerpts/2004_12_09_19_00_1.webm;Junichiro KOIZUMI.jpg;19053;19053;30689;635;635;0
/net/per920a/export/das14a/satoh-lab/haolin/nhk/excerpts/2004_12_09_19_00_1.webm;Junichiro KOIZUMI.jpg;19065;19161;30689;636;639;3
/net/per920a/export/das14a/satoh-lab/haolin/nhk/excerpts/2004_12_09_19_00_1.webm;Junichiro KOIZUMI.jpg;19181;19205;30689;640;640;0
/net/per920a/export/das14a/satoh-lab/haolin/nhk/excerpts/2004_12_09_19_00_1.webm;Junichiro KOIZUMI.jpg;21833;22117;30689;728;737;9
/net/per920a/export/das14a/satoh-lab/haolin/nhk/excerpts/2004_12_09_19_00_1.webm;Junichiro KOIZUMI.jpg;27161;27241;30689;906;908;2
/net/per920a/export/das14a/satoh-lab/haolin/nhk/excerpts/2004_12_09_19_00_1.webm;Junichiro KOIZUMI.jpg;27257;27289;30689;909;910;1
/net/per920a/export/das14a/satoh-lab/haolin/nhk/excerpts/2004_12_09_19_00_1.webm;Junichiro KOIZUMI.jpg;27945;27993;30689;932;934;2
/net/per920a/export/das14a/satoh-lab/haolin/nhk/excerpts/2004_12_09_19_00_1.webm;Junichiro KOIZUMI.jpg;28381;28429;30689;946;948;2
/net/per920a/export/das14a/satoh-lab/haolin/nhk/excerpts/2004_12_09_19_00_1.webm;Junichiro KOIZUMI.jpg;28445;28501;30689;949;950;1
/net/per920a/export/das14a/satoh-lab/haolin/nhk/excerpts/2004_12_09_19_00_1.webm;Takenori KANZAKI.jpg;19553;19625;30689;652;654;2
/net/per920a/export/das14a/satoh-lab/haolin/nhk/excerpts/2004_12_09_19_00_1.webm;Takenori KANZAKI.jpg;19905;19909;30689;664;664;0
/net/per920a/export/das14a/satoh-lab/haolin/nhk/excerpts/2004_12_09_19_00_1.webm;Takenori KANZAKI.jpg;19993;19997;30689;667;667;0
/net/per920a/export/das14a/satoh-lab/haolin/nhk/excerpts/2004_12_09_19_00_1.webm;Takenori KANZAKI.jpg;20189;20189;30689;673;673;0
/net/per920a/export/das14a/satoh-lab/haolin/nhk/excerpts/2004_12_09_19_00_1.webm;Kazuo SHII.jpg;20941;20949;30689;698;699;1
/net/per920a/export/das14a/satoh-lab/haolin/nhk/excerpts/2004_12_09_19_00_1.webm;Kazuo SHII.jpg;20965;21001;30689;699;700;1
/net/per920a/export/das14a/satoh-lab/haolin/nhk/excerpts/2004_12_09_19_00_1.webm;Kazuo SHII.jpg;21029;21105;30689;701;704;3
/net/per920a/export/das14a/satoh-lab/haolin/nhk/excerpts/2004_12_09_19_00_1.webm;Kazuo SHII.jpg;21125;21217;30689;704;707;3
/net/per920a/export/das14a/satoh-lab/haolin/nhk/excerpts/2004_12_09_19_00_1.webm;Kazuo SHII.jpg;21237;21249;30689;708;709;1
/net/per920a/export/das14a/satoh-lab/haolin/nhk/excerpts/2004_12_09_19_00_1.webm;Kazuo SHII.jpg;21261;21285;30689;709;710;1
/net/per920a/export/das14a/satoh-lab/haolin/nhk/excerpts/2004_12_09_19_00_1.webm;Kazuo SHII.jpg;21305;21305;30689;710;710;0
/net/per920a/export/das14a/satoh-lab/haolin/nhk/excerpts/2004_12_09_19_00_1.webm;Kazuo SHII.jpg;21357;21365;30689;712;712;0
/net/per920a/export/das14a/satoh-lab/haolin/nhk/excerpts/2004_12_09_19_00_1.webm;Kazuo SHII.jpg;28193;28269;30689;940;943;3
/net/per920a/export/das14a/satoh-lab/haolin/nhk/excerpts/2004_12_09_19_00_1.webm;Mizuho FUKUSHIMA.jpg;21417;21437;30689;714;715;1
/net/per920a/export/das14a/satoh-lab/haolin/nhk/excerpts/2004_12_09_19_00_1.webm;Mizuho FUKUSHIMA.jpg;21453;21469;30689;715;716;1
/net/per920a/export/das14a/satoh-lab/haolin/nhk/excerpts/2004_12_09_19_00_1.webm;Mizuho FUKUSHIMA.jpg;21481;21493;30689;716;717;1
/net/per920a/export/das14a/satoh-lab/haolin/nhk/excerpts/2004_12_09_19_00_1.webm;Mizuho FUKUSHIMA.jpg;21505;21505;30689;717;717;0
/net/per920a/export/das14a/satoh-lab/haolin/nhk/excerpts/2004_12_09_19_00_1.webm;Mizuho FUKUSHIMA.jpg;21525;21529;30689;718;718;0
/net/per920a/export/das14a/satoh-lab/haolin/nhk/excerpts/2004_12_09_19_00_1.webm;Mizuho FUKUSHIMA.jpg;21557;21565;30689;719;719;0
/net/per920a/export/das14a/satoh-lab/haolin/nhk/excerpts/2004_12_09_19_00_1.webm;Mizuho FUKUSHIMA.jpg;21605;21629;30689;720;721;1
/net/per920a/export/das14a/satoh-lab/haolin/nhk/excerpts/2004_12_09_19_00_1.webm;Mizuho FUKUSHIMA.jpg;21681;21681;30689;723;723;0
/net/per920a/export/das14a/satoh-lab/haolin/nhk/excerpts/2004_12_09_19_00_1.webm;Mizuho FUKUSHIMA.jpg;21701;21701;30689;724;724;0
/net/per920a/export/das14a/satoh-lab/haolin/nhk/excerpts/2004_12_09_19_00_1.webm;Mizuho FUKUSHIMA.jpg;21713;21721;30689;724;724;0
/net/per920a/export/das14a/satoh-lab/haolin/nhk/excerpts/2004_12_09_19_00_1.webm;Mizuho FUKUSHIMA.jpg;21769;21777;30689;726;726;0
/net/per920a/export/das14a/satoh-lab/haolin/nhk/excerpts/2004_12_09_19_00_1.webm;Mizuho FUKUSHIMA.jpg;21805;21805;30689;727;727;0
/net/per920a/export/das14a/satoh-lab/haolin/nhk/excerpts/2004_12_09_19_00_1.webm;Mizuho FUKUSHIMA.jpg;28085;28177;30689;937;940;3
/net/per920a/export/das14a/satoh-lab/haolin/nhk/excerpts/2004_12_09_19_00_1.webm;Katsuya OKADA.jpg;28009;28049;30689;934;935;1
/net/per920a/export/das14a/satoh-lab/haolin/nhk/excerpts/2004_12_09_19_00_1.webm;Katsuya OKADA.jpg;28065;28069;30689;936;936;0
/net/per920a/export/das14a/satoh-lab/haolin/nhk/excerpts/2005_02_06_19_00_2.webm;Shinzo ABE.jpg;9;9;2161;0;0;0
/net/per920a/export/das14a/satoh-lab/haolin/nhk/excerpts/2005_02_06_19_00_2.webm;Shinzo ABE.jpg;37;57;2161;1;1;0
/net/per920a/export/das14a/satoh-lab/haolin/nhk/excerpts/2005_02_06_19_00_2.webm;Shinzo ABE.jpg;81;81;2161;2;2;0
/net/per920a/export/das14a/satoh-lab/haolin/nhk/excerpts/2005_02_06_19_00_2.webm;Shinzo ABE.jpg;109;117;2161;3;3;0
/net/per920a/export/das14a/satoh-lab/haolin/nhk/excerpts/2005_02_06_19_00_2.webm;Shinzo ABE.jpg;129;129;2161;4;4;0
/net/per920a/export/das14a/satoh-lab/haolin/nhk/excerpts/2005_02_06_19_00_2.webm;Shinzo ABE.jpg;141;177;2161;4;5;1
/net/per920a/export/das14a/satoh-lab/haolin/nhk/excerpts/2005_02_06_19_00_2.webm;Shinzo ABE.jpg;213;261;2161;7;8;1
/net/per920a/export/das14a/satoh-lab/haolin/nhk/excerpts/2005_02_06_19_00_2.webm;Shinzo ABE.jpg;277;297;2161;9;9;0
/net/per920a/export/das14a/satoh-lab/haolin/nhk/excerpts/2005_02_06_19_00_2.webm;Shinzo ABE.jpg;309;309;2161;10;10;0
/net/per920a/export/das14a/satoh-lab/haolin/nhk/excerpts/2005_02_06_19_00_2.webm;Shinzo ABE.jpg;321;349;2161;10;11;1
/net/per920a/export/das14a/satoh-lab/haolin/nhk/excerpts/2005_02_06_19_00_2.webm;Shinzo ABE.jpg;365;385;2161;12;12;0
/net/per920a/export/das14a/satoh-lab/haolin/nhk/excerpts/2005_02_06_19_00_2.webm;Shinzo ABE.jpg;409;429;2161;13;14;1
/net/per920a/export/das14a/satoh-lab/haolin/nhk/excerpts/2005_02_06_19_00_2.webm;Shinzo ABE.jpg;441;441;2161;14;14;0
/net/per920a/export/das14a/satoh-lab/haolin/nhk/excerpts/2005_02_06_19_00_2.webm;Shinzo ABE.jpg;453;461;2161;15;15;0
/net/per920a/export/das14a/satoh-lab/haolin/nhk/excerpts/2005_02_06_19_00_2.webm;Shinzo ABE.jpg;473;473;2161;15;15;0
/net/per920a/export/das14a/satoh-lab/haolin/nhk/excerpts/2005_02_06_19_00_2.webm;Shinzo ABE.jpg;493;497;2161;16;16;0
/net/per920a/export/das14a/satoh-lab/haolin/nhk/excerpts/2005_02_06_19_00_2.webm;Shinzo ABE.jpg;513;569;2161;17;18;1
/net/per920a/export/das14a/satoh-lab/haolin/nhk/excerpts/2005_02_06_19_00_2.webm;Shinzo ABE.jpg;625;1617;2161;20;53;33
/net/per920a/export/das14a/satoh-lab/haolin/nhk/excerpts/2005_02_06_19_00_2.webm;Shinzo ABE.jpg;1633;2005;2161;54;66;12
/net/per920a/export/das14a/satoh-lab/haolin/nhk/excerpts/2005_02_06_19_00_2.webm;Shinzo ABE.jpg;2021;2021;2161;67;67;0
/net/per920a/export/das14a/satoh-lab/haolin/nhk/excerpts/2005_02_06_19_00_2.webm;Shinzo ABE.jpg;2037;2037;2161;67;67;0
/net/per920a/export/das14a/satoh-lab/haolin/nhk/excerpts/2005_02_06_19_00_2.webm;Shinzo ABE.jpg;2053;2105;2161;68;70;2
/net/per920a/export/das14a/satoh-lab/haolin/nhk/excerpts/2005_03_14_19_00_3.webm;Junichiro KOIZUMI.jpg;1645;1649;7317;54;54;0
/net/per920a/export/das14a/satoh-lab/haolin/nhk/excerpts/2005_04_24_19_00_2.webm;Junichiro KOIZUMI.jpg;2101;2101;8013;70;70;0
/net/per920a/export/das14a/satoh-lab/haolin/nhk/excerpts/2005_04_24_19_00_2.webm;Junichiro KOIZUMI.jpg;2113;2113;8013;70;70;0
/net/per920a/export/das14a/satoh-lab/haolin/nhk/excerpts/2005_04_24_19_00_2.webm;Junichiro KOIZUMI.jpg;2137;2137;8013;71;71;0
/net/per920a/export/das14a/satoh-lab/haolin/nhk/excerpts/2005_04_24_19_00_2.webm;Junichiro KOIZUMI.jpg;2233;2241;8013;74;74;0
/net/per920a/export/das14a/satoh-lab/haolin/nhk/excerpts/2005_04_24_19_00_2.webm;Junichiro KOIZUMI.jpg;2253;2269;8013;75;75;0
/net/per920a/export/das14a/satoh-lab/haolin/nhk/excerpts/2005_04_24_19_00_2.webm;Junichiro KOIZUMI.jpg;2301;2301;8013;76;76;0
/net/per920a/export/das14a/satoh-lab/haolin/nhk/excerpts/2005_04_24_19_00_2.webm;Junichiro KOIZUMI.jpg;2425;2737;8013;80;91;11
/net/per920a/export/das14a/satoh-lab/haolin/nhk/excerpts/2005_04_24_19_00_2.webm;Junichiro KOIZUMI.jpg;2769;2905;8013;92;96;4
/net/per920a/export/das14a/satoh-lab/haolin/nhk/excerpts/2005_04_24_19_00_2.webm;Junichiro KOIZUMI.jpg;2921;2945;8013;97;98;1
/net/per920a/export/das14a/satoh-lab/haolin/nhk/excerpts/2005_04_24_19_00_2.webm;Junichiro KOIZUMI.jpg;2961;3193;8013;98;106;8
/net/per920a/export/das14a/satoh-lab/haolin/nhk/excerpts/2005_04_30_19_00_1.webm;Junichiro KOIZUMI.jpg;36061;36061;37921;1202;1202;0
/net/per920a/export/das14a/satoh-lab/haolin/nhk/excerpts/2005_04_30_19_00_1.webm;Junichiro KOIZUMI.jpg;36073;36073;37921;1203;1203;0
/net/per920a/export/das14a/satoh-lab/haolin/nhk/excerpts/2005_04_30_19_00_1.webm;Junichiro KOIZUMI.jpg;36089;36141;37921;1203;1205;2
/net/per920a/export/das14a/satoh-lab/haolin/nhk/excerpts/2005_04_30_19_00_1.webm;Junichiro KOIZUMI.jpg;36153;36213;37921;1206;1208;2
/net/per920a/export/das14a/satoh-lab/haolin/nhk/excerpts/2005_04_30_19_00_1.webm;Junichiro KOIZUMI.jpg;36229;36305;37921;1208;1211;3
/net/per920a/export/das14a/satoh-lab/haolin/nhk/excerpts/2005_04_30_19_00_1.webm;Junichiro KOIZUMI.jpg;36629;36633;37921;1221;1222;1
/net/per920a/export/das14a/satoh-lab/haolin/nhk/excerpts/2005_04_30_19_00_1.webm;Junichiro KOIZUMI.jpg;36645;36653;37921;1222;1222;0
/net/per920a/export/das14a/satoh-lab/haolin/nhk/excerpts/2005_04_30_19_00_1.webm;Junichiro KOIZUMI.jpg;36665;36685;37921;1223;1223;0
/net/per920a/export/das14a/satoh-lab/haolin/nhk/excerpts/2005_05_26_19_00_3.webm;Junichiro KOIZUMI.jpg;2973;3221;8009;99;107;8
/net/per920a/export/das14a/satoh-lab/haolin/nhk/excerpts/2005_05_26_19_00_3.webm;Junichiro KOIZUMI.jpg;4861;4869;8009;162;162;0
/net/per920a/export/das14a/satoh-lab/haolin/nhk/excerpts/2005_05_26_19_00_3.webm;Junichiro KOIZUMI.jpg;5581;5581;8009;186;186;0
/net/per920a/export/das14a/satoh-lab/haolin/nhk/excerpts/2005_05_26_19_00_3.webm;Junichiro KOIZUMI.jpg;5597;5597;8009;186;186;0
/net/per920a/export/das14a/satoh-lab/haolin/nhk/excerpts/2005_05_26_19_00_3.webm;Junichiro KOIZUMI.jpg;5617;5657;8009;187;188;1
/net/per920a/export/das14a/satoh-lab/haolin/nhk/excerpts/2005_05_26_19_00_3.webm;Junichiro KOIZUMI.jpg;5677;5701;8009;189;190;1
/net/per920a/export/das14a/satoh-lab/haolin/nhk/excerpts/2005_05_26_19_00_3.webm;Junichiro KOIZUMI.jpg;5721;5765;8009;190;192;2
/net/per920a/export/das14a/satoh-lab/haolin/nhk/excerpts/2005_05_26_19_00_3.webm;Junichiro KOIZUMI.jpg;5781;5781;8009;192;192;0
/net/per920a/export/das14a/satoh-lab/haolin/nhk/excerpts/2005_05_26_19_00_3.webm;Junichiro KOIZUMI.jpg;5797;5829;8009;193;194;1
/net/per920a/export/das14a/satoh-lab/haolin/nhk/excerpts/2005_05_26_19_00_3.webm;Junichiro KOIZUMI.jpg;5853;5857;8009;195;195;0
/net/per920a/export/das14a/satoh-lab/haolin/nhk/excerpts/2005_05_26_19_00_3.webm;Junichiro KOIZUMI.jpg;5869;5881;8009;195;196;1
/net/per920a/export/das14a/satoh-lab/haolin/nhk/excerpts/2005_05_26_19_00_3.webm;Junichiro KOIZUMI.jpg;5897;5905;8009;196;196;0
/net/per920a/export/das14a/satoh-lab/haolin/nhk/excerpts/2005_05_26_19_00_3.webm;Junichiro KOIZUMI.jpg;5921;5957;8009;197;198;1
/net/per920a/export/das14a/satoh-lab/haolin/nhk/excerpts/2005_05_26_19_00_3.webm;Junichiro KOIZUMI.jpg;7501;7693;8009;250;256;6
/net/per920a/export/das14a/satoh-lab/haolin/nhk/excerpts/2005_05_26_19_00_3.webm;Junichiro KOIZUMI.jpg;7709;7745;8009;256;258;2
/net/per920a/export/das14a/satoh-lab/haolin/nhk/excerpts/2005_05_26_19_00_3.webm;Junichiro KOIZUMI.jpg;7761;7925;8009;258;264;6
/net/per920a/export/das14a/satoh-lab/haolin/nhk/excerpts/2005_05_26_19_00_3.webm;Junichiro KOIZUMI.jpg;7937;7977;8009;264;265;1
/net/per920a/export/das14a/satoh-lab/haolin/nhk/excerpts/2005_05_26_19_00_3.webm;Akihiro OHTA.jpg;5581;5581;8009;186;186;0
/net/per920a/export/das14a/satoh-lab/haolin/nhk/excerpts/2005_05_26_19_00_3.webm;Akihiro OHTA.jpg;5597;5597;8009;186;186;0
/net/per920a/export/das14a/satoh-lab/haolin/nhk/excerpts/2005_05_26_19_00_3.webm;Akihiro OHTA.jpg;5617;5657;8009;187;188;1
/net/per920a/export/das14a/satoh-lab/haolin/nhk/excerpts/2005_05_26_19_00_3.webm;Akihiro OHTA.jpg;5677;5701;8009;189;190;1
/net/per920a/export/das14a/satoh-lab/haolin/nhk/excerpts/2005_05_26_19_00_3.webm;Akihiro OHTA.jpg;5721;5765;8009;190;192;2
/net/per920a/export/das14a/satoh-lab/haolin/nhk/excerpts/2005_05_26_19_00_3.webm;Akihiro OHTA.jpg;5781;5781;8009;192;192;0
/net/per920a/export/das14a/satoh-lab/haolin/nhk/excerpts/2005_05_26_19_00_3.webm;Akihiro OHTA.jpg;5797;5829;8009;193;194;1
/net/per920a/export/das14a/satoh-lab/haolin/nhk/excerpts/2005_05_26_19_00_3.webm;Akihiro OHTA.jpg;5869;5881;8009;195;196;1
/net/per920a/export/das14a/satoh-lab/haolin/nhk/excerpts/2005_05_26_19_00_3.webm;Akihiro OHTA.jpg;5897;5957;8009;196;198;2
/net/per920a/export/das14a/satoh-lab/haolin/nhk/excerpts/2005_06_09_19_00_1.webm;Junichiro KOIZUMI.jpg;9961;10469;10525;332;349;17
/net/per920a/export/das14a/satoh-lab/haolin/nhk/excerpts/2005_06_15_19_00_2.webm;Junichiro KOIZUMI.jpg;5993;6025;6029;199;200;1
/net/per920a/export/das14a/satoh-lab/haolin/nhk/excerpts/2005_06_17_19_00_1.webm;Katsuya OKADA.jpg;1289;1337;6393;42;44;2
/net/per920a/export/das14a/satoh-lab/haolin/nhk/excerpts/2005_06_17_19_00_1.webm;Katsuya OKADA.jpg;1429;1445;6393;47;48;1
/net/per920a/export/das14a/satoh-lab/haolin/nhk/excerpts/2005_06_17_19_00_1.webm;Katsuya OKADA.jpg;1461;1465;6393;48;48;0
/net/per920a/export/das14a/satoh-lab/haolin/nhk/excerpts/2005_06_17_19_00_1.webm;Katsuya OKADA.jpg;1481;1501;6393;49;50;1
/net/per920a/export/das14a/satoh-lab/haolin/nhk/excerpts/2005_06_17_19_00_1.webm;Katsuya OKADA.jpg;1525;1669;6393;50;55;5
/net/per920a/export/das14a/satoh-lab/haolin/nhk/excerpts/2005_06_17_19_00_1.webm;Katsuya OKADA.jpg;3989;4061;6393;132;135;3
/net/per920a/export/das14a/satoh-lab/haolin/nhk/excerpts/2005_06_17_19_00_1.webm;Junichiro KOIZUMI.jpg;3041;3101;6393;101;103;2
/net/per920a/export/das14a/satoh-lab/haolin/nhk/excerpts/2005_06_17_19_00_1.webm;Junichiro KOIZUMI.jpg;3117;3177;6393;103;105;2
/net/per920a/export/das14a/satoh-lab/haolin/nhk/excerpts/2005_06_17_19_00_1.webm;Natsuo YAMAGUCHI.jpg;3561;3565;6393;118;118;0
/net/per920a/export/das14a/satoh-lab/haolin/nhk/excerpts/2005_06_17_19_00_1.webm;Natsuo YAMAGUCHI.jpg;3585;3589;6393;119;119;0
/net/per920a/export/das14a/satoh-lab/haolin/nhk/excerpts/2005_06_17_19_00_1.webm;Natsuo YAMAGUCHI.jpg;3605;3701;6393;120;123;3
/net/per920a/export/das14a/satoh-lab/haolin/nhk/excerpts/2005_06_18_19_00_2.webm;Shinzo ABE.jpg;7109;7121;7973;237;237;0
/net/per920a/export/das14a/satoh-lab/haolin/nhk/excerpts/2005_06_18_19_00_2.webm;Shinzo ABE.jpg;7137;7157;7973;238;238;0
/net/per920a/export/das14a/satoh-lab/haolin/nhk/excerpts/2005_06_18_19_00_2.webm;Shinzo ABE.jpg;7173;7649;7973;239;255;16
/net/per920a/export/das14a/satoh-lab/haolin/nhk/excerpts/2005_06_18_19_00_2.webm;Shinzo ABE.jpg;7665;7665;7973;255;255;0
/net/per920a/export/das14a/satoh-lab/haolin/nhk/excerpts/2005_06_18_19_00_2.webm;Shinzo ABE.jpg;7681;7769;7973;256;259;3
/net/per920a/export/das14a/satoh-lab/haolin/nhk/excerpts/2005_06_18_19_00_2.webm;Shinzo ABE.jpg;7785;7785;7973;259;259;0
/net/per920a/export/das14a/satoh-lab/haolin/nhk/excerpts/2005_06_18_19_00_2.webm;Shinzo ABE.jpg;7801;7897;7973;260;263;3
/net/per920a/export/das14a/satoh-lab/haolin/nhk/excerpts/2005_06_18_19_00_2.webm;Shinzo ABE.jpg;7913;7969;7973;263;265;2
/net/per920a/export/das14a/satoh-lab/haolin/nhk/excerpts/2005_08_03_19_00_1.webm;Shinzo ABE.jpg;2505;2513;8481;83;83;0
/net/per920a/export/das14a/satoh-lab/haolin/nhk/excerpts/2005_08_03_19_00_1.webm;Shinzo ABE.jpg;2525;2549;8481;84;85;1
/net/per920a/export/das14a/satoh-lab/haolin/nhk/excerpts/2005_08_03_19_00_1.webm;Shinzo ABE.jpg;2561;2585;8481;85;86;1
/net/per920a/export/das14a/satoh-lab/haolin/nhk/excerpts/2005_08_03_19_00_1.webm;Shinzo ABE.jpg;2601;2609;8481;86;87;1
/net/per920a/export/das14a/satoh-lab/haolin/nhk/excerpts/2005_08_03_19_00_1.webm;Shinzo ABE.jpg;2625;2629;8481;87;87;0
/net/per920a/export/das14a/satoh-lab/haolin/nhk/excerpts/2005_08_03_19_00_1.webm;Shinzo ABE.jpg;2641;2641;8481;88;88;0
/net/per920a/export/das14a/satoh-lab/haolin/nhk/excerpts/2005_08_03_19_00_1.webm;Shinzo ABE.jpg;2653;2657;8481;88;88;0
/net/per920a/export/das14a/satoh-lab/haolin/nhk/excerpts/2005_08_03_19_00_1.webm;Takenori KANZAKI.jpg;5449;5561;8481;181;185;4
/net/per920a/export/das14a/satoh-lab/haolin/nhk/excerpts/2005_08_03_19_00_1.webm;Takenori KANZAKI.jpg;5577;5969;8481;186;199;13
/net/per920a/export/das14a/satoh-lab/haolin/nhk/excerpts/2005_08_03_19_00_1.webm;Junichiro KOIZUMI.jpg;7373;7865;8481;246;262;16
/net/per920a/export/das14a/satoh-lab/haolin/nhk/excerpts/2005_08_03_19_00_1.webm;Junichiro KOIZUMI.jpg;7881;7885;8481;262;263;1
/net/per920a/export/das14a/satoh-lab/haolin/nhk/excerpts/2005_08_03_19_00_1.webm;Junichiro KOIZUMI.jpg;7901;7905;8481;263;263;0
/net/per920a/export/das14a/satoh-lab/haolin/nhk/excerpts/2005_08_03_19_00_1.webm;Junichiro KOIZUMI.jpg;7921;7933;8481;264;264;0
/net/per920a/export/das14a/satoh-lab/haolin/nhk/excerpts/2005_08_03_19_00_1.webm;Junichiro KOIZUMI.jpg;7949;7953;8481;265;265;0
/net/per920a/export/das14a/satoh-lab/haolin/nhk/excerpts/2005_08_03_19_00_1.webm;Junichiro KOIZUMI.jpg;7969;7969;8481;265;265;0
/net/per920a/export/das14a/satoh-lab/haolin/nhk/excerpts/2005_08_03_19_00_1.webm;Junichiro KOIZUMI.jpg;7985;7993;8481;266;266;0
/net/per920a/export/das14a/satoh-lab/haolin/nhk/excerpts/2005_08_03_19_00_1.webm;Junichiro KOIZUMI.jpg;8009;8041;8481;267;268;1
/net/per920a/export/das14a/satoh-lab/haolin/nhk/excerpts/2005_08_03_19_00_1.webm;Junichiro KOIZUMI.jpg;8057;8089;8481;268;269;1
/net/per920a/export/das14a/satoh-lab/haolin/nhk/excerpts/2005_08_03_19_00_1.webm;Junichiro KOIZUMI.jpg;8105;8117;8481;270;270;0
/net/per920a/export/das14a/satoh-lab/haolin/nhk/excerpts/2005_08_03_19_00_1.webm;Junichiro KOIZUMI.jpg;8129;8129;8481;271;271;0
/net/per920a/export/das14a/satoh-lab/haolin/nhk/excerpts/2005_08_03_19_00_1.webm;Junichiro KOIZUMI.jpg;8153;8161;8481;272;272;0
/net/per920a/export/das14a/satoh-lab/haolin/nhk/excerpts/2005_08_03_19_00_1.webm;Junichiro KOIZUMI.jpg;8185;8185;8481;273;273;0
/net/per920a/export/das14a/satoh-lab/haolin/nhk/excerpts/2005_08_03_19_00_1.webm;Junichiro KOIZUMI.jpg;8213;8441;8481;274;281;7
/net/per920a/export/das14a/satoh-lab/haolin/nhk/excerpts/2005_08_24_19_00_3.webm;Junichiro KOIZUMI.jpg;565;585;8309;18;19;1
/net/per920a/export/das14a/satoh-lab/haolin/nhk/excerpts/2005_08_24_19_00_3.webm;Junichiro KOIZUMI.jpg;597;833;8309;19;27;8
/net/per920a/export/das14a/satoh-lab/haolin/nhk/excerpts/2005_08_24_19_00_3.webm;Junichiro KOIZUMI.jpg;941;949;8309;31;31;0
/net/per920a/export/das14a/satoh-lab/haolin/nhk/excerpts/2005_08_24_19_00_3.webm;Junichiro KOIZUMI.jpg;1017;1021;8309;33;34;1
/net/per920a/export/das14a/satoh-lab/haolin/nhk/excerpts/2005_08_24_19_00_3.webm;Junichiro KOIZUMI.jpg;1045;1045;8309;34;34;0
/net/per920a/export/das14a/satoh-lab/haolin/nhk/excerpts/2005_08_24_19_00_3.webm;Junichiro KOIZUMI.jpg;1069;1069;8309;35;35;0
/net/per920a/export/das14a/satoh-lab/haolin/nhk/excerpts/2005_08_24_19_00_3.webm;Junichiro KOIZUMI.jpg;1085;1085;8309;36;36;0
/net/per920a/export/das14a/satoh-lab/haolin/nhk/excerpts/2005_08_24_19_00_3.webm;Junichiro KOIZUMI.jpg;1101;1105;8309;36;36;0
/net/per920a/export/das14a/satoh-lab/haolin/nhk/excerpts/2005_08_24_19_00_3.webm;Junichiro KOIZUMI.jpg;1189;1397;8309;39;46;7
/net/per920a/export/das14a/satoh-lab/haolin/nhk/excerpts/2005_08_24_19_00_3.webm;Junichiro KOIZUMI.jpg;1489;1505;8309;49;50;1
/net/per920a/export/das14a/satoh-lab/haolin/nhk/excerpts/2005_08_24_19_00_3.webm;Junichiro KOIZUMI.jpg;1549;1549;8309;51;51;0
/net/per920a/export/das14a/satoh-lab/haolin/nhk/excerpts/2005_08_24_19_00_3.webm;Junichiro KOIZUMI.jpg;2089;2105;8309;69;70;1
/net/per920a/export/das14a/satoh-lab/haolin/nhk/excerpts/2005_08_24_19_00_3.webm;Junichiro KOIZUMI.jpg;2129;2169;8309;70;72;2
/net/per920a/export/das14a/satoh-lab/haolin/nhk/excerpts/2005_08_24_19_00_3.webm;Junichiro KOIZUMI.jpg;2189;2225;8309;72;74;2
/net/per920a/export/das14a/satoh-lab/haolin/nhk/excerpts/2005_08_24_19_00_3.webm;Takenori KANZAKI.jpg;2885;3025;8309;96;100;4
/net/per920a/export/das14a/satoh-lab/haolin/nhk/excerpts/2005_08_24_19_00_3.webm;Takenori KANZAKI.jpg;3041;3209;8309;101;106;5
/net/per920a/export/das14a/satoh-lab/haolin/nhk/excerpts/2005_08_24_19_00_3.webm;Takenori KANZAKI.jpg;3225;3241;8309;107;108;1
/net/per920a/export/das14a/satoh-lab/haolin/nhk/excerpts/2005_08_24_19_00_3.webm;Takenori KANZAKI.jpg;3257;3469;8309;108;115;7
/net/per920a/export/das14a/satoh-lab/haolin/nhk/excerpts/2005_08_24_19_00_3.webm;Katsuya OKADA.jpg;3689;4281;8309;122;142;20
/net/per920a/export/das14a/satoh-lab/haolin/nhk/excerpts/2005_08_24_19_00_3.webm;Katsuya OKADA.jpg;4297;4501;8309;143;150;7
/net/per920a/export/das14a/satoh-lab/haolin/nhk/excerpts/2005_08_24_19_00_3.webm;Katsuya OKADA.jpg;4717;4797;8309;157;159;2
/net/per920a/export/das14a/satoh-lab/haolin/nhk/excerpts/2005_08_24_19_00_3.webm;Yukio HATOYAMA.jpg;4849;4881;8309;161;162;1
/net/per920a/export/das14a/satoh-lab/haolin/nhk/excerpts/2005_08_24_19_00_3.webm;Ichiro OZAWA.jpg;4897;4925;8309;163;164;1
/net/per920a/export/das14a/satoh-lab/haolin/nhk/excerpts/2005_08_24_19_00_3.webm;Ichiro OZAWA.jpg;4941;4977;8309;164;165;1
/net/per920a/export/das14a/satoh-lab/haolin/nhk/excerpts/2005_08_24_19_00_3.webm;Ichiro OZAWA.jpg;4993;4997;8309;166;166;0
/net/per920a/export/das14a/satoh-lab/haolin/nhk/excerpts/2005_08_24_19_00_3.webm;Ichiro OZAWA.jpg;5021;5025;8309;167;167;0
/net/per920a/export/das14a/satoh-lab/haolin/nhk/excerpts/2005_08_24_19_00_3.webm;Ichiro OZAWA.jpg;5041;5089;8309;168;169;1
/net/per920a/export/das14a/satoh-lab/haolin/nhk/excerpts/2005_08_24_19_00_3.webm;Ichiro OZAWA.jpg;5105;5125;8309;170;170;0
/net/per920a/export/das14a/satoh-lab/haolin/nhk/excerpts/2005_08_24_19_00_3.webm;Ichiro OZAWA.jpg;5141;5169;8309;171;172;1
/net/per920a/export/das14a/satoh-lab/haolin/nhk/excerpts/2005_08_24_19_00_3.webm;Ichiro OZAWA.jpg;5197;5229;8309;173;174;1
/net/per920a/export/das14a/satoh-lab/haolin/nhk/excerpts/2005_08_24_19_00_3.webm;Ichiro OZAWA.jpg;5245;5309;8309;174;176;2
/net/per920a/export/das14a/satoh-lab/haolin/nhk/excerpts/2005_08_24_19_00_3.webm;Ichiro OZAWA.jpg;5329;5329;8309;177;177;0
/net/per920a/export/das14a/satoh-lab/haolin/nhk/excerpts/2005_08_24_19_00_3.webm;Ichiro OZAWA.jpg;5373;5433;8309;179;181;2
/net/per920a/export/das14a/satoh-lab/haolin/nhk/excerpts/2005_08_24_19_00_3.webm;Kazuo SHII.jpg;5481;5497;8309;182;183;1
/net/per920a/export/das14a/satoh-lab/haolin/nhk/excerpts/2005_08_24_19_00_3.webm;Kazuo SHII.jpg;5513;5777;8309;183;192;9
/net/per920a/export/das14a/satoh-lab/haolin/nhk/excerpts/2005_08_24_19_00_3.webm;Kazuo SHII.jpg;5801;6429;8309;193;214;21
/net/per920a/export/das14a/satoh-lab/haolin/nhk/excerpts/2005_08_24_19_00_3.webm;Kazuo SHII.jpg;6445;7237;8309;214;241;27
/net/per920a/export/das14a/satoh-lab/haolin/nhk/excerpts/2005_08_27_19_00_1.webm;Junichiro KOIZUMI.jpg;685;685;13077;22;22;0
/net/per920a/export/das14a/satoh-lab/haolin/nhk/excerpts/2005_08_27_19_00_1.webm;Junichiro KOIZUMI.jpg;701;721;13077;23;24;1
/net/per920a/export/das14a/satoh-lab/haolin/nhk/excerpts/2005_08_27_19_00_1.webm;Junichiro KOIZUMI.jpg;745;777;13077;24;25;1
/net/per920a/export/das14a/satoh-lab/haolin/nhk/excerpts/2005_08_27_19_00_1.webm;Junichiro KOIZUMI.jpg;793;1041;13077;26;34;8
/net/per920a/export/das14a/satoh-lab/haolin/nhk/excerpts/2005_08_27_19_00_1.webm;Junichiro KOIZUMI.jpg;1057;1165;13077;35;38;3
/net/per920a/export/das14a/satoh-lab/haolin/nhk/excerpts/2005_08_27_19_00_1.webm;Junichiro KOIZUMI.jpg;1297;1333;13077;43;44;1
/net/per920a/export/das14a/satoh-lab/haolin/nhk/excerpts/2005_08_27_19_00_1.webm;Junichiro KOIZUMI.jpg;1349;1509;13077;44;50;6
/net/per920a/export/das14a/satoh-lab/haolin/nhk/excerpts/2005_08_27_19_00_1.webm;Junichiro KOIZUMI.jpg;1521;1549;13077;50;51;1
/net/per920a/export/das14a/satoh-lab/haolin/nhk/excerpts/2005_08_27_19_00_1.webm;Junichiro KOIZUMI.jpg;1565;1565;13077;52;52;0
/net/per920a/export/das14a/satoh-lab/haolin/nhk/excerpts/2005_08_27_19_00_1.webm;Junichiro KOIZUMI.jpg;1581;1613;13077;52;53;1
/net/per920a/export/das14a/satoh-lab/haolin/nhk/excerpts/2005_08_27_19_00_1.webm;Junichiro KOIZUMI.jpg;1685;1833;13077;56;61;5
/net/per920a/export/das14a/satoh-lab/haolin/nhk/excerpts/2005_08_27_19_00_1.webm;Junichiro KOIZUMI.jpg;1849;1873;13077;61;62;1
/net/per920a/export/das14a/satoh-lab/haolin/nhk/excerpts/2005_08_27_19_00_1.webm;Junichiro KOIZUMI.jpg;1885;1905;13077;62;63;1
/net/per920a/export/das14a/satoh-lab/haolin/nhk/excerpts/2005_08_27_19_00_1.webm;Junichiro KOIZUMI.jpg;1917;1925;13077;63;64;1
/net/per920a/export/das14a/satoh-lab/haolin/nhk/excerpts/2005_08_27_19_00_1.webm;Junichiro KOIZUMI.jpg;1945;2113;13077;64;70;6
/net/per920a/export/das14a/satoh-lab/haolin/nhk/excerpts/2005_08_27_19_00_1.webm;Junichiro KOIZUMI.jpg;2125;2145;13077;70;71;1
/net/per920a/export/das14a/satoh-lab/haolin/nhk/excerpts/2005_08_27_19_00_1.webm;Junichiro KOIZUMI.jpg;2157;2165;13077;71;72;1
/net/per920a/export/das14a/satoh-lab/haolin/nhk/excerpts/2005_08_27_19_00_1.webm;Junichiro KOIZUMI.jpg;2185;2317;13077;72;77;5
/net/per920a/export/das14a/satoh-lab/haolin/nhk/excerpts/2005_08_27_19_00_1.webm;Junichiro KOIZUMI.jpg;2333;2353;13077;77;78;1
/net/per920a/export/das14a/satoh-lab/haolin/nhk/excerpts/2005_08_27_19_00_1.webm;Junichiro KOIZUMI.jpg;2373;2697;13077;79;89;10
/net/per920a/export/das14a/satoh-lab/haolin/nhk/excerpts/2005_08_27_19_00_1.webm;Junichiro KOIZUMI.jpg;2713;2725;13077;90;90;0
/net/per920a/export/das14a/satoh-lab/haolin/nhk/excerpts/2005_08_27_19_00_1.webm;Junichiro KOIZUMI.jpg;2741;2757;13077;91;91;0
/net/per920a/export/das14a/satoh-lab/haolin/nhk/excerpts/2005_08_27_19_00_1.webm;Junichiro KOIZUMI.jpg;2821;2821;13077;94;94;0
/net/per920a/export/das14a/satoh-lab/haolin/nhk/excerpts/2005_08_27_19_00_1.webm;Junichiro KOIZUMI.jpg;2861;2873;13077;95;95;0
/net/per920a/export/das14a/satoh-lab/haolin/nhk/excerpts/2005_08_27_19_00_1.webm;Junichiro KOIZUMI.jpg;2889;2893;13077;96;96;0
/net/per920a/export/das14a/satoh-lab/haolin/nhk/excerpts/2005_08_27_19_00_1.webm;Junichiro KOIZUMI.jpg;2905;2909;13077;96;96;0
/net/per920a/export/das14a/satoh-lab/haolin/nhk/excerpts/2005_08_27_19_00_1.webm;Junichiro KOIZUMI.jpg;2921;3197;13077;97;106;9
/net/per920a/export/das14a/satoh-lab/haolin/nhk/excerpts/2005_08_27_19_00_1.webm;Takenori KANZAKI.jpg;3977;3985;13077;132;132;0
/net/per920a/export/das14a/satoh-lab/haolin/nhk/excerpts/2005_08_27_19_00_1.webm;Takenori KANZAKI.jpg;4005;4425;13077;133;147;14
/net/per920a/export/das14a/satoh-lab/haolin/nhk/excerpts/2005_08_27_19_00_1.webm;Takenori KANZAKI.jpg;4441;4441;13077;148;148;0
/net/per920a/export/das14a/satoh-lab/haolin/nhk/excerpts/2005_08_27_19_00_1.webm;Takenori KANZAKI.jpg;4509;4585;13077;150;152;2
/net/per920a/export/das14a/satoh-lab/haolin/nhk/excerpts/2005_08_27_19_00_1.webm;Takenori KANZAKI.jpg;4629;4665;13077;154;155;1
/net/per920a/export/das14a/satoh-lab/haolin/nhk/excerpts/2005_08_27_19_00_1.webm;Takenori KANZAKI.jpg;4769;4769;13077;159;159;0
/net/per920a/export/das14a/satoh-lab/haolin/nhk/excerpts/2005_08_27_19_00_1.webm;Takenori KANZAKI.jpg;4785;4785;13077;159;159;0
/net/per920a/export/das14a/satoh-lab/haolin/nhk/excerpts/2005_08_27_19_00_1.webm;Takenori KANZAKI.jpg;4801;4817;13077;160;160;0
/net/per920a/export/das14a/satoh-lab/haolin/nhk/excerpts/2005_08_27_19_00_1.webm;Takenori KANZAKI.jpg;4833;4845;13077;161;161;0
/net/per920a/export/das14a/satoh-lab/haolin/nhk/excerpts/2005_08_27_19_00_1.webm;Takenori KANZAKI.jpg;4861;4881;13077;162;162;0
/net/per920a/export/das14a/satoh-lab/haolin/nhk/excerpts/2005_08_27_19_00_1.webm;Takenori KANZAKI.jpg;4893;4929;13077;163;164;1
/net/per920a/export/das14a/satoh-lab/haolin/nhk/excerpts/2005_08_27_19_00_1.webm;Takenori KANZAKI.jpg;4941;4941;13077;164;164;0
/net/per920a/export/das14a/satoh-lab/haolin/nhk/excerpts/2005_08_27_19_00_1.webm;Takenori KANZAKI.jpg;4957;5013;13077;165;167;2
/net/per920a/export/das14a/satoh-lab/haolin/nhk/excerpts/2005_08_27_19_00_1.webm;Takenori KANZAKI.jpg;5033;5037;13077;167;167;0
/net/per920a/export/das14a/satoh-lab/haolin/nhk/excerpts/2005_08_27_19_00_1.webm;Takenori KANZAKI.jpg;5049;5077;13077;168;169;1
/net/per920a/export/das14a/satoh-lab/haolin/nhk/excerpts/2005_08_27_19_00_1.webm;Takenori KANZAKI.jpg;5101;5109;13077;170;170;0
/net/per920a/export/das14a/satoh-lab/haolin/nhk/excerpts/2005_08_27_19_00_1.webm;Takenori KANZAKI.jpg;5129;5241;13077;171;174;3
/net/per920a/export/das14a/satoh-lab/haolin/nhk/excerpts/2005_08_27_19_00_1.webm;Ichiro OZAWA.jpg;7041;7053;13077;234;235;1
/net/per920a/export/das14a/satoh-lab/haolin/nhk/excerpts/2005_08_27_19_00_1.webm;Ichiro OZAWA.jpg;7117;7301;13077;237;243;6
/net/per920a/export/das14a/satoh-lab/haolin/nhk/excerpts/2005_08_27_19_00_1.webm;Ichiro OZAWA.jpg;7325;7337;13077;244;244;0
/net/per920a/export/das14a/satoh-lab/haolin/nhk/excerpts/2005_08_27_19_00_1.webm;Ichiro OZAWA.jpg;7353;7437;13077;245;247;2
/net/per920a/export/das14a/satoh-lab/haolin/nhk/excerpts/2005_08_27_19_00_1.webm;Ichiro OZAWA.jpg;7453;7645;13077;248;254;6
/net/per920a/export/das14a/satoh-lab/haolin/nhk/excerpts/2005_08_27_19_00_1.webm;Ichiro OZAWA.jpg;7661;7957;13077;255;265;10
/net/per920a/export/das14a/satoh-lab/haolin/nhk/excerpts/2005_08_27_19_00_1.webm;Ichiro OZAWA.jpg;7973;8073;13077;265;269;4
/net/per920a/export/das14a/satoh-lab/haolin/nhk/excerpts/2005_08_27_19_00_1.webm;Kazuo SHII.jpg;8089;8337;13077;269;277;8
/net/per920a/export/das14a/satoh-lab/haolin/nhk/excerpts/2005_08_27_19_00_1.webm;Kazuo SHII.jpg;8353;8673;13077;278;289;11
/net/per920a/export/das14a/satoh-lab/haolin/nhk/excerpts/2005_08_27_19_00_1.webm;Kazuo SHII.jpg;8709;8769;13077;290;292;2
/net/per920a/export/das14a/satoh-lab/haolin/nhk/excerpts/2005_08_27_19_00_1.webm;Kazuo SHII.jpg;8805;9065;13077;293;302;9
/net/per920a/export/das14a/satoh-lab/haolin/nhk/excerpts/2005_08_27_19_00_1.webm;Kazuo SHII.jpg;9081;9157;13077;302;305;3
/net/per920a/export/das14a/satoh-lab/haolin/nhk/excerpts/2005_08_27_19_00_1.webm;Kazuo SHII.jpg;9173;9333;13077;305;311;6
/net/per920a/export/das14a/satoh-lab/haolin/nhk/excerpts/2005_08_27_19_00_1.webm;Kazuo SHII.jpg;9349;9565;13077;311;318;7
/net/per920a/export/das14a/satoh-lab/haolin/nhk/excerpts/2005_10_07_19_00_1.webm;Junichiro KOIZUMI.jpg;8997;9081;9085;300;302;2
/net/per920a/export/das14a/satoh-lab/haolin/nhk/excerpts/2005_11_07_19_00_3.webm;Shinzo ABE.jpg;4889;5321;5397;163;177;14
/net/per920a/export/das14a/satoh-lab/haolin/nhk/excerpts/2005_11_15_19_00_2.webm;Shintaro ISHIHARA.jpg;1029;1493;41697;34;49;15
/net/per920a/export/das14a/satoh-lab/haolin/nhk/excerpts/2005_11_15_19_00_2.webm;Shintaro ISHIHARA.jpg;13637;13737;41697;454;458;4
/net/per920a/export/das14a/satoh-lab/haolin/nhk/excerpts/2005_11_15_19_00_2.webm;Shintaro ISHIHARA.jpg;13757;13785;41697;458;459;1
/net/per920a/export/das14a/satoh-lab/haolin/nhk/excerpts/2005_11_15_19_00_2.webm;Shintaro ISHIHARA.jpg;13813;13857;41697;460;462;2
/net/per920a/export/das14a/satoh-lab/haolin/nhk/excerpts/2005_11_15_19_00_2.webm;Shintaro ISHIHARA.jpg;13877;13881;41697;462;463;1
/net/per920a/export/das14a/satoh-lab/haolin/nhk/excerpts/2005_11_15_19_00_2.webm;Shintaro ISHIHARA.jpg;13901;13901;41697;463;463;0
/net/per920a/export/das14a/satoh-lab/haolin/nhk/excerpts/2005_11_15_19_00_2.webm;Shintaro ISHIHARA.jpg;13917;13981;41697;464;466;2
/net/per920a/export/das14a/satoh-lab/haolin/nhk/excerpts/2005_11_15_19_00_2.webm;Shintaro ISHIHARA.jpg;13997;14001;41697;466;467;1
/net/per920a/export/das14a/satoh-lab/haolin/nhk/excerpts/2005_11_15_19_00_2.webm;Shintaro ISHIHARA.jpg;14013;14893;41697;467;496;29
/net/per920a/export/das14a/satoh-lab/haolin/nhk/excerpts/2005_12_28_19_00_3.webm;Junichiro KOIZUMI.jpg;2437;2733;2737;81;90;9
/net/per920a/export/das14a/satoh-lab/haolin/nhk/excerpts/2006_01_05_19_00_1.webm;Natsuo YAMAGUCHI.jpg;9001;9149;12409;300;305;5
/net/per920a/export/das14a/satoh-lab/haolin/nhk/excerpts/2006_01_05_19_00_1.webm;Natsuo YAMAGUCHI.jpg;9165;9265;12409;305;309;4
/net/per920a/export/das14a/satoh-lab/haolin/nhk/excerpts/2006_01_24_19_00_3.webm;Shizuka KAMEI.jpg;5425;5425;8013;180;180;0
/net/per920a/export/das14a/satoh-lab/haolin/nhk/excerpts/2006_01_24_19_00_3.webm;Shizuka KAMEI.jpg;5493;5505;8013;183;183;0
/net/per920a/export/das14a/satoh-lab/haolin/nhk/excerpts/2006_01_24_19_00_3.webm;Shizuka KAMEI.jpg;5533;5541;8013;184;184;0
/net/per920a/export/das14a/satoh-lab/haolin/nhk/excerpts/2006_01_24_19_00_3.webm;Shizuka KAMEI.jpg;5553;5565;8013;185;185;0
/net/per920a/export/das14a/satoh-lab/haolin/nhk/excerpts/2006_01_24_19_00_3.webm;Shizuka KAMEI.jpg;5585;5593;8013;186;186;0
/net/per920a/export/das14a/satoh-lab/haolin/nhk/excerpts/2006_01_24_19_00_3.webm;Shizuka KAMEI.jpg;5609;5657;8013;186;188;2
/net/per920a/export/das14a/satoh-lab/haolin/nhk/excerpts/2006_01_24_19_00_3.webm;Shizuka KAMEI.jpg;5673;5685;8013;189;189;0
/net/per920a/export/das14a/satoh-lab/haolin/nhk/excerpts/2006_01_24_19_00_3.webm;Shizuka KAMEI.jpg;5701;5701;8013;189;189;0
/net/per920a/export/das14a/satoh-lab/haolin/nhk/excerpts/2006_01_24_19_00_3.webm;Shizuka KAMEI.jpg;5721;5761;8013;190;191;1
/net/per920a/export/das14a/satoh-lab/haolin/nhk/excerpts/2006_01_24_19_00_3.webm;Shizuka KAMEI.jpg;5789;5833;8013;192;194;2
/net/per920a/export/das14a/satoh-lab/haolin/nhk/excerpts/2006_01_24_19_00_3.webm;Shizuka KAMEI.jpg;5849;5945;8013;194;198;4
/net/per920a/export/das14a/satoh-lab/haolin/nhk/excerpts/2006_01_24_19_00_3.webm;Shizuka KAMEI.jpg;5961;5969;8013;198;198;0
/net/per920a/export/das14a/satoh-lab/haolin/nhk/excerpts/2006_01_24_19_00_3.webm;Shizuka KAMEI.jpg;6001;6001;8013;199;199;0
/net/per920a/export/das14a/satoh-lab/haolin/nhk/excerpts/2006_01_24_19_00_3.webm;Shizuka KAMEI.jpg;6021;6197;8013;200;206;6
/net/per920a/export/das14a/satoh-lab/haolin/nhk/excerpts/2006_01_24_19_00_3.webm;Shizuka KAMEI.jpg;6213;6465;8013;207;215;8
/net/per920a/export/das14a/satoh-lab/haolin/nhk/excerpts/2006_01_24_19_00_3.webm;Seiji MAEHARA.jpg;6481;6653;8013;215;221;6
/net/per920a/export/das14a/satoh-lab/haolin/nhk/excerpts/2006_01_24_19_00_3.webm;Seiji MAEHARA.jpg;6669;6697;8013;222;223;1
/net/per920a/export/das14a/satoh-lab/haolin/nhk/excerpts/2006_01_24_19_00_3.webm;Seiji MAEHARA.jpg;6713;6933;8013;223;231;8
/net/per920a/export/das14a/satoh-lab/haolin/nhk/excerpts/2006_01_24_19_00_3.webm;Seiji MAEHARA.jpg;6953;7025;8013;231;234;3
/net/per920a/export/das14a/satoh-lab/haolin/nhk/excerpts/2006_01_24_19_00_3.webm;Seiji MAEHARA.jpg;7041;7137;8013;234;237;3
/net/per920a/export/das14a/satoh-lab/haolin/nhk/excerpts/2006_01_24_19_00_3.webm;Junichiro KOIZUMI.jpg;7233;7921;8013;241;263;22
/net/per920a/export/das14a/satoh-lab/haolin/nhk/excerpts/2006_02_23_19_00_1.webm;Seiji MAEHARA.jpg;469;477;19905;15;15;0
/net/per920a/export/das14a/satoh-lab/haolin/nhk/excerpts/2006_02_23_19_00_1.webm;Seiji MAEHARA.jpg;493;741;19905;16;24;8
/net/per920a/export/das14a/satoh-lab/haolin/nhk/excerpts/2006_02_23_19_00_1.webm;Seiji MAEHARA.jpg;3181;3585;19905;106;119;13
/net/per920a/export/das14a/satoh-lab/haolin/nhk/excerpts/2006_02_23_19_00_1.webm;Seiji MAEHARA.jpg;4769;4785;19905;159;159;0
/net/per920a/export/das14a/satoh-lab/haolin/nhk/excerpts/2006_02_23_19_00_1.webm;Seiji MAEHARA.jpg;9805;10077;19905;327;336;9
/net/per920a/export/das14a/satoh-lab/haolin/nhk/excerpts/2006_02_23_19_00_1.webm;Seiji MAEHARA.jpg;10093;10209;19905;336;340;4
/net/per920a/export/das14a/satoh-lab/haolin/nhk/excerpts/2006_02_23_19_00_1.webm;Seiji MAEHARA.jpg;11337;11349;19905;378;378;0
/net/per920a/export/das14a/satoh-lab/haolin/nhk/excerpts/2006_02_23_19_00_1.webm;Seiji MAEHARA.jpg;11365;11557;19905;379;385;6
/net/per920a/export/das14a/satoh-lab/haolin/nhk/excerpts/2006_02_23_19_00_1.webm;Seiji MAEHARA.jpg;18273;18273;19905;609;609;0
/net/per920a/export/das14a/satoh-lab/haolin/nhk/excerpts/2006_02_23_19_00_1.webm;Seiji MAEHARA.jpg;18293;18297;19905;610;610;0
/net/per920a/export/das14a/satoh-lab/haolin/nhk/excerpts/2006_02_23_19_00_1.webm;Seiji MAEHARA.jpg;18325;18329;19905;611;611;0
/net/per920a/export/das14a/satoh-lab/haolin/nhk/excerpts/2006_02_23_19_00_1.webm;Seiji MAEHARA.jpg;18421;18421;19905;614;614;0
/net/per920a/export/das14a/satoh-lab/haolin/nhk/excerpts/2006_02_23_19_00_1.webm;Seiji MAEHARA.jpg;18501;18769;19905;617;626;9
/net/per920a/export/das14a/satoh-lab/haolin/nhk/excerpts/2006_02_23_19_00_1.webm;Yoshihiko Noda.jpg;1157;1609;19905;38;53;15
/net/per920a/export/das14a/satoh-lab/haolin/nhk/excerpts/2006_02_23_19_00_1.webm;Yoshihiko Noda.jpg;1857;1857;19905;61;61;0
/net/per920a/export/das14a/satoh-lab/haolin/nhk/excerpts/2006_02_23_19_00_1.webm;Yoshihiko Noda.jpg;1869;1885;19905;62;62;0
/net/per920a/export/das14a/satoh-lab/haolin/nhk/excerpts/2006_02_23_19_00_1.webm;Yoshihiko Noda.jpg;4809;4813;19905;160;160;0
/net/per920a/export/das14a/satoh-lab/haolin/nhk/excerpts/2006_02_23_19_00_1.webm;Yoshihiko Noda.jpg;4869;4869;19905;162;162;0
/net/per920a/export/das14a/satoh-lab/haolin/nhk/excerpts/2006_02_23_19_00_1.webm;Yoshihiko Noda.jpg;4897;4905;19905;163;163;0
/net/per920a/export/das14a/satoh-lab/haolin/nhk/excerpts/2006_02_23_19_00_1.webm;Yoshihiko Noda.jpg;4921;4933;19905;164;164;0
/net/per920a/export/das14a/satoh-lab/haolin/nhk/excerpts/2006_02_23_19_00_1.webm;Yoshihiko Noda.jpg;9393;9413;19905;313;314;1
/net/per920a/export/das14a/satoh-lab/haolin/nhk/excerpts/2006_02_23_19_00_1.webm;Yoshihiko Noda.jpg;9433;9521;19905;314;317;3
/net/per920a/export/das14a/satoh-lab/haolin/nhk/excerpts/2006_02_23_19_00_1.webm;Yoshihiko Noda.jpg;16633;16645;19905;554;555;1
/net/per920a/export/das14a/satoh-lab/haolin/nhk/excerpts/2006_02_23_19_00_1.webm;Yoshihiko Noda.jpg;16657;16685;19905;555;556;1
/net/per920a/export/das14a/satoh-lab/haolin/nhk/excerpts/2006_02_23_19_00_1.webm;Yukio HATOYAMA.jpg;2265;2265;19905;75;75;0
/net/per920a/export/das14a/satoh-lab/haolin/nhk/excerpts/2006_02_23_19_00_1.webm;Yukio HATOYAMA.jpg;2289;2289;19905;76;76;0
/net/per920a/export/das14a/satoh-lab/haolin/nhk/excerpts/2006_02_23_19_00_1.webm;Yukio HATOYAMA.jpg;2309;2361;19905;77;78;1
/net/per920a/export/das14a/satoh-lab/haolin/nhk/excerpts/2006_02_23_19_00_1.webm;Yukio HATOYAMA.jpg;2377;2413;19905;79;80;1
/net/per920a/export/das14a/satoh-lab/haolin/nhk/excerpts/2006_02_23_19_00_1.webm;Yukio HATOYAMA.jpg;2429;2433;19905;81;81;0
/net/per920a/export/das14a/satoh-lab/haolin/nhk/excerpts/2006_02_23_19_00_1.webm;Yukio HATOYAMA.jpg;2449;2473;19905;81;82;1
/net/per920a/export/das14a/satoh-lab/haolin/nhk/excerpts/2006_02_23_19_00_1.webm;Yukio HATOYAMA.jpg;2489;2501;19905;83;83;0
/net/per920a/export/das14a/satoh-lab/haolin/nhk/excerpts/2006_02_23_19_00_1.webm;Yukio HATOYAMA.jpg;2557;2557;19905;85;85;0
/net/per920a/export/das14a/satoh-lab/haolin/nhk/excerpts/2006_02_23_19_00_1.webm;Yukio HATOYAMA.jpg;2569;2569;19905;85;85;0
/net/per920a/export/das14a/satoh-lab/haolin/nhk/excerpts/2006_02_23_19_00_1.webm;Yukio HATOYAMA.jpg;2589;2605;19905;86;86;0
/net/per920a/export/das14a/satoh-lab/haolin/nhk/excerpts/2006_02_23_19_00_1.webm;Yukio HATOYAMA.jpg;2625;2629;19905;87;87;0
/net/per920a/export/das14a/satoh-lab/haolin/nhk/excerpts/2006_02_23_19_00_1.webm;Junichiro KOIZUMI.jpg;9121;9193;19905;304;306;2
/net/per920a/export/das14a/satoh-lab/haolin/nhk/excerpts/2006_02_23_19_00_1.webm;Junichiro KOIZUMI.jpg;9209;9289;19905;307;309;2
/net/per920a/export/das14a/satoh-lab/haolin/nhk/excerpts/2006_02_23_19_00_1.webm;Junichiro KOIZUMI.jpg;9305;9317;19905;310;310;0
/net/per920a/export/das14a/satoh-lab/haolin/nhk/excerpts/2006_02_23_19_00_1.webm;Junichiro KOIZUMI.jpg;9333;9345;19905;311;311;0
/net/per920a/export/das14a/satoh-lab/haolin/nhk/excerpts/2006_02_23_19_00_1.webm;Junichiro KOIZUMI.jpg;10817;10817;19905;360;360;0
/net/per920a/export/das14a/satoh-lab/haolin/nhk/excerpts/2006_02_23_19_00_1.webm;Junichiro KOIZUMI.jpg;10877;10881;19905;362;362;0
/net/per920a/export/das14a/satoh-lab/haolin/nhk/excerpts/2006_02_23_19_00_1.webm;Junichiro KOIZUMI.jpg;10965;10969;19905;365;365;0
/net/per920a/export/das14a/satoh-lab/haolin/nhk/excerpts/2006_02_23_19_00_1.webm;Junichiro KOIZUMI.jpg;11049;11049;19905;368;368;0
/net/per920a/export/das14a/satoh-lab/haolin/nhk/excerpts/2006_02_23_19_00_1.webm;Junichiro KOIZUMI.jpg;15457;15629;19905;515;521;6
/net/per920a/export/das14a/satoh-lab/haolin/nhk/excerpts/2006_03_04_19_00_1.webm;Seiji MAEHARA.jpg;3833;3837;3841;127;127;0
/net/per920a/export/das14a/satoh-lab/haolin/nhk/excerpts/2006_03_09_19_00_1.webm;Junichiro KOIZUMI.jpg;7369;7397;19549;245;246;1
/net/per920a/export/das14a/satoh-lab/haolin/nhk/excerpts/2006_03_09_19_00_1.webm;Junichiro KOIZUMI.jpg;7413;7429;19549;247;247;0
/net/per920a/export/das14a/satoh-lab/haolin/nhk/excerpts/2006_03_09_19_00_1.webm;Junichiro KOIZUMI.jpg;7441;7441;19549;248;248;0
/net/per920a/export/das14a/satoh-lab/haolin/nhk/excerpts/2006_03_09_19_00_1.webm;Junichiro KOIZUMI.jpg;7465;7465;19549;248;248;0
/net/per920a/export/das14a/satoh-lab/haolin/nhk/excerpts/2006_03_09_19_00_1.webm;Junichiro KOIZUMI.jpg;7477;7481;19549;249;249;0
/net/per920a/export/das14a/satoh-lab/haolin/nhk/excerpts/2006_03_09_19_00_1.webm;Junichiro KOIZUMI.jpg;7493;7501;19549;249;250;1
/net/per920a/export/das14a/satoh-lab/haolin/nhk/excerpts/2006_03_09_19_00_1.webm;Junichiro KOIZUMI.jpg;7553;7581;19549;251;252;1
/net/per920a/export/das14a/satoh-lab/haolin/nhk/excerpts/2006_03_09_19_00_1.webm;Junichiro KOIZUMI.jpg;7597;7597;19549;253;253;0
/net/per920a/export/das14a/satoh-lab/haolin/nhk/excerpts/2006_03_09_19_00_1.webm;Junichiro KOIZUMI.jpg;7625;7645;19549;254;254;0
/net/per920a/export/das14a/satoh-lab/haolin/nhk/excerpts/2006_03_09_19_00_1.webm;Junichiro KOIZUMI.jpg;7681;7721;19549;256;257;1
/net/per920a/export/das14a/satoh-lab/haolin/nhk/excerpts/2006_03_09_19_00_1.webm;Junichiro KOIZUMI.jpg;15689;16205;19549;523;540;17
/net/per920a/export/das14a/satoh-lab/haolin/nhk/excerpts/2006_04_05_19_00_1.webm;Ichiro OZAWA.jpg;81;97;5489;2;3;1
/net/per920a/export/das14a/satoh-lab/haolin/nhk/excerpts/2006_04_05_19_00_1.webm;Ichiro OZAWA.jpg;113;469;5489;3;15;12
/net/per920a/export/das14a/satoh-lab/haolin/nhk/excerpts/2006_04_05_19_00_1.webm;Ichiro OZAWA.jpg;485;485;5489;16;16;0
/net/per920a/export/das14a/satoh-lab/haolin/nhk/excerpts/2006_04_05_19_00_1.webm;Ichiro OZAWA.jpg;501;541;5489;16;18;2
/net/per920a/export/das14a/satoh-lab/haolin/nhk/excerpts/2006_04_05_19_00_1.webm;Ichiro OZAWA.jpg;553;585;5489;18;19;1
/net/per920a/export/das14a/satoh-lab/haolin/nhk/excerpts/2006_04_05_19_00_1.webm;Ichiro OZAWA.jpg;601;657;5489;20;21;1
/net/per920a/export/das14a/satoh-lab/haolin/nhk/excerpts/2006_04_05_19_00_1.webm;Ichiro OZAWA.jpg;673;785;5489;22;26;4
/net/per920a/export/das14a/satoh-lab/haolin/nhk/excerpts/2006_04_05_19_00_1.webm;Ichiro OZAWA.jpg;801;801;5489;26;26;0
/net/per920a/export/das14a/satoh-lab/haolin/nhk/excerpts/2006_04_05_19_00_1.webm;Ichiro OZAWA.jpg;1981;2001;5489;66;66;0
/net/per920a/export/das14a/satoh-lab/haolin/nhk/excerpts/2006_04_05_19_00_1.webm;Ichiro OZAWA.jpg;2017;2145;5489;67;71;4
/net/per920a/export/das14a/satoh-lab/haolin/nhk/excerpts/2006_04_05_19_00_1.webm;Ichiro OZAWA.jpg;2301;2325;5489;76;77;1
/net/per920a/export/das14a/satoh-lab/haolin/nhk/excerpts/2006_04_05_19_00_1.webm;Ichiro OZAWA.jpg;3405;3417;5489;113;113;0
/net/per920a/export/das14a/satoh-lab/haolin/nhk/excerpts/2006_04_05_19_00_1.webm;Ichiro OZAWA.jpg;3433;3485;5489;114;116;2
/net/per920a/export/das14a/satoh-lab/haolin/nhk/excerpts/2006_04_05_19_00_1.webm;Ichiro OZAWA.jpg;3501;3545;5489;116;118;2
/net/per920a/export/das14a/satoh-lab/haolin/nhk/excerpts/2006_04_05_19_00_1.webm;Ichiro OZAWA.jpg;3565;3589;5489;118;119;1
/net/per920a/export/das14a/satoh-lab/haolin/nhk/excerpts/2006_04_05_19_00_1.webm;Ichiro OZAWA.jpg;3617;3617;5489;120;120;0
/net/per920a/export/das14a/satoh-lab/haolin/nhk/excerpts/2006_04_05_19_00_1.webm;Ichiro OZAWA.jpg;3629;3677;5489;120;122;2
/net/per920a/export/das14a/satoh-lab/haolin/nhk/excerpts/2006_04_05_19_00_1.webm;Ichiro OZAWA.jpg;3697;3769;5489;123;125;2
/net/per920a/export/das14a/satoh-lab/haolin/nhk/excerpts/2006_04_05_19_00_1.webm;Ichiro OZAWA.jpg;3977;4041;5489;132;134;2
/net/per920a/export/das14a/satoh-lab/haolin/nhk/excerpts/2006_04_05_19_00_1.webm;Ichiro OZAWA.jpg;4293;4293;5489;143;143;0
/net/per920a/export/das14a/satoh-lab/haolin/nhk/excerpts/2006_04_05_19_00_1.webm;Ichiro OZAWA.jpg;4305;4305;5489;143;143;0
/net/per920a/export/das14a/satoh-lab/haolin/nhk/excerpts/2006_04_05_19_00_1.webm;Ichiro OZAWA.jpg;4321;4325;5489;144;144;0
/net/per920a/export/das14a/satoh-lab/haolin/nhk/excerpts/2006_04_05_19_00_1.webm;Ichiro OZAWA.jpg;4821;4849;5489;160;161;1
/net/per920a/export/das14a/satoh-lab/haolin/nhk/excerpts/2006_04_05_19_00_1.webm;Naoto KAN.jpg;553;585;5489;18;19;1
/net/per920a/export/das14a/satoh-lab/haolin/nhk/excerpts/2006_04_05_19_00_1.webm;Naoto KAN.jpg;601;657;5489;20;21;1
/net/per920a/export/das14a/satoh-lab/haolin/nhk/excerpts/2006_04_05_19_00_1.webm;Naoto KAN.jpg;673;785;5489;22;26;4
/net/per920a/export/das14a/satoh-lab/haolin/nhk/excerpts/2006_04_05_19_00_1.webm;Naoto KAN.jpg;801;801;5489;26;26;0
/net/per920a/export/das14a/satoh-lab/haolin/nhk/excerpts/2006_04_05_19_00_1.webm;Naoto KAN.jpg;961;961;5489;32;32;0
/net/per920a/export/das14a/satoh-lab/haolin/nhk/excerpts/2006_04_05_19_00_1.webm;Naoto KAN.jpg;973;977;5489;32;32;0
/net/per920a/export/das14a/satoh-lab/haolin/nhk/excerpts/2006_04_05_19_00_1.webm;Naoto KAN.jpg;1005;1013;5489;33;33;0
/net/per920a/export/das14a/satoh-lab/haolin/nhk/excerpts/2006_04_05_19_00_1.webm;Naoto KAN.jpg;1045;1077;5489;34;35;1
/net/per920a/export/das14a/satoh-lab/haolin/nhk/excerpts/2006_04_05_19_00_1.webm;Naoto KAN.jpg;1093;1097;5489;36;36;0
/net/per920a/export/das14a/satoh-lab/haolin/nhk/excerpts/2006_04_05_19_00_1.webm;Naoto KAN.jpg;1125;1137;5489;37;37;0
/net/per920a/export/das14a/satoh-lab/haolin/nhk/excerpts/2006_04_05_19_00_1.webm;Naoto KAN.jpg;1157;1173;5489;38;39;1
/net/per920a/export/das14a/satoh-lab/haolin/nhk/excerpts/2006_04_05_19_00_1.webm;Naoto KAN.jpg;1189;1205;5489;39;40;1
/net/per920a/export/das14a/satoh-lab/haolin/nhk/excerpts/2006_04_05_19_00_1.webm;Naoto KAN.jpg;1225;1225;5489;40;40;0
/net/per920a/export/das14a/satoh-lab/haolin/nhk/excerpts/2006_04_05_19_00_1.webm;Naoto KAN.jpg;1241;1241;5489;41;41;0
/net/per920a/export/das14a/satoh-lab/haolin/nhk/excerpts/2006_04_05_19_00_1.webm;Naoto KAN.jpg;1257;1261;5489;41;42;1
/net/per920a/export/das14a/satoh-lab/haolin/nhk/excerpts/2006_04_05_19_00_1.webm;Naoto KAN.jpg;1281;1289;5489;42;42;0
/net/per920a/export/das14a/satoh-lab/haolin/nhk/excerpts/2006_04_05_19_00_1.webm;Naoto KAN.jpg;1329;1329;5489;44;44;0
/net/per920a/export/das14a/satoh-lab/haolin/nhk/excerpts/2006_04_05_19_00_1.webm;Naoto KAN.jpg;1345;1345;5489;44;44;0
/net/per920a/export/das14a/satoh-lab/haolin/nhk/excerpts/2006_04_05_19_00_1.webm;Naoto KAN.jpg;1389;1397;5489;46;46;0
/net/per920a/export/das14a/satoh-lab/haolin/nhk/excerpts/2006_04_05_19_00_1.webm;Naoto KAN.jpg;1605;1621;5489;53;54;1
/net/per920a/export/das14a/satoh-lab/haolin/nhk/excerpts/2006_04_05_19_00_1.webm;Naoto KAN.jpg;5141;5357;5489;171;178;7
/net/per920a/export/das14a/satoh-lab/haolin/nhk/excerpts/2006_04_07_19_00_2.webm;Ichiro OZAWA.jpg;517;517;16937;17;17;0
/net/per920a/export/das14a/satoh-lab/haolin/nhk/excerpts/2006_04_07_19_00_2.webm;Ichiro OZAWA.jpg;713;717;16937;23;23;0
/net/per920a/export/das14a/satoh-lab/haolin/nhk/excerpts/2006_04_07_19_00_2.webm;Ichiro OZAWA.jpg;737;741;16937;24;24;0
/net/per920a/export/das14a/satoh-lab/haolin/nhk/excerpts/2006_04_07_19_00_2.webm;Ichiro OZAWA.jpg;753;753;16937;25;25;0
/net/per920a/export/das14a/satoh-lab/haolin/nhk/excerpts/2006_04_07_19_00_2.webm;Ichiro OZAWA.jpg;905;953;16937;30;31;1
/net/per920a/export/das14a/satoh-lab/haolin/nhk/excerpts/2006_04_07_19_00_2.webm;Ichiro OZAWA.jpg;965;973;16937;32;32;0
/net/per920a/export/das14a/satoh-lab/haolin/nhk/excerpts/2006_04_07_19_00_2.webm;Ichiro OZAWA.jpg;1001;1005;16937;33;33;0
/net/per920a/export/das14a/satoh-lab/haolin/nhk/excerpts/2006_04_07_19_00_2.webm;Ichiro OZAWA.jpg;1017;1021;16937;33;34;1
/net/per920a/export/das14a/satoh-lab/haolin/nhk/excerpts/2006_04_07_19_00_2.webm;Ichiro OZAWA.jpg;1033;1073;16937;34;35;1
/net/per920a/export/das14a/satoh-lab/haolin/nhk/excerpts/2006_04_07_19_00_2.webm;Ichiro OZAWA.jpg;1097;1109;16937;36;36;0
/net/per920a/export/das14a/satoh-lab/haolin/nhk/excerpts/2006_04_07_19_00_2.webm;Ichiro OZAWA.jpg;1157;1157;16937;38;38;0
/net/per920a/export/das14a/satoh-lab/haolin/nhk/excerpts/2006_04_07_19_00_2.webm;Ichiro OZAWA.jpg;1169;1209;16937;38;40;2
/net/per920a/export/das14a/satoh-lab/haolin/nhk/excerpts/2006_04_07_19_00_2.webm;Ichiro OZAWA.jpg;1281;1325;16937;42;44;2
/net/per920a/export/das14a/satoh-lab/haolin/nhk/excerpts/2006_04_07_19_00_2.webm;Ichiro OZAWA.jpg;1341;1345;16937;44;44;0
/net/per920a/export/das14a/satoh-lab/haolin/nhk/excerpts/2006_04_07_19_00_2.webm;Ichiro OZAWA.jpg;1357;1397;16937;45;46;1
/net/per920a/export/das14a/satoh-lab/haolin/nhk/excerpts/2006_04_07_19_00_2.webm;Ichiro OZAWA.jpg;1417;1477;16937;47;49;2
/net/per920a/export/das14a/satoh-lab/haolin/nhk/excerpts/2006_04_07_19_00_2.webm;Ichiro OZAWA.jpg;1517;1573;16937;50;52;2
/net/per920a/export/das14a/satoh-lab/haolin/nhk/excerpts/2006_04_07_19_00_2.webm;Ichiro OZAWA.jpg;1589;1589;16937;53;53;0
/net/per920a/export/das14a/satoh-lab/haolin/nhk/excerpts/2006_04_07_19_00_2.webm;Ichiro OZAWA.jpg;2265;2297;16937;75;76;1
/net/per920a/export/das14a/satoh-lab/haolin/nhk/excerpts/2006_04_07_19_00_2.webm;Ichiro OZAWA.jpg;2313;2357;16937;77;78;1
/net/per920a/export/das14a/satoh-lab/haolin/nhk/excerpts/2006_04_07_19_00_2.webm;Ichiro OZAWA.jpg;2373;2533;16937;79;84;5
/net/per920a/export/das14a/satoh-lab/haolin/nhk/excerpts/2006_04_07_19_00_2.webm;Ichiro OZAWA.jpg;2889;2909;16937;96;97;1
/net/per920a/export/das14a/satoh-lab/haolin/nhk/excerpts/2006_04_07_19_00_2.webm;Ichiro OZAWA.jpg;2925;2961;16937;97;98;1
/net/per920a/export/das14a/satoh-lab/haolin/nhk/excerpts/2006_04_07_19_00_2.webm;Ichiro OZAWA.jpg;2977;3041;16937;99;101;2
/net/per920a/export/das14a/satoh-lab/haolin/nhk/excerpts/2006_04_07_19_00_2.webm;Ichiro OZAWA.jpg;4157;4213;16937;138;140;2
/net/per920a/export/das14a/satoh-lab/haolin/nhk/excerpts/2006_04_07_19_00_2.webm;Ichiro OZAWA.jpg;4773;4785;16937;159;159;0
/net/per920a/export/das14a/satoh-lab/haolin/nhk/excerpts/2006_04_07_19_00_2.webm;Ichiro OZAWA.jpg;5357;5361;16937;178;178;0
/net/per920a/export/das14a/satoh-lab/haolin/nhk/excerpts/2006_04_07_19_00_2.webm;Ichiro OZAWA.jpg;5373;5393;16937;179;179;0
/net/per920a/export/das14a/satoh-lab/haolin/nhk/excerpts/2006_04_07_19_00_2.webm;Ichiro OZAWA.jpg;5633;5645;16937;187;188;1
/net/per920a/export/das14a/satoh-lab/haolin/nhk/excerpts/2006_04_07_19_00_2.webm;Ichiro OZAWA.jpg;5945;6233;16937;198;207;9
/net/per920a/export/das14a/satoh-lab/haolin/nhk/excerpts/2006_04_07_19_00_2.webm;Ichiro OZAWA.jpg;6429;6437;16937;214;214;0
/net/per920a/export/das14a/satoh-lab/haolin/nhk/excerpts/2006_04_07_19_00_2.webm;Ichiro OZAWA.jpg;6449;6449;16937;215;215;0
/net/per920a/export/das14a/satoh-lab/haolin/nhk/excerpts/2006_04_07_19_00_2.webm;Ichiro OZAWA.jpg;6873;7301;16937;229;243;14
/net/per920a/export/das14a/satoh-lab/haolin/nhk/excerpts/2006_04_07_19_00_2.webm;Ichiro OZAWA.jpg;7809;7857;16937;260;262;2
/net/per920a/export/das14a/satoh-lab/haolin/nhk/excerpts/2006_04_07_19_00_2.webm;Ichiro OZAWA.jpg;7873;7905;16937;262;263;1
/net/per920a/export/das14a/satoh-lab/haolin/nhk/excerpts/2006_04_07_19_00_2.webm;Ichiro OZAWA.jpg;7921;8013;16937;264;267;3
/net/per920a/export/das14a/satoh-lab/haolin/nhk/excerpts/2006_04_07_19_00_2.webm;Ichiro OZAWA.jpg;8145;8285;16937;271;276;5
/net/per920a/export/das14a/satoh-lab/haolin/nhk/excerpts/2006_04_07_19_00_2.webm;Ichiro OZAWA.jpg;8401;8521;16937;280;284;4
/net/per920a/export/das14a/satoh-lab/haolin/nhk/excerpts/2006_04_07_19_00_2.webm;Ichiro OZAWA.jpg;10661;10765;16937;355;359;4
/net/per920a/export/das14a/satoh-lab/haolin/nhk/excerpts/2006_04_07_19_00_2.webm;Ichiro OZAWA.jpg;14265;14593;16937;475;486;11
/net/per920a/export/das14a/satoh-lab/haolin/nhk/excerpts/2006_04_07_19_00_2.webm;Ichiro OZAWA.jpg;15629;15773;16937;521;526;5
/net/per920a/export/das14a/satoh-lab/haolin/nhk/excerpts/2006_04_07_19_00_2.webm;Ichiro OZAWA.jpg;16621;16641;16937;554;555;1
/net/per920a/export/das14a/satoh-lab/haolin/nhk/excerpts/2006_04_07_19_00_2.webm;Naoto KAN.jpg;6813;6821;16937;227;227;0
/net/per920a/export/das14a/satoh-lab/haolin/nhk/excerpts/2006_04_07_19_00_2.webm;Yukio HATOYAMA.jpg;8557;8565;16937;285;285;0
/net/per920a/export/das14a/satoh-lab/haolin/nhk/excerpts/2006_04_07_19_00_2.webm;Yukio HATOYAMA.jpg;8593;8629;16937;286;287;1
/net/per920a/export/das14a/satoh-lab/haolin/nhk/excerpts/2006_04_07_19_00_2.webm;Yukio HATOYAMA.jpg;8649;8765;16937;288;292;4
/net/per920a/export/das14a/satoh-lab/haolin/nhk/excerpts/2006_04_07_19_00_2.webm;Yukio HATOYAMA.jpg;8797;8797;16937;293;293;0
/net/per920a/export/das14a/satoh-lab/haolin/nhk/excerpts/2006_04_07_19_00_2.webm;Yukio HATOYAMA.jpg;8813;8813;16937;293;293;0
/net/per920a/export/das14a/satoh-lab/haolin/nhk/excerpts/2006_04_07_19_00_2.webm;Yukio HATOYAMA.jpg;8865;8889;16937;295;296;1
/net/per920a/export/das14a/satoh-lab/haolin/nhk/excerpts/2006_04_07_19_00_2.webm;Yukio HATOYAMA.jpg;8961;8965;16937;298;299;1
/net/per920a/export/das14a/satoh-lab/haolin/nhk/excerpts/2006_04_07_19_00_2.webm;Yukio HATOYAMA.jpg;8981;8985;16937;299;299;0
/net/per920a/export/das14a/satoh-lab/haolin/nhk/excerpts/2006_04_07_19_00_2.webm;Yukio HATOYAMA.jpg;9053;9053;16937;301;301;0
/net/per920a/export/das14a/satoh-lab/haolin/nhk/excerpts/2006_04_07_19_00_2.webm;Seiji MAEHARA.jpg;9577;10241;16937;319;341;22
/net/per920a/export/das14a/satoh-lab/haolin/nhk/excerpts/2006_04_07_19_00_2.webm;Katsuya OKADA.jpg;10309;10337;16937;343;344;1
/net/per920a/export/das14a/satoh-lab/haolin/nhk/excerpts/2006_04_07_19_00_2.webm;Junichiro KOIZUMI.jpg;10853;10865;16937;362;362;0
/net/per920a/export/das14a/satoh-lab/haolin/nhk/excerpts/2006_04_07_19_00_2.webm;Junichiro KOIZUMI.jpg;10881;11245;16937;362;375;13
/net/per920a/export/das14a/satoh-lab/haolin/nhk/excerpts/2006_04_07_19_00_2.webm;Junichiro KOIZUMI.jpg;11261;11293;16937;375;376;1
/net/per920a/export/das14a/satoh-lab/haolin/nhk/excerpts/2006_04_07_19_00_2.webm;Junichiro KOIZUMI.jpg;11309;11357;16937;377;378;1
/net/per920a/export/das14a/satoh-lab/haolin/nhk/excerpts/2006_04_07_19_00_2.webm;Junichiro KOIZUMI.jpg;11373;12045;16937;379;401;22
/net/per920a/export/das14a/satoh-lab/haolin/nhk/excerpts/2006_04_07_19_00_2.webm;Junichiro KOIZUMI.jpg;12061;12065;16937;402;402;0
/net/per920a/export/das14a/satoh-lab/haolin/nhk/excerpts/2006_04_07_19_00_2.webm;Takenori KANZAKI.jpg;12709;13273;16937;423;442;19
/net/per920a/export/das14a/satoh-lab/haolin/nhk/excerpts/2006_04_07_19_00_2.webm;Mizuho FUKUSHIMA.jpg;13985;14253;16937;466;475;9
/net/per920a/export/das14a/satoh-lab/haolin/nhk/excerpts/2006_05_01_19_00_2.webm;Shinzo ABE.jpg;1545;1681;4593;51;55;4
/net/per920a/export/das14a/satoh-lab/haolin/nhk/excerpts/2006_05_01_19_00_2.webm;Shinzo ABE.jpg;1701;1701;4593;56;56;0
/net/per920a/export/das14a/satoh-lab/haolin/nhk/excerpts/2006_05_01_19_00_2.webm;Shinzo ABE.jpg;1717;1717;4593;57;57;0
/net/per920a/export/das14a/satoh-lab/haolin/nhk/excerpts/2006_05_01_19_00_2.webm;Shinzo ABE.jpg;1729;1733;4593;57;57;0
/net/per920a/export/das14a/satoh-lab/haolin/nhk/excerpts/2006_05_11_19_00_1.webm;Toru Hashimoto.jpg;1737;1857;11089;57;61;4
/net/per920a/export/das14a/satoh-lab/haolin/nhk/excerpts/2006_05_11_19_00_1.webm;Toru Hashimoto.jpg;2261;2285;11089;75;76;1
/net/per920a/export/das14a/satoh-lab/haolin/nhk/excerpts/2006_05_11_19_00_1.webm;Toru Hashimoto.jpg;2297;2301;11089;76;76;0
/net/per920a/export/das14a/satoh-lab/haolin/nhk/excerpts/2006_05_11_19_00_1.webm;Toru Hashimoto.jpg;2325;2325;11089;77;77;0
/net/per920a/export/das14a/satoh-lab/haolin/nhk/excerpts/2006_05_11_19_00_1.webm;Toru Hashimoto.jpg;2497;2677;11089;83;89;6
/net/per920a/export/das14a/satoh-lab/haolin/nhk/excerpts/2006_05_11_19_00_1.webm;Toru Hashimoto.jpg;2697;2741;11089;89;91;2
/net/per920a/export/das14a/satoh-lab/haolin/nhk/excerpts/2006_05_11_19_00_1.webm;Toru Hashimoto.jpg;2757;2805;11089;91;93;2
/net/per920a/export/das14a/satoh-lab/haolin/nhk/excerpts/2006_05_11_19_00_1.webm;Toru Hashimoto.jpg;2821;2825;11089;94;94;0
/net/per920a/export/das14a/satoh-lab/haolin/nhk/excerpts/2006_05_11_19_00_1.webm;Toru Hashimoto.jpg;2841;2897;11089;94;96;2
/net/per920a/export/das14a/satoh-lab/haolin/nhk/excerpts/2006_05_11_19_00_1.webm;Toru Hashimoto.jpg;2913;2925;11089;97;97;0
/net/per920a/export/das14a/satoh-lab/haolin/nhk/excerpts/2006_05_11_19_00_1.webm;Toru Hashimoto.jpg;2941;3297;11089;98;110;12
/net/per920a/export/das14a/satoh-lab/haolin/nhk/excerpts/2006_05_11_19_00_1.webm;Junichiro KOIZUMI.jpg;5073;5149;11089;169;171;2
/net/per920a/export/das14a/satoh-lab/haolin/nhk/excerpts/2006_05_11_19_00_1.webm;Junichiro KOIZUMI.jpg;5229;5265;11089;174;175;1
/net/per920a/export/das14a/satoh-lab/haolin/nhk/excerpts/2006_05_11_19_00_1.webm;Junichiro KOIZUMI.jpg;10489;10489;11089;349;349;0
/net/per920a/export/das14a/satoh-lab/haolin/nhk/excerpts/2006_05_11_19_00_1.webm;Junichiro KOIZUMI.jpg;10501;10505;11089;350;350;0
/net/per920a/export/das14a/satoh-lab/haolin/nhk/excerpts/2006_05_11_19_00_1.webm;Junichiro KOIZUMI.jpg;10757;10757;11089;358;358;0
/net/per920a/export/das14a/satoh-lab/haolin/nhk/excerpts/2006_05_25_19_00_1.webm;Sadakazu TANIGAKI.jpg;669;1545;8845;22;51;29
/net/per920a/export/das14a/satoh-lab/haolin/nhk/excerpts/2006_05_25_19_00_1.webm;Sadakazu TANIGAKI.jpg;4465;4781;8845;148;159;11
/net/per920a/export/das14a/satoh-lab/haolin/nhk/excerpts/2006_05_25_19_00_1.webm;Sadakazu TANIGAKI.jpg;4821;4825;8845;160;160;0
/net/per920a/export/das14a/satoh-lab/haolin/nhk/excerpts/2006_05_25_19_00_1.webm;Sadakazu TANIGAKI.jpg;4861;4861;8845;162;162;0
/net/per920a/export/das14a/satoh-lab/haolin/nhk/excerpts/2006_05_25_19_00_1.webm;Sadakazu TANIGAKI.jpg;4877;4897;8845;162;163;1
/net/per920a/export/das14a/satoh-lab/haolin/nhk/excerpts/2006_05_25_19_00_1.webm;Sadakazu TANIGAKI.jpg;4933;4949;8845;164;165;1
/net/per920a/export/das14a/satoh-lab/haolin/nhk/excerpts/2006_05_25_19_00_1.webm;Sadakazu TANIGAKI.jpg;4961;4961;8845;165;165;0
/net/per920a/export/das14a/satoh-lab/haolin/nhk/excerpts/2006_05_25_19_00_1.webm;Sadakazu TANIGAKI.jpg;5029;5037;8845;167;167;0
/net/per920a/export/das14a/satoh-lab/haolin/nhk/excerpts/2006_05_25_19_00_1.webm;Sadakazu TANIGAKI.jpg;5049;5057;8845;168;168;0
/net/per920a/export/das14a/satoh-lab/haolin/nhk/excerpts/2006_05_25_19_00_1.webm;Sadakazu TANIGAKI.jpg;5077;5077;8845;169;169;0
/net/per920a/export/das14a/satoh-lab/haolin/nhk/excerpts/2006_05_25_19_00_1.webm;Sadakazu TANIGAKI.jpg;5117;5129;8845;170;171;1
/net/per920a/export/das14a/satoh-lab/haolin/nhk/excerpts/2006_05_25_19_00_1.webm;Sadakazu TANIGAKI.jpg;5173;5173;8845;172;172;0
/net/per920a/export/das14a/satoh-lab/haolin/nhk/excerpts/2006_05_25_19_00_1.webm;Sadakazu TANIGAKI.jpg;5185;5185;8845;172;172;0
/net/per920a/export/das14a/satoh-lab/haolin/nhk/excerpts/2006_05_25_19_00_1.webm;Sadakazu TANIGAKI.jpg;5201;5229;8845;173;174;1
/net/per920a/export/das14a/satoh-lab/haolin/nhk/excerpts/2006_05_25_19_00_1.webm;Sadakazu TANIGAKI.jpg;5253;5253;8845;175;175;0
/net/per920a/export/das14a/satoh-lab/haolin/nhk/excerpts/2006_05_25_19_00_1.webm;Sadakazu TANIGAKI.jpg;5317;5333;8845;177;177;0
/net/per920a/export/das14a/satoh-lab/haolin/nhk/excerpts/2006_05_25_19_00_1.webm;Sadakazu TANIGAKI.jpg;5345;5353;8845;178;178;0
/net/per920a/export/das14a/satoh-lab/haolin/nhk/excerpts/2006_05_25_19_00_1.webm;Sadakazu TANIGAKI.jpg;5377;5385;8845;179;179;0
/net/per920a/export/das14a/satoh-lab/haolin/nhk/excerpts/2006_05_25_19_00_1.webm;Sadakazu TANIGAKI.jpg;5405;5405;8845;180;180;0
/net/per920a/export/das14a/satoh-lab/haolin/nhk/excerpts/2006_05_25_19_00_1.webm;Sadakazu TANIGAKI.jpg;5425;5469;8845;180;182;2
/net/per920a/export/das14a/satoh-lab/haolin/nhk/excerpts/2006_05_25_19_00_1.webm;Sadakazu TANIGAKI.jpg;5485;5485;8845;182;182;0
/net/per920a/export/das14a/satoh-lab/haolin/nhk/excerpts/2006_05_25_19_00_1.webm;Sadakazu TANIGAKI.jpg;5501;5505;8845;183;183;0
/net/per920a/export/das14a/satoh-lab/haolin/nhk/excerpts/2006_05_25_19_00_1.webm;Sadakazu TANIGAKI.jpg;5517;5521;8845;184;184;0
/net/per920a/export/das14a/satoh-lab/haolin/nhk/excerpts/2006_05_25_19_00_1.webm;Sadakazu TANIGAKI.jpg;5541;5541;8845;184;184;0
/net/per920a/export/das14a/satoh-lab/haolin/nhk/excerpts/2006_05_25_19_00_1.webm;Sadakazu TANIGAKI.jpg;5613;5633;8845;187;187;0
/net/per920a/export/das14a/satoh-lab/haolin/nhk/excerpts/2006_05_25_19_00_1.webm;Sadakazu TANIGAKI.jpg;5665;5681;8845;188;189;1
/net/per920a/export/das14a/satoh-lab/haolin/nhk/excerpts/2006_05_25_19_00_1.webm;Yasuo FUKUDA.jpg;669;1545;8845;22;51;29
/net/per920a/export/das14a/satoh-lab/haolin/nhk/excerpts/2006_05_25_19_00_1.webm;Yasuo FUKUDA.jpg;2233;2237;8845;74;74;0
/net/per920a/export/das14a/satoh-lab/haolin/nhk/excerpts/2006_05_25_19_00_1.webm;Yasuo FUKUDA.jpg;2257;2265;8845;75;75;0
/net/per920a/export/das14a/satoh-lab/haolin/nhk/excerpts/2006_05_25_19_00_1.webm;Yasuo FUKUDA.jpg;2301;2301;8845;76;76;0
/net/per920a/export/das14a/satoh-lab/haolin/nhk/excerpts/2006_05_25_19_00_1.webm;Yasuo FUKUDA.jpg;2321;2321;8845;77;77;0
/net/per920a/export/das14a/satoh-lab/haolin/nhk/excerpts/2006_05_25_19_00_1.webm;Yasuo FUKUDA.jpg;8749;8769;8845;291;292;1
/net/per920a/export/das14a/satoh-lab/haolin/nhk/excerpts/2006_05_25_19_00_1.webm;Shinzo ABE.jpg;3045;3121;8845;101;104;3
/net/per920a/export/das14a/satoh-lab/haolin/nhk/excerpts/2006_05_25_19_00_1.webm;Shinzo ABE.jpg;3137;3229;8845;104;107;3
/net/per920a/export/das14a/satoh-lab/haolin/nhk/excerpts/2006_05_25_19_00_1.webm;Shinzo ABE.jpg;3245;3405;8845;108;113;5
/net/per920a/export/das14a/satoh-lab/haolin/nhk/excerpts/2006_05_25_19_00_1.webm;Shinzo ABE.jpg;3421;3425;8845;114;114;0
/net/per920a/export/das14a/satoh-lab/haolin/nhk/excerpts/2006_05_25_19_00_1.webm;Shinzo ABE.jpg;3445;3821;8845;114;127;13
/net/per920a/export/das14a/satoh-lab/haolin/nhk/excerpts/2006_05_25_19_00_1.webm;Shinzo ABE.jpg;3849;3889;8845;128;129;1
/net/per920a/export/das14a/satoh-lab/haolin/nhk/excerpts/2006_05_25_19_00_1.webm;Taro ASO.jpg;5821;5857;8845;194;195;1
/net/per920a/export/das14a/satoh-lab/haolin/nhk/excerpts/2006_05_25_19_00_1.webm;Taro ASO.jpg;5873;5881;8845;195;196;1
/net/per920a/export/das14a/satoh-lab/haolin/nhk/excerpts/2006_05_25_19_00_1.webm;Taro ASO.jpg;5893;6101;8845;196;203;7
/net/per920a/export/das14a/satoh-lab/haolin/nhk/excerpts/2006_05_25_19_00_1.webm;Taro ASO.jpg;6245;6545;8845;208;218;10
/net/per920a/export/das14a/satoh-lab/haolin/nhk/excerpts/2006_05_25_19_00_1.webm;Taro ASO.jpg;6561;6573;8845;218;219;1
/net/per920a/export/das14a/satoh-lab/haolin/nhk/excerpts/2006_05_25_19_00_1.webm;Taro ASO.jpg;6589;6593;8845;219;219;0
/net/per920a/export/das14a/satoh-lab/haolin/nhk/excerpts/2006_05_25_19_00_1.webm;Taro ASO.jpg;6609;6609;8845;220;220;0
/net/per920a/export/das14a/satoh-lab/haolin/nhk/excerpts/2006_05_25_19_00_1.webm;Taro ASO.jpg;6625;6677;8845;220;222;2
/net/per920a/export/das14a/satoh-lab/haolin/nhk/excerpts/2006_05_25_19_00_1.webm;Taro ASO.jpg;6689;6729;8845;223;224;1
/net/per920a/export/das14a/satoh-lab/haolin/nhk/excerpts/2006_05_25_19_00_1.webm;Junichiro KOIZUMI.jpg;8029;8345;8845;267;278;11
/net/per920a/export/das14a/satoh-lab/haolin/nhk/excerpts/2006_05_25_19_00_1.webm;Junichiro KOIZUMI.jpg;8361;8469;8845;278;282;4
/net/per920a/export/das14a/satoh-lab/haolin/nhk/excerpts/2006_05_25_19_00_1.webm;Junichiro KOIZUMI.jpg;8485;8737;8845;282;291;9
/net/per920a/export/das14a/satoh-lab/haolin/nhk/excerpts/2006_06_02_19_00_3.webm;Shinzo ABE.jpg;9;129;5105;0;4;4
/net/per920a/export/das14a/satoh-lab/haolin/nhk/excerpts/2006_06_02_19_00_3.webm;Shinzo ABE.jpg;145;277;5105;4;9;5
/net/per920a/export/das14a/satoh-lab/haolin/nhk/excerpts/2006_06_02_19_00_3.webm;Shinzo ABE.jpg;1389;1389;5105;46;46;0
/net/per920a/export/das14a/satoh-lab/haolin/nhk/excerpts/2006_06_02_19_00_3.webm;Shinzo ABE.jpg;1401;1421;5105;46;47;1
/net/per920a/export/das14a/satoh-lab/haolin/nhk/excerpts/2006_06_02_19_00_3.webm;Shinzo ABE.jpg;1509;2237;5105;50;74;24
/net/per920a/export/das14a/satoh-lab/haolin/nhk/excerpts/2006_06_02_19_00_3.webm;Shinzo ABE.jpg;5041;5049;5105;167;168;1
/net/per920a/export/das14a/satoh-lab/haolin/nhk/excerpts/2006_06_02_19_00_3.webm;Sadakazu TANIGAKI.jpg;3449;3457;5105;114;115;1
/net/per920a/export/das14a/satoh-lab/haolin/nhk/excerpts/2006_06_02_19_00_3.webm;Sadakazu TANIGAKI.jpg;3497;3497;5105;116;116;0
/net/per920a/export/das14a/satoh-lab/haolin/nhk/excerpts/2006_06_02_19_00_3.webm;Sadakazu TANIGAKI.jpg;3545;3545;5105;118;118;0
/net/per920a/export/das14a/satoh-lab/haolin/nhk/excerpts/2006_06_02_19_00_3.webm;Sadakazu TANIGAKI.jpg;3577;3589;5105;119;119;0
/net/per920a/export/das14a/satoh-lab/haolin/nhk/excerpts/2006_06_02_19_00_3.webm;Sadakazu TANIGAKI.jpg;3645;3669;5105;121;122;1
/net/per920a/export/das14a/satoh-lab/haolin/nhk/excerpts/2006_06_02_19_00_3.webm;Sadakazu TANIGAKI.jpg;3689;3697;5105;122;123;1
/net/per920a/export/das14a/satoh-lab/haolin/nhk/excerpts/2006_06_02_19_00_3.webm;Junichiro KOIZUMI.jpg;4293;5029;5105;142;167;25
/net/per920a/export/das14a/satoh-lab/haolin/nhk/excerpts/2006_06_07_19_00_3.webm;Junichiro KOIZUMI.jpg;5117;5121;10409;170;170;0
/net/per920a/export/das14a/satoh-lab/haolin/nhk/excerpts/2006_06_07_19_00_3.webm;Junichiro KOIZUMI.jpg;5133;5145;10409;171;171;0
/net/per920a/export/das14a/satoh-lab/haolin/nhk/excerpts/2006_06_07_19_00_3.webm;Junichiro KOIZUMI.jpg;5237;5241;10409;174;174;0
/net/per920a/export/das14a/satoh-lab/haolin/nhk/excerpts/2006_06_20_19_00_3.webm;Shinzo ABE.jpg;4489;5061;8153;149;168;19
/net/per920a/export/das14a/satoh-lab/haolin/nhk/excerpts/2006_06_20_19_00_3.webm;Ichiro OZAWA.jpg;5077;5113;8153;169;170;1
/net/per920a/export/das14a/satoh-lab/haolin/nhk/excerpts/2006_06_20_19_00_3.webm;Ichiro OZAWA.jpg;5133;5269;8153;171;175;4
/net/per920a/export/das14a/satoh-lab/haolin/nhk/excerpts/2006_06_20_19_00_3.webm;Ichiro OZAWA.jpg;5285;5289;8153;176;176;0
/net/per920a/export/das14a/satoh-lab/haolin/nhk/excerpts/2006_06_20_19_00_3.webm;Ichiro OZAWA.jpg;5305;5369;8153;176;179;3
/net/per920a/export/das14a/satoh-lab/haolin/nhk/excerpts/2006_06_20_19_00_3.webm;Ichiro OZAWA.jpg;5385;5385;8153;179;179;0
/net/per920a/export/das14a/satoh-lab/haolin/nhk/excerpts/2006_06_20_19_00_3.webm;Ichiro OZAWA.jpg;5401;5653;8153;180;188;8
/net/per920a/export/das14a/satoh-lab/haolin/nhk/excerpts/2006_06_20_19_00_3.webm;Ichiro OZAWA.jpg;5669;5753;8153;189;191;2
/net/per920a/export/das14a/satoh-lab/haolin/nhk/excerpts/2006_06_20_19_00_3.webm;Ichiro OZAWA.jpg;5769;5901;8153;192;196;4
/net/per920a/export/das14a/satoh-lab/haolin/nhk/excerpts/2006_06_20_19_00_3.webm;Ichiro OZAWA.jpg;5917;5977;8153;197;199;2
/net/per920a/export/das14a/satoh-lab/haolin/nhk/excerpts/2006_06_20_19_00_3.webm;Ichiro OZAWA.jpg;5993;6181;8153;199;206;7
/net/per920a/export/das14a/satoh-lab/haolin/nhk/excerpts/2006_07_15_19_00_2.webm;Junichiro KOIZUMI.jpg;15857;16277;16465;528;542;14
/net/per920a/export/das14a/satoh-lab/haolin/nhk/excerpts/2006_07_15_19_00_2.webm;Junichiro KOIZUMI.jpg;16293;16405;16465;543;546;3
/net/per920a/export/das14a/satoh-lab/haolin/nhk/excerpts/2006_07_15_19_00_2.webm;Junichiro KOIZUMI.jpg;16417;16433;16465;547;547;0
/net/per920a/export/das14a/satoh-lab/haolin/nhk/excerpts/2006_09_08_19_00_2.webm;Junichiro KOIZUMI.jpg;169;293;6629;5;9;4
/net/per920a/export/das14a/satoh-lab/haolin/nhk/excerpts/2006_09_08_19_00_2.webm;Shinzo ABE.jpg;677;753;6629;22;25;3
/net/per920a/export/das14a/satoh-lab/haolin/nhk/excerpts/2006_09_08_19_00_2.webm;Shinzo ABE.jpg;769;993;6629;25;33;8
/net/per920a/export/das14a/satoh-lab/haolin/nhk/excerpts/2006_09_08_19_00_2.webm;Shinzo ABE.jpg;3277;3281;6629;109;109;0
/net/per920a/export/das14a/satoh-lab/haolin/nhk/excerpts/2006_09_08_19_00_2.webm;Shinzo ABE.jpg;3293;3321;6629;109;110;1
/net/per920a/export/das14a/satoh-lab/haolin/nhk/excerpts/2006_09_08_19_00_2.webm;Shinzo ABE.jpg;3605;3653;6629;120;121;1
/net/per920a/export/das14a/satoh-lab/haolin/nhk/excerpts/2006_09_08_19_00_2.webm;Shinzo ABE.jpg;3833;3865;6629;127;128;1
/net/per920a/export/das14a/satoh-lab/haolin/nhk/excerpts/2006_09_08_19_00_2.webm;Shinzo ABE.jpg;4377;4461;6629;145;148;3
/net/per920a/export/das14a/satoh-lab/haolin/nhk/excerpts/2006_09_08_19_00_2.webm;Shinzo ABE.jpg;4473;4617;6629;149;153;4
/net/per920a/export/das14a/satoh-lab/haolin/nhk/excerpts/2006_09_08_19_00_2.webm;Shinzo ABE.jpg;4633;4641;6629;154;154;0
/net/per920a/export/das14a/satoh-lab/haolin/nhk/excerpts/2006_09_08_19_00_2.webm;Shinzo ABE.jpg;4657;4661;6629;155;155;0
/net/per920a/export/das14a/satoh-lab/haolin/nhk/excerpts/2006_09_08_19_00_2.webm;Sadakazu TANIGAKI.jpg;1397;1661;6629;46;55;9
/net/per920a/export/das14a/satoh-lab/haolin/nhk/excerpts/2006_09_08_19_00_2.webm;Sadakazu TANIGAKI.jpg;1677;1893;6629;55;63;8
/net/per920a/export/das14a/satoh-lab/haolin/nhk/excerpts/2006_09_08_19_00_2.webm;Sadakazu TANIGAKI.jpg;2129;2149;6629;70;71;1
/net/per920a/export/das14a/satoh-lab/haolin/nhk/excerpts/2006_09_08_19_00_2.webm;Sadakazu TANIGAKI.jpg;3369;3373;6629;112;112;0
/net/per920a/export/das14a/satoh-lab/haolin/nhk/excerpts/2006_09_08_19_00_2.webm;Sadakazu TANIGAKI.jpg;3389;3393;6629;112;113;1
/net/per920a/export/das14a/satoh-lab/haolin/nhk/excerpts/2006_09_08_19_00_2.webm;Sadakazu TANIGAKI.jpg;3901;3993;6629;130;133;3
/net/per920a/export/das14a/satoh-lab/haolin/nhk/excerpts/2006_09_08_19_00_2.webm;Taro ASO.jpg;2249;2689;6629;74;89;15
/net/per920a/export/das14a/satoh-lab/haolin/nhk/excerpts/2006_09_08_19_00_2.webm;Taro ASO.jpg;2717;2725;6629;90;90;0
/net/per920a/export/das14a/satoh-lab/haolin/nhk/excerpts/2006_09_08_19_00_2.webm;Taro ASO.jpg;2737;2757;6629;91;91;0
/net/per920a/export/das14a/satoh-lab/haolin/nhk/excerpts/2006_09_08_19_00_2.webm;Taro ASO.jpg;4025;4301;6629;134;143;9
/net/per920a/export/das14a/satoh-lab/haolin/nhk/excerpts/2006_09_08_19_00_2.webm;Taro ASO.jpg;4317;4365;6629;143;145;2
/net/per920a/export/das14a/satoh-lab/haolin/nhk/excerpts/2006_09_25_19_00_3.webm;Shinzo ABE.jpg;709;765;2165;23;25;2
/net/per920a/export/das14a/satoh-lab/haolin/nhk/excerpts/2006_09_25_19_00_3.webm;Shinzo ABE.jpg;777;777;2165;25;25;0
/net/per920a/export/das14a/satoh-lab/haolin/nhk/excerpts/2006_09_25_19_00_3.webm;Shinzo ABE.jpg;809;841;2165;26;27;1
/net/per920a/export/das14a/satoh-lab/haolin/nhk/excerpts/2006_09_25_19_00_3.webm;Shinzo ABE.jpg;853;905;2165;28;30;2
/net/per920a/export/das14a/satoh-lab/haolin/nhk/excerpts/2006_09_25_19_00_3.webm;Takenori KANZAKI.jpg;917;1021;2165;30;33;3
/net/per920a/export/das14a/satoh-lab/haolin/nhk/excerpts/2006_09_25_19_00_3.webm;Takenori KANZAKI.jpg;1485;1989;2165;49;66;17
/net/per920a/export/das14a/satoh-lab/haolin/nhk/excerpts/2006_10_04_19_00_1.webm;Shinzo ABE.jpg;2165;2165;12177;72;72;0
/net/per920a/export/das14a/satoh-lab/haolin/nhk/excerpts/2006_10_04_19_00_1.webm;Shinzo ABE.jpg;2269;2317;12177;75;77;2
/net/per920a/export/das14a/satoh-lab/haolin/nhk/excerpts/2006_10_04_19_00_1.webm;Shinzo ABE.jpg;2345;2377;12177;78;79;1
/net/per920a/export/das14a/satoh-lab/haolin/nhk/excerpts/2006_10_04_19_00_1.webm;Shinzo ABE.jpg;2393;2401;12177;79;80;1
/net/per920a/export/das14a/satoh-lab/haolin/nhk/excerpts/2006_10_04_19_00_1.webm;Shinzo ABE.jpg;2417;2465;12177;80;82;2
/net/per920a/export/das14a/satoh-lab/haolin/nhk/excerpts/2006_10_04_19_00_1.webm;Shinzo ABE.jpg;2481;2565;12177;82;85;3
/net/per920a/export/das14a/satoh-lab/haolin/nhk/excerpts/2006_10_04_19_00_1.webm;Shinzo ABE.jpg;2589;2769;12177;86;92;6
/net/per920a/export/das14a/satoh-lab/haolin/nhk/excerpts/2006_10_04_19_00_1.webm;Shinzo ABE.jpg;2873;3273;12177;95;109;14
/net/per920a/export/das14a/satoh-lab/haolin/nhk/excerpts/2006_10_14_19_00_1.webm;Shinzo ABE.jpg;17789;18133;21857;593;604;11
/net/per920a/export/das14a/satoh-lab/haolin/nhk/excerpts/2006_10_14_19_00_1.webm;Shinzo ABE.jpg;18145;18225;21857;605;607;2
/net/per920a/export/das14a/satoh-lab/haolin/nhk/excerpts/2006_10_14_19_00_1.webm;Shinzo ABE.jpg;18237;18277;21857;608;609;1
/net/per920a/export/das14a/satoh-lab/haolin/nhk/excerpts/2006_10_14_19_00_1.webm;Shinzo ABE.jpg;18301;18337;21857;610;611;1
/net/per920a/export/das14a/satoh-lab/haolin/nhk/excerpts/2006_10_14_19_00_1.webm;Shinzo ABE.jpg;18353;18365;21857;612;612;0
/net/per920a/export/das14a/satoh-lab/haolin/nhk/excerpts/2006_10_14_19_00_1.webm;Shinzo ABE.jpg;18381;18453;21857;613;615;2
/net/per920a/export/das14a/satoh-lab/haolin/nhk/excerpts/2006_10_14_19_00_1.webm;Shinzo ABE.jpg;18469;18469;21857;615;615;0
/net/per920a/export/das14a/satoh-lab/haolin/nhk/excerpts/2006_10_14_19_00_1.webm;Shinzo ABE.jpg;18485;18489;21857;616;616;0
/net/per920a/export/das14a/satoh-lab/haolin/nhk/excerpts/2006_10_14_19_00_1.webm;Shinzo ABE.jpg;18505;18633;21857;617;621;4
/net/per920a/export/das14a/satoh-lab/haolin/nhk/excerpts/2006_10_14_19_00_1.webm;Shinzo ABE.jpg;18649;18649;21857;622;622;0
/net/per920a/export/das14a/satoh-lab/haolin/nhk/excerpts/2006_10_14_19_00_1.webm;Shinzo ABE.jpg;18661;18677;21857;622;622;0
/net/per920a/export/das14a/satoh-lab/haolin/nhk/excerpts/2006_10_14_19_00_1.webm;Shinzo ABE.jpg;18697;18785;21857;623;626;3
/net/per920a/export/das14a/satoh-lab/haolin/nhk/excerpts/2006_10_14_19_00_1.webm;Shinzo ABE.jpg;18801;18845;21857;627;628;1
/net/per920a/export/das14a/satoh-lab/haolin/nhk/excerpts/2006_10_14_19_00_1.webm;Shinzo ABE.jpg;18861;19261;21857;629;642;13
/net/per920a/export/das14a/satoh-lab/haolin/nhk/excerpts/2006_10_14_19_00_1.webm;Shinzo ABE.jpg;19273;19313;21857;642;644;2
/net/per920a/export/das14a/satoh-lab/haolin/nhk/excerpts/2006_10_14_19_00_1.webm;Shinzo ABE.jpg;19325;19353;21857;644;645;1
/net/per920a/export/das14a/satoh-lab/haolin/nhk/excerpts/2006_10_14_19_00_1.webm;Shinzo ABE.jpg;19365;19405;21857;645;647;2
/net/per920a/export/das14a/satoh-lab/haolin/nhk/excerpts/2006_10_14_19_00_1.webm;Shinzo ABE.jpg;19417;19753;21857;647;658;11
/net/per920a/export/das14a/satoh-lab/haolin/nhk/excerpts/2006_10_14_19_00_1.webm;Yukio HATOYAMA.jpg;20573;20573;21857;686;686;0
/net/per920a/export/das14a/satoh-lab/haolin/nhk/excerpts/2006_10_14_19_00_1.webm;Yukio HATOYAMA.jpg;20589;20885;21857;686;696;10
/net/per920a/export/das14a/satoh-lab/haolin/nhk/excerpts/2006_10_14_19_00_1.webm;Yukio HATOYAMA.jpg;20901;20905;21857;697;697;0
/net/per920a/export/das14a/satoh-lab/haolin/nhk/excerpts/2006_10_14_19_00_1.webm;Yukio HATOYAMA.jpg;20921;20965;21857;697;699;2
/net/per920a/export/das14a/satoh-lab/haolin/nhk/excerpts/2006_10_14_19_00_1.webm;Yukio HATOYAMA.jpg;20981;21193;21857;699;706;7
/net/per920a/export/das14a/satoh-lab/haolin/nhk/excerpts/2006_10_14_19_00_1.webm;Yukio HATOYAMA.jpg;21209;21509;21857;707;717;10
/net/per920a/export/das14a/satoh-lab/haolin/nhk/excerpts/2006_10_14_19_00_1.webm;Yukio HATOYAMA.jpg;21525;21741;21857;717;725;8
/net/per920a/export/das14a/satoh-lab/haolin/nhk/excerpts/2006_10_14_19_00_1.webm;Yukio HATOYAMA.jpg;21757;21777;21857;725;726;1
/net/per920a/export/das14a/satoh-lab/haolin/nhk/excerpts/2006_10_20_19_00_3.webm;Shinzo ABE.jpg;213;333;757;7;10;3
/net/per920a/export/das14a/satoh-lab/haolin/nhk/excerpts/2006_11_01_19_00_1.webm;Taro ASO.jpg;3389;3693;21921;113;123;10
/net/per920a/export/das14a/satoh-lab/haolin/nhk/excerpts/2006_11_01_19_00_1.webm;Shinzo ABE.jpg;4117;4209;21921;137;140;3
/net/per920a/export/das14a/satoh-lab/haolin/nhk/excerpts/2006_11_01_19_00_1.webm;Shinzo ABE.jpg;4281;5445;21921;142;181;39
/net/per920a/export/das14a/satoh-lab/haolin/nhk/excerpts/2006_11_01_19_00_1.webm;Shinzo ABE.jpg;5461;5749;21921;182;191;9
/net/per920a/export/das14a/satoh-lab/haolin/nhk/excerpts/2006_11_07_19_00_2.webm;Shinzo ABE.jpg;1405;1405;5313;46;46;0
/net/per920a/export/das14a/satoh-lab/haolin/nhk/excerpts/2006_11_07_19_00_2.webm;Shinzo ABE.jpg;1417;1429;5313;47;47;0
/net/per920a/export/das14a/satoh-lab/haolin/nhk/excerpts/2006_11_07_19_00_2.webm;Shinzo ABE.jpg;1445;1445;5313;48;48;0
/net/per920a/export/das14a/satoh-lab/haolin/nhk/excerpts/2006_11_07_19_00_2.webm;Shinzo ABE.jpg;1461;1481;5313;48;49;1
/net/per920a/export/das14a/satoh-lab/haolin/nhk/excerpts/2006_11_07_19_00_2.webm;Shinzo ABE.jpg;1497;1501;5313;49;50;1
/net/per920a/export/das14a/satoh-lab/haolin/nhk/excerpts/2006_11_07_19_00_2.webm;Shinzo ABE.jpg;1521;1525;5313;50;50;0
/net/per920a/export/das14a/satoh-lab/haolin/nhk/excerpts/2006_11_07_19_00_2.webm;Shinzo ABE.jpg;1545;1557;5313;51;51;0
/net/per920a/export/das14a/satoh-lab/haolin/nhk/excerpts/2006_11_07_19_00_2.webm;Shinzo ABE.jpg;1573;1657;5313;52;55;3
/net/per920a/export/das14a/satoh-lab/haolin/nhk/excerpts/2006_11_07_19_00_2.webm;Shinzo ABE.jpg;1673;1813;5313;55;60;5
/net/per920a/export/das14a/satoh-lab/haolin/nhk/excerpts/2006_11_30_19_00_3.webm;Ichiro OZAWA.jpg;1041;1089;5165;34;36;2
/net/per920a/export/das14a/satoh-lab/haolin/nhk/excerpts/2006_11_30_19_00_3.webm;Ichiro OZAWA.jpg;1105;1109;5165;36;36;0
/net/per920a/export/das14a/satoh-lab/haolin/nhk/excerpts/2006_11_30_19_00_3.webm;Ichiro OZAWA.jpg;1125;1129;5165;37;37;0
/net/per920a/export/das14a/satoh-lab/haolin/nhk/excerpts/2006_11_30_19_00_3.webm;Ichiro OZAWA.jpg;1145;1181;5165;38;39;1
/net/per920a/export/das14a/satoh-lab/haolin/nhk/excerpts/2006_11_30_19_00_3.webm;Ichiro OZAWA.jpg;1193;1213;5165;39;40;1
/net/per920a/export/das14a/satoh-lab/haolin/nhk/excerpts/2006_11_30_19_00_3.webm;Ichiro OZAWA.jpg;1233;1453;5165;41;48;7
/net/per920a/export/das14a/satoh-lab/haolin/nhk/excerpts/2006_11_30_19_00_3.webm;Naoto KAN.jpg;2865;3945;5165;95;131;36
/net/per920a/export/das14a/satoh-lab/haolin/nhk/excerpts/2006_11_30_19_00_3.webm;Kazuo SHII.jpg;4273;4713;5165;142;156;14
/net/per920a/export/das14a/satoh-lab/haolin/nhk/excerpts/2006_12_04_19_00_1.webm;Shinzo ABE.jpg;25;457;8553;0;15;15
/net/per920a/export/das14a/satoh-lab/haolin/nhk/excerpts/2006_12_04_19_00_1.webm;Shinzo ABE.jpg;2665;2853;8553;88;95;7
/net/per920a/export/das14a/satoh-lab/haolin/nhk/excerpts/2006_12_04_19_00_1.webm;Shinzo ABE.jpg;2869;3005;8553;95;100;5
/net/per920a/export/das14a/satoh-lab/haolin/nhk/excerpts/2006_12_04_19_00_1.webm;Shinzo ABE.jpg;3021;3853;8553;100;128;28
/net/per920a/export/das14a/satoh-lab/haolin/nhk/excerpts/2006_12_04_19_00_1.webm;Shinzo ABE.jpg;3865;3977;8553;128;132;4
/net/per920a/export/das14a/satoh-lab/haolin/nhk/excerpts/2006_12_04_19_00_1.webm;Shinzo ABE.jpg;4565;4605;8553;152;153;1
/net/per920a/export/das14a/satoh-lab/haolin/nhk/excerpts/2006_12_04_19_00_1.webm;Shinzo ABE.jpg;4625;4625;8553;154;154;0
/net/per920a/export/das14a/satoh-lab/haolin/nhk/excerpts/2006_12_04_19_00_1.webm;Shinzo ABE.jpg;4645;4645;8553;154;154;0
/net/per920a/export/das14a/satoh-lab/haolin/nhk/excerpts/2006_12_04_19_00_1.webm;Shinzo ABE.jpg;4781;4781;8553;159;159;0
/net/per920a/export/das14a/satoh-lab/haolin/nhk/excerpts/2006_12_04_19_00_1.webm;Shinzo ABE.jpg;4793;4797;8553;159;159;0
/net/per920a/export/das14a/satoh-lab/haolin/nhk/excerpts/2006_12_04_19_00_1.webm;Natsuo YAMAGUCHI.jpg;801;893;8553;26;29;3
/net/per920a/export/das14a/satoh-lab/haolin/nhk/excerpts/2006_12_04_19_00_1.webm;Natsuo YAMAGUCHI.jpg;7217;7301;8553;240;243;3
/net/per920a/export/das14a/satoh-lab/haolin/nhk/excerpts/2006_12_04_19_00_1.webm;Natsuo YAMAGUCHI.jpg;7317;7373;8553;243;245;2
/net/per920a/export/das14a/satoh-lab/haolin/nhk/excerpts/2006_12_04_19_00_1.webm;Natsuo YAMAGUCHI.jpg;7389;7425;8553;246;247;1
/net/per920a/export/das14a/satoh-lab/haolin/nhk/excerpts/2006_12_04_19_00_1.webm;Natsuo YAMAGUCHI.jpg;7441;7457;8553;247;248;1
/net/per920a/export/das14a/satoh-lab/haolin/nhk/excerpts/2006_12_04_19_00_1.webm;Natsuo YAMAGUCHI.jpg;7489;7625;8553;249;254;5
/net/per920a/export/das14a/satoh-lab/haolin/nhk/excerpts/2006_12_04_19_00_1.webm;Natsuo YAMAGUCHI.jpg;7653;7701;8553;255;256;1
/net/per920a/export/das14a/satoh-lab/haolin/nhk/excerpts/2006_12_04_19_00_1.webm;Natsuo YAMAGUCHI.jpg;7725;7749;8553;257;258;1
/net/per920a/export/das14a/satoh-lab/haolin/nhk/excerpts/2006_12_04_19_00_1.webm;Natsuo YAMAGUCHI.jpg;7773;7845;8553;259;261;2
/net/per920a/export/das14a/satoh-lab/haolin/nhk/excerpts/2006_12_04_19_00_1.webm;Natsuo YAMAGUCHI.jpg;7921;7925;8553;263;264;1
/net/per920a/export/das14a/satoh-lab/haolin/nhk/excerpts/2006_12_04_19_00_1.webm;Natsuo YAMAGUCHI.jpg;7953;8109;8553;265;270;5
/net/per920a/export/das14a/satoh-lab/haolin/nhk/excerpts/2007_01_14_19_00_1.webm;Shinzo ABE.jpg;1237;1257;7585;41;41;0
/net/per920a/export/das14a/satoh-lab/haolin/nhk/excerpts/2007_01_14_19_00_1.webm;Shinzo ABE.jpg;1273;1309;7585;42;43;1
/net/per920a/export/das14a/satoh-lab/haolin/nhk/excerpts/2007_01_14_19_00_1.webm;Shinzo ABE.jpg;1325;1337;7585;44;44;0
/net/per920a/export/das14a/satoh-lab/haolin/nhk/excerpts/2007_01_14_19_00_1.webm;Shinzo ABE.jpg;1349;1401;7585;44;46;2
/net/per920a/export/das14a/satoh-lab/haolin/nhk/excerpts/2007_01_14_19_00_1.webm;Shinzo ABE.jpg;1689;1749;7585;56;58;2
/net/per920a/export/das14a/satoh-lab/haolin/nhk/excerpts/2007_01_14_19_00_1.webm;Shinzo ABE.jpg;1773;1829;7585;59;61;2
/net/per920a/export/das14a/satoh-lab/haolin/nhk/excerpts/2007_01_14_19_00_1.webm;Shinzo ABE.jpg;1841;1873;7585;61;62;1
/net/per920a/export/das14a/satoh-lab/haolin/nhk/excerpts/2007_01_14_19_00_1.webm;Shinzo ABE.jpg;6457;6541;7585;215;218;3
/net/per920a/export/das14a/satoh-lab/haolin/nhk/excerpts/2007_01_31_19_00_1.webm;Naoto KAN.jpg;4193;4197;10409;139;139;0
/net/per920a/export/das14a/satoh-lab/haolin/nhk/excerpts/2007_01_31_19_00_1.webm;Naoto KAN.jpg;4209;4213;10409;140;140;0
/net/per920a/export/das14a/satoh-lab/haolin/nhk/excerpts/2007_01_31_19_00_1.webm;Naoto KAN.jpg;4229;4229;10409;140;140;0
/net/per920a/export/das14a/satoh-lab/haolin/nhk/excerpts/2007_01_31_19_00_1.webm;Naoto KAN.jpg;4253;4257;10409;141;141;0
/net/per920a/export/das14a/satoh-lab/haolin/nhk/excerpts/2007_01_31_19_00_1.webm;Yukio HATOYAMA.jpg;4345;4357;10409;144;145;1
/net/per920a/export/das14a/satoh-lab/haolin/nhk/excerpts/2007_01_31_19_00_1.webm;Yukio HATOYAMA.jpg;4369;4385;10409;145;146;1
/net/per920a/export/das14a/satoh-lab/haolin/nhk/excerpts/2007_01_31_19_00_1.webm;Yukio HATOYAMA.jpg;4637;4641;10409;154;154;0
/net/per920a/export/das14a/satoh-lab/haolin/nhk/excerpts/2007_01_31_19_00_1.webm;Yukio HATOYAMA.jpg;4661;4669;10409;155;155;0
/net/per920a/export/das14a/satoh-lab/haolin/nhk/excerpts/2007_01_31_19_00_1.webm;Yukio HATOYAMA.jpg;4749;4753;10409;158;158;0
/net/per920a/export/das14a/satoh-lab/haolin/nhk/excerpts/2007_02_05_19_00_1.webm;Shinzo ABE.jpg;3197;3349;8609;106;111;5
/net/per920a/export/das14a/satoh-lab/haolin/nhk/excerpts/2007_02_05_19_00_1.webm;Shinzo ABE.jpg;3613;3677;8609;120;122;2
/net/per920a/export/das14a/satoh-lab/haolin/nhk/excerpts/2007_02_05_19_00_1.webm;Shinzo ABE.jpg;3689;3929;8609;122;130;8
/net/per920a/export/das14a/satoh-lab/haolin/nhk/excerpts/2007_02_05_19_00_1.webm;Shinzo ABE.jpg;3945;3993;8609;131;133;2
/net/per920a/export/das14a/satoh-lab/haolin/nhk/excerpts/2007_02_05_19_00_1.webm;Shinzo ABE.jpg;4009;4357;8609;133;145;12
/net/per920a/export/das14a/satoh-lab/haolin/nhk/excerpts/2007_02_05_19_00_1.webm;Yukio HATOYAMA.jpg;4369;4373;8609;145;145;0
/net/per920a/export/das14a/satoh-lab/haolin/nhk/excerpts/2007_02_05_19_00_1.webm;Yukio HATOYAMA.jpg;4385;4669;8609;146;155;9
/net/per920a/export/das14a/satoh-lab/haolin/nhk/excerpts/2007_02_05_19_00_1.webm;Yukio HATOYAMA.jpg;4685;5205;8609;156;173;17
/net/per920a/export/das14a/satoh-lab/haolin/nhk/excerpts/2007_02_05_19_00_1.webm;Yukio HATOYAMA.jpg;8465;8521;8609;282;284;2
/net/per920a/export/das14a/satoh-lab/haolin/nhk/excerpts/2007_02_05_19_00_1.webm;Natsuo YAMAGUCHI.jpg;7641;7721;8609;254;257;3
/net/per920a/export/das14a/satoh-lab/haolin/nhk/excerpts/2007_02_05_19_00_1.webm;Ichiro OZAWA.jpg;7929;7941;8609;264;264;0
/net/per920a/export/das14a/satoh-lab/haolin/nhk/excerpts/2007_02_05_19_00_1.webm;Ichiro OZAWA.jpg;7953;7973;8609;265;265;0
/net/per920a/export/das14a/satoh-lab/haolin/nhk/excerpts/2007_02_05_19_00_1.webm;Naoto KAN.jpg;8145;8157;8609;271;271;0
/net/per920a/export/das14a/satoh-lab/haolin/nhk/excerpts/2007_02_05_19_00_1.webm;Naoto KAN.jpg;8169;8209;8609;272;273;1
/net/per920a/export/das14a/satoh-lab/haolin/nhk/excerpts/2007_02_06_19_00_1.webm;Shinzo ABE.jpg;733;781;8941;24;26;2
/net/per920a/export/das14a/satoh-lab/haolin/nhk/excerpts/2007_02_06_19_00_1.webm;Shinzo ABE.jpg;805;833;8941;26;27;1
/net/per920a/export/das14a/satoh-lab/haolin/nhk/excerpts/2007_02_06_19_00_1.webm;Shinzo ABE.jpg;1625;1633;8941;54;54;0
/net/per920a/export/das14a/satoh-lab/haolin/nhk/excerpts/2007_02_06_19_00_1.webm;Shinzo ABE.jpg;1649;1669;8941;54;55;1
/net/per920a/export/das14a/satoh-lab/haolin/nhk/excerpts/2007_02_06_19_00_1.webm;Shinzo ABE.jpg;1685;1713;8941;56;57;1
/net/per920a/export/das14a/satoh-lab/haolin/nhk/excerpts/2007_02_06_19_00_1.webm;Ichiro OZAWA.jpg;2361;2889;8941;78;96;18
/net/per920a/export/das14a/satoh-lab/haolin/nhk/excerpts/2007_02_06_19_00_1.webm;Ichiro OZAWA.jpg;2905;2933;8941;96;97;1
/net/per920a/export/das14a/satoh-lab/haolin/nhk/excerpts/2007_02_06_19_00_1.webm;Ichiro OZAWA.jpg;2961;2981;8941;98;99;1
/net/per920a/export/das14a/satoh-lab/haolin/nhk/excerpts/2007_02_06_19_00_1.webm;Ichiro OZAWA.jpg;2997;3133;8941;99;104;5
/net/per920a/export/das14a/satoh-lab/haolin/nhk/excerpts/2007_02_06_19_00_1.webm;Ichiro OZAWA.jpg;3913;4233;8941;130;141;11
/net/per920a/export/das14a/satoh-lab/haolin/nhk/excerpts/2007_02_06_19_00_1.webm;Ichiro OZAWA.jpg;4249;4437;8941;141;147;6
/net/per920a/export/das14a/satoh-lab/haolin/nhk/excerpts/2007_02_06_19_00_1.webm;Ichiro OZAWA.jpg;4457;4581;8941;148;152;4
/net/per920a/export/das14a/satoh-lab/haolin/nhk/excerpts/2007_02_06_19_00_1.webm;Ichiro OZAWA.jpg;4597;4753;8941;153;158;5
/net/per920a/export/das14a/satoh-lab/haolin/nhk/excerpts/2007_02_06_19_00_1.webm;Ichiro OZAWA.jpg;4785;4797;8941;159;159;0
/net/per920a/export/das14a/satoh-lab/haolin/nhk/excerpts/2007_02_06_19_00_1.webm;Ichiro OZAWA.jpg;4809;4913;8941;160;163;3
/net/per920a/export/das14a/satoh-lab/haolin/nhk/excerpts/2007_02_06_19_00_1.webm;Ichiro OZAWA.jpg;4929;4977;8941;164;165;1
/net/per920a/export/das14a/satoh-lab/haolin/nhk/excerpts/2007_02_06_19_00_1.webm;Ichiro OZAWA.jpg;5065;5489;8941;168;182;14
/net/per920a/export/das14a/satoh-lab/haolin/nhk/excerpts/2007_02_06_19_00_1.webm;Ichiro OZAWA.jpg;5505;5717;8941;183;190;7
/net/per920a/export/das14a/satoh-lab/haolin/nhk/excerpts/2007_02_06_19_00_1.webm;Ichiro OZAWA.jpg;5733;5817;8941;191;193;2
/net/per920a/export/das14a/satoh-lab/haolin/nhk/excerpts/2007_02_06_19_00_1.webm;Ichiro OZAWA.jpg;5833;6981;8941;194;232;38
/net/per920a/export/das14a/satoh-lab/haolin/nhk/excerpts/2007_03_16_19_00_1.webm;Shizuka KAMEI.jpg;12713;12717;28053;424;424;0
/net/per920a/export/das14a/satoh-lab/haolin/nhk/excerpts/2007_03_16_19_00_1.webm;Shizuka KAMEI.jpg;12777;12785;28053;426;426;0
/net/per920a/export/das14a/satoh-lab/haolin/nhk/excerpts/2007_03_16_19_00_1.webm;Shizuka KAMEI.jpg;12797;12821;28053;426;427;1
/net/per920a/export/das14a/satoh-lab/haolin/nhk/excerpts/2007_03_16_19_00_1.webm;Shizuka KAMEI.jpg;12949;12949;28053;432;432;0
/net/per920a/export/das14a/satoh-lab/haolin/nhk/excerpts/2007_03_16_19_00_1.webm;Shizuka KAMEI.jpg;12977;12981;28053;432;433;1
/net/per920a/export/das14a/satoh-lab/haolin/nhk/excerpts/2007_03_16_19_00_1.webm;Shizuka KAMEI.jpg;13061;13077;28053;435;436;1
/net/per920a/export/das14a/satoh-lab/haolin/nhk/excerpts/2007_03_16_19_00_1.webm;Shizuka KAMEI.jpg;13089;13093;28053;436;436;0
/net/per920a/export/das14a/satoh-lab/haolin/nhk/excerpts/2007_03_16_19_00_1.webm;Shizuka KAMEI.jpg;13113;13121;28053;437;437;0
/net/per920a/export/das14a/satoh-lab/haolin/nhk/excerpts/2007_03_16_19_00_1.webm;Shizuka KAMEI.jpg;13181;13181;28053;439;439;0
/net/per920a/export/das14a/satoh-lab/haolin/nhk/excerpts/2007_03_16_19_00_1.webm;Shizuka KAMEI.jpg;13285;13293;28053;443;443;0
/net/per920a/export/das14a/satoh-lab/haolin/nhk/excerpts/2007_03_16_19_00_1.webm;Shizuka KAMEI.jpg;13353;13365;28053;445;445;0
/net/per920a/export/das14a/satoh-lab/haolin/nhk/excerpts/2007_03_16_19_00_1.webm;Shizuka KAMEI.jpg;13385;13421;28053;446;447;1
/net/per920a/export/das14a/satoh-lab/haolin/nhk/excerpts/2007_03_16_19_00_1.webm;Shizuka KAMEI.jpg;13493;13529;28053;450;451;1
/net/per920a/export/das14a/satoh-lab/haolin/nhk/excerpts/2007_04_09_19_00_3.webm;Ichiro OZAWA.jpg;589;661;2941;19;22;3
/net/per920a/export/das14a/satoh-lab/haolin/nhk/excerpts/2007_04_09_19_00_3.webm;Ichiro OZAWA.jpg;677;709;2941;22;23;1
/net/per920a/export/das14a/satoh-lab/haolin/nhk/excerpts/2007_04_09_19_00_3.webm;Ichiro OZAWA.jpg;725;769;2941;24;25;1
/net/per920a/export/das14a/satoh-lab/haolin/nhk/excerpts/2007_04_09_19_00_3.webm;Ichiro OZAWA.jpg;785;789;2941;26;26;0
/net/per920a/export/das14a/satoh-lab/haolin/nhk/excerpts/2007_04_09_19_00_3.webm;Ichiro OZAWA.jpg;801;833;2941;26;27;1
/net/per920a/export/das14a/satoh-lab/haolin/nhk/excerpts/2007_04_09_19_00_3.webm;Ichiro OZAWA.jpg;845;861;2941;28;28;0
/net/per920a/export/das14a/satoh-lab/haolin/nhk/excerpts/2007_04_09_19_00_3.webm;Ichiro OZAWA.jpg;885;901;2941;29;30;1
/net/per920a/export/das14a/satoh-lab/haolin/nhk/excerpts/2007_04_09_19_00_3.webm;Ichiro OZAWA.jpg;913;949;2941;30;31;1
/net/per920a/export/das14a/satoh-lab/haolin/nhk/excerpts/2007_04_09_19_00_3.webm;Ichiro OZAWA.jpg;965;969;2941;32;32;0
/net/per920a/export/das14a/satoh-lab/haolin/nhk/excerpts/2007_04_09_19_00_3.webm;Ichiro OZAWA.jpg;985;993;2941;32;33;1
/net/per920a/export/das14a/satoh-lab/haolin/nhk/excerpts/2007_04_09_19_00_3.webm;Ichiro OZAWA.jpg;1009;1041;2941;33;34;1
/net/per920a/export/das14a/satoh-lab/haolin/nhk/excerpts/2007_04_09_19_00_3.webm;Ichiro OZAWA.jpg;1069;1097;2941;35;36;1
/net/per920a/export/das14a/satoh-lab/haolin/nhk/excerpts/2007_04_09_19_00_3.webm;Ichiro OZAWA.jpg;1113;1157;2941;37;38;1
/net/per920a/export/das14a/satoh-lab/haolin/nhk/excerpts/2007_04_09_19_00_3.webm;Ichiro OZAWA.jpg;1185;1309;2941;39;43;4
/net/per920a/export/das14a/satoh-lab/haolin/nhk/excerpts/2007_04_09_19_00_3.webm;Yukio EDANO.jpg;2285;2597;2941;76;86;10
/net/per920a/export/das14a/satoh-lab/haolin/nhk/excerpts/2007_04_09_19_00_3.webm;Yukio EDANO.jpg;2613;2829;2941;87;94;7
/net/per920a/export/das14a/satoh-lab/haolin/nhk/excerpts/2007_04_11_19_00_3.webm;Yoshimi WATANABE.jpg;953;957;3121;31;31;0
/net/per920a/export/das14a/satoh-lab/haolin/nhk/excerpts/2007_04_14_19_00_2.webm;Shinzo ABE.jpg;9;277;2157;0;9;9
/net/per920a/export/das14a/satoh-lab/haolin/nhk/excerpts/2007_04_14_19_00_2.webm;Shinzo ABE.jpg;293;557;2157;9;18;9
/net/per920a/export/das14a/satoh-lab/haolin/nhk/excerpts/2007_04_14_19_00_2.webm;Shinzo ABE.jpg;645;649;2157;21;21;0
/net/per920a/export/das14a/satoh-lab/haolin/nhk/excerpts/2007_04_14_19_00_2.webm;Shinzo ABE.jpg;665;849;2157;22;28;6
/net/per920a/export/das14a/satoh-lab/haolin/nhk/excerpts/2007_04_14_19_00_2.webm;Shinzo ABE.jpg;861;877;2157;28;29;1
/net/per920a/export/das14a/satoh-lab/haolin/nhk/excerpts/2007_04_14_19_00_2.webm;Shinzo ABE.jpg;889;897;2157;29;29;0
/net/per920a/export/das14a/satoh-lab/haolin/nhk/excerpts/2007_04_14_19_00_2.webm;Shinzo ABE.jpg;961;961;2157;32;32;0
/net/per920a/export/das14a/satoh-lab/haolin/nhk/excerpts/2007_04_14_19_00_2.webm;Shinzo ABE.jpg;993;1013;2157;33;33;0
/net/per920a/export/das14a/satoh-lab/haolin/nhk/excerpts/2007_04_14_19_00_2.webm;Shinzo ABE.jpg;1025;1121;2157;34;37;3
/net/per920a/export/das14a/satoh-lab/haolin/nhk/excerpts/2007_04_14_19_00_2.webm;Shinzo ABE.jpg;1153;1157;2157;38;38;0
/net/per920a/export/das14a/satoh-lab/haolin/nhk/excerpts/2007_04_14_19_00_2.webm;Shinzo ABE.jpg;1169;1453;2157;39;48;9
/net/per920a/export/das14a/satoh-lab/haolin/nhk/excerpts/2007_04_14_19_00_2.webm;Shinzo ABE.jpg;1469;1473;2157;49;49;0
/net/per920a/export/das14a/satoh-lab/haolin/nhk/excerpts/2007_04_14_19_00_2.webm;Shinzo ABE.jpg;1501;1605;2157;50;53;3
/net/per920a/export/das14a/satoh-lab/haolin/nhk/excerpts/2007_04_14_19_00_2.webm;Shinzo ABE.jpg;1637;1653;2157;54;55;1
/net/per920a/export/das14a/satoh-lab/haolin/nhk/excerpts/2007_04_14_19_00_2.webm;Shinzo ABE.jpg;1669;1709;2157;55;57;2
/net/per920a/export/das14a/satoh-lab/haolin/nhk/excerpts/2007_04_14_19_00_2.webm;Shinzo ABE.jpg;1737;1801;2157;57;60;3
/net/per920a/export/das14a/satoh-lab/haolin/nhk/excerpts/2007_04_14_19_00_2.webm;Shinzo ABE.jpg;1857;1857;2157;61;61;0
/net/per920a/export/das14a/satoh-lab/haolin/nhk/excerpts/2007_04_14_19_00_2.webm;Shinzo ABE.jpg;1873;2073;2157;62;69;7
/net/per920a/export/das14a/satoh-lab/haolin/nhk/excerpts/2007_04_27_19_00_1.webm;Shinzo ABE.jpg;1445;1449;8221;48;48;0
/net/per920a/export/das14a/satoh-lab/haolin/nhk/excerpts/2007_04_27_19_00_1.webm;Shinzo ABE.jpg;1501;1517;8221;50;50;0
/net/per920a/export/das14a/satoh-lab/haolin/nhk/excerpts/2007_04_27_19_00_1.webm;Shinzo ABE.jpg;1529;1529;8221;50;50;0
/net/per920a/export/das14a/satoh-lab/haolin/nhk/excerpts/2007_04_27_19_00_1.webm;Shinzo ABE.jpg;1701;1705;8221;56;56;0
/net/per920a/export/das14a/satoh-lab/haolin/nhk/excerpts/2007_04_27_19_00_1.webm;Shinzo ABE.jpg;1721;1785;8221;57;59;2
/net/per920a/export/das14a/satoh-lab/haolin/nhk/excerpts/2007_04_27_19_00_1.webm;Shinzo ABE.jpg;1801;1825;8221;60;60;0
/net/per920a/export/das14a/satoh-lab/haolin/nhk/excerpts/2007_04_27_19_00_1.webm;Shinzo ABE.jpg;4033;4069;8221;134;135;1
/net/per920a/export/das14a/satoh-lab/haolin/nhk/excerpts/2007_04_27_19_00_1.webm;Shinzo ABE.jpg;5057;5101;8221;168;170;2
/net/per920a/export/das14a/satoh-lab/haolin/nhk/excerpts/2007_04_27_19_00_1.webm;Shinzo ABE.jpg;5201;5257;8221;173;175;2
/net/per920a/export/das14a/satoh-lab/haolin/nhk/excerpts/2007_04_27_19_00_1.webm;Shinzo ABE.jpg;5313;5357;8221;177;178;1
/net/per920a/export/das14a/satoh-lab/haolin/nhk/excerpts/2007_04_27_19_00_1.webm;Shinzo ABE.jpg;5381;5393;8221;179;179;0
/net/per920a/export/das14a/satoh-lab/haolin/nhk/excerpts/2007_04_27_19_00_1.webm;Shinzo ABE.jpg;5405;5405;8221;180;180;0
/net/per920a/export/das14a/satoh-lab/haolin/nhk/excerpts/2007_06_04_19_00_2.webm;Shinzo ABE.jpg;9;525;4053;0;17;17
/net/per920a/export/das14a/satoh-lab/haolin/nhk/excerpts/2007_06_04_19_00_2.webm;Shinzo ABE.jpg;941;945;4053;31;31;0
/net/per920a/export/das14a/satoh-lab/haolin/nhk/excerpts/2007_06_04_19_00_2.webm;Shinzo ABE.jpg;1013;1121;4053;33;37;4
/net/per920a/export/das14a/satoh-lab/haolin/nhk/excerpts/2007_06_04_19_00_2.webm;Shinzo ABE.jpg;3113;3253;4053;103;108;5
/net/per920a/export/das14a/satoh-lab/haolin/nhk/excerpts/2007_06_16_19_00_3.webm;Shinzo ABE.jpg;2109;2233;5945;70;74;4
/net/per920a/export/das14a/satoh-lab/haolin/nhk/excerpts/2007_06_16_19_00_3.webm;Shinzo ABE.jpg;2249;2541;5945;74;84;10
/net/per920a/export/das14a/satoh-lab/haolin/nhk/excerpts/2007_06_16_19_00_3.webm;Shinzo ABE.jpg;2553;2597;5945;85;86;1
/net/per920a/export/das14a/satoh-lab/haolin/nhk/excerpts/2007_06_16_19_00_3.webm;Shinzo ABE.jpg;2613;2969;5945;87;98;11
/net/per920a/export/das14a/satoh-lab/haolin/nhk/excerpts/2007_06_16_19_00_3.webm;Shinzo ABE.jpg;2985;3901;5945;99;129;30
/net/per920a/export/das14a/satoh-lab/haolin/nhk/excerpts/2007_06_16_19_00_3.webm;Shinzo ABE.jpg;3917;4725;5945;130;157;27
/net/per920a/export/das14a/satoh-lab/haolin/nhk/excerpts/2007_06_16_19_00_3.webm;Yukio HATOYAMA.jpg;4749;4769;5945;158;158;0
/net/per920a/export/das14a/satoh-lab/haolin/nhk/excerpts/2007_06_16_19_00_3.webm;Yukio HATOYAMA.jpg;4785;4797;5945;159;159;0
/net/per920a/export/das14a/satoh-lab/haolin/nhk/excerpts/2007_06_16_19_00_3.webm;Yukio HATOYAMA.jpg;4813;5001;5945;160;166;6
/net/per920a/export/das14a/satoh-lab/haolin/nhk/excerpts/2007_06_16_19_00_3.webm;Yukio HATOYAMA.jpg;5025;5049;5945;167;168;1
/net/per920a/export/das14a/satoh-lab/haolin/nhk/excerpts/2007_06_16_19_00_3.webm;Yukio HATOYAMA.jpg;5073;5085;5945;168;169;1
/net/per920a/export/das14a/satoh-lab/haolin/nhk/excerpts/2007_06_16_19_00_3.webm;Yukio HATOYAMA.jpg;5101;5109;5945;169;170;1
/net/per920a/export/das14a/satoh-lab/haolin/nhk/excerpts/2007_06_16_19_00_3.webm;Yukio HATOYAMA.jpg;5129;5137;5945;170;171;1
/net/per920a/export/das14a/satoh-lab/haolin/nhk/excerpts/2007_06_16_19_00_3.webm;Yukio HATOYAMA.jpg;5165;5185;5945;172;172;0
/net/per920a/export/das14a/satoh-lab/haolin/nhk/excerpts/2007_06_16_19_00_3.webm;Yukio HATOYAMA.jpg;5201;5221;5945;173;173;0
/net/per920a/export/das14a/satoh-lab/haolin/nhk/excerpts/2007_06_16_19_00_3.webm;Yukio HATOYAMA.jpg;5237;5245;5945;174;174;0
/net/per920a/export/das14a/satoh-lab/haolin/nhk/excerpts/2007_06_16_19_00_3.webm;Yukio HATOYAMA.jpg;5261;5341;5945;175;177;2
/net/per920a/export/das14a/satoh-lab/haolin/nhk/excerpts/2007_06_16_19_00_3.webm;Yukio HATOYAMA.jpg;5357;5377;5945;178;179;1
/net/per920a/export/das14a/satoh-lab/haolin/nhk/excerpts/2007_06_16_19_00_3.webm;Yukio HATOYAMA.jpg;5393;5421;5945;179;180;1
/net/per920a/export/das14a/satoh-lab/haolin/nhk/excerpts/2007_06_16_19_00_3.webm;Yukio HATOYAMA.jpg;5437;5513;5945;181;183;2
/net/per920a/export/das14a/satoh-lab/haolin/nhk/excerpts/2007_06_16_19_00_3.webm;Yukio HATOYAMA.jpg;5529;5545;5945;184;184;0
/net/per920a/export/das14a/satoh-lab/haolin/nhk/excerpts/2007_06_16_19_00_3.webm;Yukio HATOYAMA.jpg;5565;5665;5945;185;188;3
/net/per920a/export/das14a/satoh-lab/haolin/nhk/excerpts/2007_06_16_19_00_3.webm;Yukio HATOYAMA.jpg;5681;5881;5945;189;195;6
/net/per920a/export/das14a/satoh-lab/haolin/nhk/excerpts/2007_06_17_19_00_3.webm;Akihiro OHTA.jpg;1085;1801;1865;36;59;23
/net/per920a/export/das14a/satoh-lab/haolin/nhk/excerpts/2007_06_18_19_00_3.webm;Yukio HATOYAMA.jpg;2029;2093;3417;67;69;2
/net/per920a/export/das14a/satoh-lab/haolin/nhk/excerpts/2007_06_18_19_00_3.webm;Yukio HATOYAMA.jpg;2109;2133;3417;70;71;1
/net/per920a/export/das14a/satoh-lab/haolin/nhk/excerpts/2007_06_18_19_00_3.webm;Yukio HATOYAMA.jpg;2149;2169;3417;71;72;1
/net/per920a/export/das14a/satoh-lab/haolin/nhk/excerpts/2007_06_18_19_00_3.webm;Yukio HATOYAMA.jpg;2185;2269;3417;72;75;3
/net/per920a/export/das14a/satoh-lab/haolin/nhk/excerpts/2007_06_18_19_00_3.webm;Yukio HATOYAMA.jpg;2285;2285;3417;76;76;0
/net/per920a/export/das14a/satoh-lab/haolin/nhk/excerpts/2007_06_18_19_00_3.webm;Yukio HATOYAMA.jpg;2301;2589;3417;76;86;10
/net/per920a/export/das14a/satoh-lab/haolin/nhk/excerpts/2007_06_22_19_00_3.webm;Shintaro ISHIHARA.jpg;9509;9553;14689;317;318;1
/net/per920a/export/das14a/satoh-lab/haolin/nhk/excerpts/2007_06_22_19_00_3.webm;Shintaro ISHIHARA.jpg;9569;9657;14689;319;322;3
/net/per920a/export/das14a/satoh-lab/haolin/nhk/excerpts/2007_07_28_19_00_1.webm;Shinzo ABE.jpg;477;497;6509;15;16;1
/net/per920a/export/das14a/satoh-lab/haolin/nhk/excerpts/2007_07_28_19_00_1.webm;Shinzo ABE.jpg;521;525;6509;17;17;0
/net/per920a/export/das14a/satoh-lab/haolin/nhk/excerpts/2007_07_28_19_00_1.webm;Shinzo ABE.jpg;541;785;6509;18;26;8
/net/per920a/export/das14a/satoh-lab/haolin/nhk/excerpts/2007_07_28_19_00_1.webm;Ichiro OZAWA.jpg;833;897;6509;27;29;2
/net/per920a/export/das14a/satoh-lab/haolin/nhk/excerpts/2007_07_28_19_00_1.webm;Ichiro OZAWA.jpg;921;961;6509;30;32;2
/net/per920a/export/das14a/satoh-lab/haolin/nhk/excerpts/2007_07_28_19_00_1.webm;Ichiro OZAWA.jpg;977;1033;6509;32;34;2
/net/per920a/export/das14a/satoh-lab/haolin/nhk/excerpts/2007_07_28_19_00_1.webm;Ichiro OZAWA.jpg;1049;1049;6509;34;34;0
/net/per920a/export/das14a/satoh-lab/haolin/nhk/excerpts/2007_07_28_19_00_1.webm;Ichiro OZAWA.jpg;1069;1093;6509;35;36;1
/net/per920a/export/das14a/satoh-lab/haolin/nhk/excerpts/2007_07_28_19_00_1.webm;Ichiro OZAWA.jpg;1109;1137;6509;36;37;1
/net/per920a/export/das14a/satoh-lab/haolin/nhk/excerpts/2007_07_28_19_00_1.webm;Ichiro OZAWA.jpg;1153;1161;6509;38;38;0
/net/per920a/export/das14a/satoh-lab/haolin/nhk/excerpts/2007_07_28_19_00_1.webm;Ichiro OZAWA.jpg;1177;1201;6509;39;40;1
/net/per920a/export/das14a/satoh-lab/haolin/nhk/excerpts/2007_07_28_19_00_1.webm;Ichiro OZAWA.jpg;1217;1217;6509;40;40;0
/net/per920a/export/das14a/satoh-lab/haolin/nhk/excerpts/2007_07_28_19_00_1.webm;Ichiro OZAWA.jpg;1233;1265;6509;41;42;1
/net/per920a/export/das14a/satoh-lab/haolin/nhk/excerpts/2007_07_28_19_00_1.webm;Ichiro OZAWA.jpg;1281;1321;6509;42;44;2
/net/per920a/export/das14a/satoh-lab/haolin/nhk/excerpts/2007_07_28_19_00_1.webm;Ichiro OZAWA.jpg;1357;1381;6509;45;46;1
/net/per920a/export/das14a/satoh-lab/haolin/nhk/excerpts/2007_07_28_19_00_1.webm;Ichiro OZAWA.jpg;1409;1413;6509;46;47;1
/net/per920a/export/das14a/satoh-lab/haolin/nhk/excerpts/2007_07_28_19_00_1.webm;Ichiro OZAWA.jpg;1445;1529;6509;48;50;2
/net/per920a/export/das14a/satoh-lab/haolin/nhk/excerpts/2007_07_28_19_00_1.webm;Ichiro OZAWA.jpg;1549;1565;6509;51;52;1
/net/per920a/export/das14a/satoh-lab/haolin/nhk/excerpts/2007_07_28_19_00_1.webm;Ichiro OZAWA.jpg;1585;1641;6509;52;54;2
/net/per920a/export/das14a/satoh-lab/haolin/nhk/excerpts/2007_07_28_19_00_1.webm;Ichiro OZAWA.jpg;1665;1669;6509;55;55;0
/net/per920a/export/das14a/satoh-lab/haolin/nhk/excerpts/2007_07_28_19_00_1.webm;Ichiro OZAWA.jpg;1689;1781;6509;56;59;3
/net/per920a/export/das14a/satoh-lab/haolin/nhk/excerpts/2007_07_28_19_00_1.webm;Ichiro OZAWA.jpg;1797;2005;6509;59;66;7
/net/per920a/export/das14a/satoh-lab/haolin/nhk/excerpts/2007_07_28_19_00_1.webm;Ichiro OZAWA.jpg;2021;2045;6509;67;68;1
/net/per920a/export/das14a/satoh-lab/haolin/nhk/excerpts/2007_07_28_19_00_1.webm;Ichiro OZAWA.jpg;2065;2073;6509;68;69;1
/net/per920a/export/das14a/satoh-lab/haolin/nhk/excerpts/2007_07_28_19_00_1.webm;Ichiro OZAWA.jpg;2089;2113;6509;69;70;1
/net/per920a/export/das14a/satoh-lab/haolin/nhk/excerpts/2007_07_28_19_00_1.webm;Ichiro OZAWA.jpg;2145;2149;6509;71;71;0
/net/per920a/export/das14a/satoh-lab/haolin/nhk/excerpts/2007_07_28_19_00_1.webm;Ichiro OZAWA.jpg;2173;2201;6509;72;73;1
/net/per920a/export/das14a/satoh-lab/haolin/nhk/excerpts/2007_07_28_19_00_1.webm;Ichiro OZAWA.jpg;2221;2345;6509;74;78;4
/net/per920a/export/das14a/satoh-lab/haolin/nhk/excerpts/2007_07_28_19_00_1.webm;Kazuo SHII.jpg;3441;3441;6509;114;114;0
/net/per920a/export/das14a/satoh-lab/haolin/nhk/excerpts/2007_07_28_19_00_1.webm;Kazuo SHII.jpg;3469;3677;6509;115;122;7
/net/per920a/export/das14a/satoh-lab/haolin/nhk/excerpts/2007_07_28_19_00_1.webm;Kazuo SHII.jpg;3693;3821;6509;123;127;4
/net/per920a/export/das14a/satoh-lab/haolin/nhk/excerpts/2007_07_28_19_00_1.webm;Kazuo SHII.jpg;3837;4021;6509;127;134;7
/net/per920a/export/das14a/satoh-lab/haolin/nhk/excerpts/2007_07_28_19_00_1.webm;Kazuo SHII.jpg;4045;4121;6509;134;137;3
/net/per920a/export/das14a/satoh-lab/haolin/nhk/excerpts/2007_07_28_19_00_1.webm;Kazuo SHII.jpg;4141;4437;6509;138;147;9
/net/per920a/export/das14a/satoh-lab/haolin/nhk/excerpts/2007_08_19_19_00_1.webm;Shinzo ABE.jpg;413;417;929;13;13;0
/net/per920a/export/das14a/satoh-lab/haolin/nhk/excerpts/2007_08_19_19_00_1.webm;Shinzo ABE.jpg;433;465;929;14;15;1
/net/per920a/export/das14a/satoh-lab/haolin/nhk/excerpts/2007_08_19_19_00_1.webm;Shinzo ABE.jpg;481;489;929;16;16;0
/net/per920a/export/das14a/satoh-lab/haolin/nhk/excerpts/2007_08_19_19_00_1.webm;Shinzo ABE.jpg;505;557;929;16;18;2
/net/per920a/export/das14a/satoh-lab/haolin/nhk/excerpts/2007_09_16_19_00_1.webm;Yasuo FUKUDA.jpg;9;33;6629;0;1;1
/net/per920a/export/das14a/satoh-lab/haolin/nhk/excerpts/2007_09_16_19_00_1.webm;Yasuo FUKUDA.jpg;49;513;6629;1;17;16
/net/per920a/export/das14a/satoh-lab/haolin/nhk/excerpts/2007_09_16_19_00_1.webm;Yasuo FUKUDA.jpg;537;565;6629;17;18;1
/net/per920a/export/das14a/satoh-lab/haolin/nhk/excerpts/2007_09_16_19_00_1.webm;Yasuo FUKUDA.jpg;577;969;6629;19;32;13
/net/per920a/export/das14a/satoh-lab/haolin/nhk/excerpts/2007_09_16_19_00_1.webm;Yasuo FUKUDA.jpg;985;1109;6629;32;36;4
/net/per920a/export/das14a/satoh-lab/haolin/nhk/excerpts/2007_09_16_19_00_1.webm;Yasuo FUKUDA.jpg;1125;1133;6629;37;37;0
/net/per920a/export/das14a/satoh-lab/haolin/nhk/excerpts/2007_09_16_19_00_1.webm;Yasuo FUKUDA.jpg;1149;1149;6629;38;38;0
/net/per920a/export/das14a/satoh-lab/haolin/nhk/excerpts/2007_09_16_19_00_1.webm;Yasuo FUKUDA.jpg;1173;1245;6629;39;41;2
/net/per920a/export/das14a/satoh-lab/haolin/nhk/excerpts/2007_09_16_19_00_1.webm;Yasuo FUKUDA.jpg;1261;1309;6629;42;43;1
/net/per920a/export/das14a/satoh-lab/haolin/nhk/excerpts/2007_09_16_19_00_1.webm;Yasuo FUKUDA.jpg;1341;1489;6629;44;49;5
/net/per920a/export/das14a/satoh-lab/haolin/nhk/excerpts/2007_09_16_19_00_1.webm;Yasuo FUKUDA.jpg;1561;2553;6629;52;85;33
/net/per920a/export/das14a/satoh-lab/haolin/nhk/excerpts/2007_09_16_19_00_1.webm;Yasuo FUKUDA.jpg;6193;6197;6629;206;206;0
/net/per920a/export/das14a/satoh-lab/haolin/nhk/excerpts/2007_09_16_19_00_1.webm;Yasuo FUKUDA.jpg;6213;6257;6629;207;208;1
/net/per920a/export/das14a/satoh-lab/haolin/nhk/excerpts/2007_09_16_19_00_1.webm;Yasuo FUKUDA.jpg;6401;6425;6629;213;214;1
/net/per920a/export/das14a/satoh-lab/haolin/nhk/excerpts/2007_09_16_19_00_1.webm;Taro ASO.jpg;3153;3245;6629;105;108;3
/net/per920a/export/das14a/satoh-lab/haolin/nhk/excerpts/2007_09_16_19_00_1.webm;Taro ASO.jpg;3261;4217;6629;108;140;32
/net/per920a/export/das14a/satoh-lab/haolin/nhk/excerpts/2007_09_16_19_00_1.webm;Taro ASO.jpg;4577;4893;6629;152;163;11
/net/per920a/export/das14a/satoh-lab/haolin/nhk/excerpts/2007_09_16_19_00_1.webm;Taro ASO.jpg;4909;5085;6629;163;169;6
/net/per920a/export/das14a/satoh-lab/haolin/nhk/excerpts/2007_09_16_19_00_1.webm;Taro ASO.jpg;6213;6253;6629;207;208;1
/net/per920a/export/das14a/satoh-lab/haolin/nhk/excerpts/2007_09_16_19_00_1.webm;Taro ASO.jpg;6277;6289;6629;209;209;0
/net/per920a/export/das14a/satoh-lab/haolin/nhk/excerpts/2007_09_16_19_00_1.webm;Taro ASO.jpg;6369;6373;6629;212;212;0
/net/per920a/export/das14a/satoh-lab/haolin/nhk/excerpts/2007_09_18_19_00_1.webm;Yasuo FUKUDA.jpg;9;249;2949;0;8;8
/net/per920a/export/das14a/satoh-lab/haolin/nhk/excerpts/2007_09_18_19_00_1.webm;Yasuo FUKUDA.jpg;261;281;2949;8;9;1
/net/per920a/export/das14a/satoh-lab/haolin/nhk/excerpts/2007_09_18_19_00_1.webm;Yasuo FUKUDA.jpg;325;329;2949;10;10;0
/net/per920a/export/das14a/satoh-lab/haolin/nhk/excerpts/2007_09_18_19_00_1.webm;Yasuo FUKUDA.jpg;365;365;2949;12;12;0
/net/per920a/export/das14a/satoh-lab/haolin/nhk/excerpts/2007_09_18_19_00_1.webm;Yasuo FUKUDA.jpg;385;401;2949;12;13;1
/net/per920a/export/das14a/satoh-lab/haolin/nhk/excerpts/2007_09_18_19_00_1.webm;Yasuo FUKUDA.jpg;429;469;2949;14;15;1
/net/per920a/export/das14a/satoh-lab/haolin/nhk/excerpts/2007_09_18_19_00_1.webm;Yasuo FUKUDA.jpg;557;569;2949;18;18;0
/net/per920a/export/das14a/satoh-lab/haolin/nhk/excerpts/2007_09_18_19_00_1.webm;Yasuo FUKUDA.jpg;581;609;2949;19;20;1
/net/per920a/export/das14a/satoh-lab/haolin/nhk/excerpts/2007_09_18_19_00_1.webm;Yasuo FUKUDA.jpg;721;725;2949;23;24;1
/net/per920a/export/das14a/satoh-lab/haolin/nhk/excerpts/2007_09_18_19_00_1.webm;Yasuo FUKUDA.jpg;857;889;2949;28;29;1
/net/per920a/export/das14a/satoh-lab/haolin/nhk/excerpts/2007_09_18_19_00_1.webm;Yasuo FUKUDA.jpg;1197;1209;2949;39;40;1
/net/per920a/export/das14a/satoh-lab/haolin/nhk/excerpts/2007_09_18_19_00_1.webm;Shinzo ABE.jpg;1145;1161;2949;38;38;0
/net/per920a/export/das14a/satoh-lab/haolin/nhk/excerpts/2007_09_18_19_00_1.webm;Taro ASO.jpg;2473;2481;2949;82;82;0
/net/per920a/export/das14a/satoh-lab/haolin/nhk/excerpts/2007_09_18_19_00_1.webm;Taro ASO.jpg;2505;2509;2949;83;83;0
/net/per920a/export/das14a/satoh-lab/haolin/nhk/excerpts/2007_09_18_19_00_1.webm;Taro ASO.jpg;2553;2553;2949;84;84;0
/net/per920a/export/das14a/satoh-lab/haolin/nhk/excerpts/2007_09_18_19_00_1.webm;Taro ASO.jpg;2681;2681;2949;89;89;0
/net/per920a/export/das14a/satoh-lab/haolin/nhk/excerpts/2007_09_18_19_00_1.webm;Taro ASO.jpg;2773;2777;2949;92;92;0
/net/per920a/export/das14a/satoh-lab/haolin/nhk/excerpts/2007_09_18_19_00_1.webm;Taro ASO.jpg;2797;2809;2949;92;93;1
/net/per920a/export/das14a/satoh-lab/haolin/nhk/excerpts/2007_10_30_19_00_1.webm;Yasuo FUKUDA.jpg;9;645;19033;0;21;21
/net/per920a/export/das14a/satoh-lab/haolin/nhk/excerpts/2007_10_30_19_00_1.webm;Yasuo FUKUDA.jpg;697;705;19033;23;23;0
/net/per920a/export/das14a/satoh-lab/haolin/nhk/excerpts/2007_10_30_19_00_1.webm;Yasuo FUKUDA.jpg;765;769;19033;25;25;0
/net/per920a/export/das14a/satoh-lab/haolin/nhk/excerpts/2007_10_30_19_00_1.webm;Yasuo FUKUDA.jpg;1057;1209;19033;35;40;5
/net/per920a/export/das14a/satoh-lab/haolin/nhk/excerpts/2007_10_30_19_00_1.webm;Yasuo FUKUDA.jpg;1677;2585;19033;55;86;31
/net/per920a/export/das14a/satoh-lab/haolin/nhk/excerpts/2007_10_30_19_00_1.webm;Yasuo FUKUDA.jpg;3237;3401;19033;107;113;6
/net/per920a/export/das14a/satoh-lab/haolin/nhk/excerpts/2007_10_30_19_00_1.webm;Yasuo FUKUDA.jpg;3685;4129;19033;122;137;15
/net/per920a/export/das14a/satoh-lab/haolin/nhk/excerpts/2007_10_30_19_00_1.webm;Yasuo FUKUDA.jpg;6113;6169;19033;203;205;2
/net/per920a/export/das14a/satoh-lab/haolin/nhk/excerpts/2007_10_30_19_00_1.webm;Yasuo FUKUDA.jpg;6185;6229;19033;206;207;1
/net/per920a/export/das14a/satoh-lab/haolin/nhk/excerpts/2007_10_30_19_00_1.webm;Yasuo FUKUDA.jpg;6257;6349;19033;208;211;3
/net/per920a/export/das14a/satoh-lab/haolin/nhk/excerpts/2007_10_30_19_00_1.webm;Yasuo FUKUDA.jpg;6373;6525;19033;212;217;5
/net/per920a/export/das14a/satoh-lab/haolin/nhk/excerpts/2007_10_30_19_00_1.webm;Yasuo FUKUDA.jpg;10161;10269;19033;339;342;3
/net/per920a/export/das14a/satoh-lab/haolin/nhk/excerpts/2007_10_30_19_00_1.webm;Yasuo FUKUDA.jpg;10977;10993;19033;366;366;0
/net/per920a/export/das14a/satoh-lab/haolin/nhk/excerpts/2007_10_30_19_00_1.webm;Yasuo FUKUDA.jpg;11009;11057;19033;367;368;1
/net/per920a/export/das14a/satoh-lab/haolin/nhk/excerpts/2007_10_30_19_00_1.webm;Yasuo FUKUDA.jpg;11357;11461;19033;378;382;4
/net/per920a/export/das14a/satoh-lab/haolin/nhk/excerpts/2007_10_30_19_00_1.webm;Yasuo FUKUDA.jpg;11957;12041;19033;398;401;3
/net/per920a/export/das14a/satoh-lab/haolin/nhk/excerpts/2007_10_30_19_00_1.webm;Yasuo FUKUDA.jpg;12057;12365;19033;402;412;10
/net/per920a/export/das14a/satoh-lab/haolin/nhk/excerpts/2007_10_30_19_00_1.webm;Yasuo FUKUDA.jpg;12405;12689;19033;413;423;10
/net/per920a/export/das14a/satoh-lab/haolin/nhk/excerpts/2007_10_30_19_00_1.webm;Yasuo FUKUDA.jpg;14285;14289;19033;476;476;0
/net/per920a/export/das14a/satoh-lab/haolin/nhk/excerpts/2007_10_30_19_00_1.webm;Yasuo FUKUDA.jpg;14309;14317;19033;477;477;0
/net/per920a/export/das14a/satoh-lab/haolin/nhk/excerpts/2007_10_30_19_00_1.webm;Yasuo FUKUDA.jpg;14829;15649;19033;494;522;28
/net/per920a/export/das14a/satoh-lab/haolin/nhk/excerpts/2007_10_30_19_00_1.webm;Yasuo FUKUDA.jpg;16097;16101;19033;537;537;0
/net/per920a/export/das14a/satoh-lab/haolin/nhk/excerpts/2007_10_30_19_00_1.webm;Yasuo FUKUDA.jpg;16145;16145;19033;538;538;0
/net/per920a/export/das14a/satoh-lab/haolin/nhk/excerpts/2007_10_30_19_00_1.webm;Yasuo FUKUDA.jpg;16165;16165;19033;539;539;0
/net/per920a/export/das14a/satoh-lab/haolin/nhk/excerpts/2007_10_30_19_00_1.webm;Yasuo FUKUDA.jpg;16177;16177;19033;539;539;0
/net/per920a/export/das14a/satoh-lab/haolin/nhk/excerpts/2007_10_30_19_00_1.webm;Yasuo FUKUDA.jpg;16213;16717;19033;540;557;17
/net/per920a/export/das14a/satoh-lab/haolin/nhk/excerpts/2007_10_30_19_00_1.webm;Yasuo FUKUDA.jpg;16741;16745;19033;558;558;0
/net/per920a/export/das14a/satoh-lab/haolin/nhk/excerpts/2007_10_30_19_00_1.webm;Yasuo FUKUDA.jpg;16765;16777;19033;559;559;0
/net/per920a/export/das14a/satoh-lab/haolin/nhk/excerpts/2007_10_30_19_00_1.webm;Yasuo FUKUDA.jpg;16793;16925;19033;560;564;4
/net/per920a/export/das14a/satoh-lab/haolin/nhk/excerpts/2007_10_30_19_00_1.webm;Yasuo FUKUDA.jpg;16945;16945;19033;565;565;0
/net/per920a/export/das14a/satoh-lab/haolin/nhk/excerpts/2007_10_30_19_00_1.webm;Yasuo FUKUDA.jpg;16973;17009;19033;566;567;1
/net/per920a/export/das14a/satoh-lab/haolin/nhk/excerpts/2007_10_30_19_00_1.webm;Yasuo FUKUDA.jpg;17025;17025;19033;568;568;0
/net/per920a/export/das14a/satoh-lab/haolin/nhk/excerpts/2007_10_30_19_00_1.webm;Yasuo FUKUDA.jpg;17041;17053;19033;568;568;0
/net/per920a/export/das14a/satoh-lab/haolin/nhk/excerpts/2007_10_30_19_00_1.webm;Yasuo FUKUDA.jpg;17069;17093;19033;569;570;1
/net/per920a/export/das14a/satoh-lab/haolin/nhk/excerpts/2007_10_30_19_00_1.webm;Yasuo FUKUDA.jpg;17109;17157;19033;570;572;2
/net/per920a/export/das14a/satoh-lab/haolin/nhk/excerpts/2007_10_30_19_00_1.webm;Yasuo FUKUDA.jpg;17173;17177;19033;572;573;1
/net/per920a/export/das14a/satoh-lab/haolin/nhk/excerpts/2007_10_30_19_00_1.webm;Yasuo FUKUDA.jpg;17189;17189;19033;573;573;0
/net/per920a/export/das14a/satoh-lab/haolin/nhk/excerpts/2007_10_30_19_00_1.webm;Yasuo FUKUDA.jpg;17217;17217;19033;574;574;0
/net/per920a/export/das14a/satoh-lab/haolin/nhk/excerpts/2007_10_30_19_00_1.webm;Yasuo FUKUDA.jpg;17237;17421;19033;575;581;6
/net/per920a/export/das14a/satoh-lab/haolin/nhk/excerpts/2007_10_30_19_00_1.webm;Yasuo FUKUDA.jpg;18233;18237;19033;608;608;0
/net/per920a/export/das14a/satoh-lab/haolin/nhk/excerpts/2007_10_30_19_00_1.webm;Yasuo FUKUDA.jpg;18261;18309;19033;609;610;1
/net/per920a/export/das14a/satoh-lab/haolin/nhk/excerpts/2007_10_30_19_00_1.webm;Yasuo FUKUDA.jpg;18433;18453;19033;614;615;1
/net/per920a/export/das14a/satoh-lab/haolin/nhk/excerpts/2007_10_30_19_00_1.webm;Yasuo FUKUDA.jpg;18481;18481;19033;616;616;0
/net/per920a/export/das14a/satoh-lab/haolin/nhk/excerpts/2007_10_30_19_00_1.webm;Yasuo FUKUDA.jpg;18505;18981;19033;617;633;16
/net/per920a/export/das14a/satoh-lab/haolin/nhk/excerpts/2007_10_30_19_00_1.webm;Ichiro OZAWA.jpg;853;853;19033;28;28;0
/net/per920a/export/das14a/satoh-lab/haolin/nhk/excerpts/2007_10_30_19_00_1.webm;Ichiro OZAWA.jpg;1233;1241;19033;41;41;0
/net/per920a/export/das14a/satoh-lab/haolin/nhk/excerpts/2007_10_30_19_00_1.webm;Ichiro OZAWA.jpg;1269;1489;19033;42;49;7
/net/per920a/export/das14a/satoh-lab/haolin/nhk/excerpts/2007_10_30_19_00_1.webm;Ichiro OZAWA.jpg;1521;1581;19033;50;52;2
/net/per920a/export/das14a/satoh-lab/haolin/nhk/excerpts/2007_10_30_19_00_1.webm;Ichiro OZAWA.jpg;2609;2641;19033;87;88;1
/net/per920a/export/das14a/satoh-lab/haolin/nhk/excerpts/2007_10_30_19_00_1.webm;Ichiro OZAWA.jpg;2661;3209;19033;88;107;19
/net/per920a/export/das14a/satoh-lab/haolin/nhk/excerpts/2007_10_30_19_00_1.webm;Ichiro OZAWA.jpg;4285;4289;19033;142;143;1
/net/per920a/export/das14a/satoh-lab/haolin/nhk/excerpts/2007_10_30_19_00_1.webm;Ichiro OZAWA.jpg;4309;4333;19033;143;144;1
/net/per920a/export/das14a/satoh-lab/haolin/nhk/excerpts/2007_10_30_19_00_1.webm;Ichiro OZAWA.jpg;4401;4405;19033;146;146;0
/net/per920a/export/das14a/satoh-lab/haolin/nhk/excerpts/2007_10_30_19_00_1.webm;Ichiro OZAWA.jpg;4421;4785;19033;147;159;12
/net/per920a/export/das14a/satoh-lab/haolin/nhk/excerpts/2007_10_30_19_00_1.webm;Ichiro OZAWA.jpg;4817;4821;19033;160;160;0
/net/per920a/export/das14a/satoh-lab/haolin/nhk/excerpts/2007_10_30_19_00_1.webm;Ichiro OZAWA.jpg;4837;4865;19033;161;162;1
/net/per920a/export/das14a/satoh-lab/haolin/nhk/excerpts/2007_10_30_19_00_1.webm;Ichiro OZAWA.jpg;4881;5237;19033;162;174;12
/net/per920a/export/das14a/satoh-lab/haolin/nhk/excerpts/2007_10_30_19_00_1.webm;Ichiro OZAWA.jpg;5253;5253;19033;175;175;0
/net/per920a/export/das14a/satoh-lab/haolin/nhk/excerpts/2007_10_30_19_00_1.webm;Ichiro OZAWA.jpg;5269;5305;19033;175;176;1
/net/per920a/export/das14a/satoh-lab/haolin/nhk/excerpts/2007_10_30_19_00_1.webm;Ichiro OZAWA.jpg;5321;5485;19033;177;182;5
/net/per920a/export/das14a/satoh-lab/haolin/nhk/excerpts/2007_10_30_19_00_1.webm;Ichiro OZAWA.jpg;5501;6097;19033;183;203;20
/net/per920a/export/das14a/satoh-lab/haolin/nhk/excerpts/2007_10_30_19_00_1.webm;Ichiro OZAWA.jpg;7917;8289;19033;264;276;12
/net/per920a/export/das14a/satoh-lab/haolin/nhk/excerpts/2007_10_30_19_00_1.webm;Ichiro OZAWA.jpg;8305;8541;19033;277;284;7
/net/per920a/export/das14a/satoh-lab/haolin/nhk/excerpts/2007_10_30_19_00_1.webm;Ichiro OZAWA.jpg;11077;11237;19033;369;374;5
/net/per920a/export/das14a/satoh-lab/haolin/nhk/excerpts/2007_10_30_19_00_1.webm;Ichiro OZAWA.jpg;11253;11341;19033;375;378;3
/net/per920a/export/das14a/satoh-lab/haolin/nhk/excerpts/2007_10_30_19_00_1.webm;Ichiro OZAWA.jpg;13973;14117;19033;466;470;4
/net/per920a/export/das14a/satoh-lab/haolin/nhk/excerpts/2007_11_03_19_00_1.webm;Yasuo FUKUDA.jpg;829;933;8069;27;31;4
/net/per920a/export/das14a/satoh-lab/haolin/nhk/excerpts/2007_11_03_19_00_1.webm;Yasuo FUKUDA.jpg;1269;1333;8069;42;44;2
/net/per920a/export/das14a/satoh-lab/haolin/nhk/excerpts/2007_11_03_19_00_1.webm;Yasuo FUKUDA.jpg;1653;2025;8069;55;67;12
/net/per920a/export/das14a/satoh-lab/haolin/nhk/excerpts/2007_11_03_19_00_1.webm;Yasuo FUKUDA.jpg;3073;3153;8069;102;105;3
/net/per920a/export/das14a/satoh-lab/haolin/nhk/excerpts/2007_11_03_19_00_1.webm;Yasuo FUKUDA.jpg;3169;3673;8069;105;122;17
/net/per920a/export/das14a/satoh-lab/haolin/nhk/excerpts/2007_11_03_19_00_1.webm;Yasuo FUKUDA.jpg;3689;3757;8069;122;125;3
/net/per920a/export/das14a/satoh-lab/haolin/nhk/excerpts/2007_11_03_19_00_1.webm;Yasuo FUKUDA.jpg;4141;4261;8069;138;142;4
/net/per920a/export/das14a/satoh-lab/haolin/nhk/excerpts/2007_11_03_19_00_1.webm;Naoto KAN.jpg;2161;2213;8069;72;73;1
/net/per920a/export/das14a/satoh-lab/haolin/nhk/excerpts/2007_11_03_19_00_1.webm;Yukio HATOYAMA.jpg;2237;2245;8069;74;74;0
/net/per920a/export/das14a/satoh-lab/haolin/nhk/excerpts/2007_11_03_19_00_1.webm;Yukio HATOYAMA.jpg;2261;2305;8069;75;76;1
/net/per920a/export/das14a/satoh-lab/haolin/nhk/excerpts/2007_11_03_19_00_1.webm;Yukio HATOYAMA.jpg;5813;5817;8069;193;193;0
/net/per920a/export/das14a/satoh-lab/haolin/nhk/excerpts/2007_11_03_19_00_1.webm;Yukio HATOYAMA.jpg;6113;6117;8069;203;203;0
/net/per920a/export/das14a/satoh-lab/haolin/nhk/excerpts/2007_11_03_19_00_1.webm;Yukio HATOYAMA.jpg;6161;6177;8069;205;205;0
/net/per920a/export/das14a/satoh-lab/haolin/nhk/excerpts/2007_11_03_19_00_1.webm;Yukio HATOYAMA.jpg;6249;6257;8069;208;208;0
/net/per920a/export/das14a/satoh-lab/haolin/nhk/excerpts/2007_11_03_19_00_1.webm;Yukio HATOYAMA.jpg;6345;6357;8069;211;211;0
/net/per920a/export/das14a/satoh-lab/haolin/nhk/excerpts/2007_11_03_19_00_1.webm;Yukio HATOYAMA.jpg;6373;6385;8069;212;212;0
/net/per920a/export/das14a/satoh-lab/haolin/nhk/excerpts/2007_11_03_19_00_1.webm;Yukio HATOYAMA.jpg;6397;6441;8069;213;214;1
/net/per920a/export/das14a/satoh-lab/haolin/nhk/excerpts/2007_11_03_19_00_1.webm;Yukio HATOYAMA.jpg;6457;6469;8069;215;215;0
/net/per920a/export/das14a/satoh-lab/haolin/nhk/excerpts/2007_11_03_19_00_1.webm;Yukio HATOYAMA.jpg;6493;6529;8069;216;217;1
/net/per920a/export/das14a/satoh-lab/haolin/nhk/excerpts/2007_11_03_19_00_1.webm;Yukio HATOYAMA.jpg;6661;6693;8069;222;223;1
/net/per920a/export/das14a/satoh-lab/haolin/nhk/excerpts/2007_11_03_19_00_1.webm;Yukio HATOYAMA.jpg;6717;6737;8069;223;224;1
/net/per920a/export/das14a/satoh-lab/haolin/nhk/excerpts/2007_11_03_19_00_1.webm;Yukio HATOYAMA.jpg;6749;6749;8069;224;224;0
/net/per920a/export/das14a/satoh-lab/haolin/nhk/excerpts/2007_11_03_19_00_1.webm;Yukio HATOYAMA.jpg;6925;6949;8069;230;231;1
/net/per920a/export/das14a/satoh-lab/haolin/nhk/excerpts/2007_11_03_19_00_1.webm;Ichiro OZAWA.jpg;2325;2485;8069;77;82;5
/net/per920a/export/das14a/satoh-lab/haolin/nhk/excerpts/2007_11_03_19_00_1.webm;Ichiro OZAWA.jpg;2509;2513;8069;83;83;0
/net/per920a/export/das14a/satoh-lab/haolin/nhk/excerpts/2007_11_03_19_00_1.webm;Ichiro OZAWA.jpg;2545;2737;8069;84;91;7
/net/per920a/export/das14a/satoh-lab/haolin/nhk/excerpts/2007_11_03_19_00_1.webm;Ichiro OZAWA.jpg;2769;2881;8069;92;96;4
/net/per920a/export/das14a/satoh-lab/haolin/nhk/excerpts/2007_11_03_19_00_1.webm;Ichiro OZAWA.jpg;2897;2913;8069;96;97;1
/net/per920a/export/das14a/satoh-lab/haolin/nhk/excerpts/2007_11_03_19_00_1.webm;Ichiro OZAWA.jpg;2969;2973;8069;98;99;1
/net/per920a/export/das14a/satoh-lab/haolin/nhk/excerpts/2007_11_03_19_00_1.webm;Ichiro OZAWA.jpg;2989;2993;8069;99;99;0
/net/per920a/export/das14a/satoh-lab/haolin/nhk/excerpts/2007_11_03_19_00_1.webm;Ichiro OZAWA.jpg;3009;3029;8069;100;100;0
/net/per920a/export/das14a/satoh-lab/haolin/nhk/excerpts/2007_11_03_19_00_1.webm;Taro ASO.jpg;4689;5133;8069;156;171;15
/net/per920a/export/das14a/satoh-lab/haolin/nhk/excerpts/2007_11_03_19_00_1.webm;Taro ASO.jpg;5165;5537;8069;172;184;12
/net/per920a/export/das14a/satoh-lab/haolin/nhk/excerpts/2007_11_20_19_00_1.webm;Yasuo FUKUDA.jpg;4509;4509;11309;150;150;0
/net/per920a/export/das14a/satoh-lab/haolin/nhk/excerpts/2007_11_20_19_00_1.webm;Yasuo FUKUDA.jpg;4521;4521;11309;150;150;0
/net/per920a/export/das14a/satoh-lab/haolin/nhk/excerpts/2007_11_20_19_00_1.webm;Yasuo FUKUDA.jpg;4533;4665;11309;151;155;4
/net/per920a/export/das14a/satoh-lab/haolin/nhk/excerpts/2007_11_20_19_00_1.webm;Yasuo FUKUDA.jpg;4677;4677;11309;155;155;0
/net/per920a/export/das14a/satoh-lab/haolin/nhk/excerpts/2007_11_20_19_00_1.webm;Yasuo FUKUDA.jpg;4741;4749;11309;158;158;0
/net/per920a/export/das14a/satoh-lab/haolin/nhk/excerpts/2007_11_20_19_00_1.webm;Yasuo FUKUDA.jpg;4809;4873;11309;160;162;2
/net/per920a/export/das14a/satoh-lab/haolin/nhk/excerpts/2007_11_20_19_00_1.webm;Yasuo FUKUDA.jpg;4885;4885;11309;162;162;0
/net/per920a/export/das14a/satoh-lab/haolin/nhk/excerpts/2007_11_20_19_00_1.webm;Yasuo FUKUDA.jpg;4901;4901;11309;163;163;0
/net/per920a/export/das14a/satoh-lab/haolin/nhk/excerpts/2007_11_20_19_00_1.webm;Yasuo FUKUDA.jpg;4917;5013;11309;163;167;4
/net/per920a/export/das14a/satoh-lab/haolin/nhk/excerpts/2007_11_20_19_00_1.webm;Yasuo FUKUDA.jpg;5045;5057;11309;168;168;0
/net/per920a/export/das14a/satoh-lab/haolin/nhk/excerpts/2007_11_20_19_00_1.webm;Yasuo FUKUDA.jpg;5077;5145;11309;169;171;2
/net/per920a/export/das14a/satoh-lab/haolin/nhk/excerpts/2007_11_20_19_00_1.webm;Yasuo FUKUDA.jpg;5681;5693;11309;189;189;0
/net/per920a/export/das14a/satoh-lab/haolin/nhk/excerpts/2007_11_20_19_00_1.webm;Yasuo FUKUDA.jpg;5713;5713;11309;190;190;0
/net/per920a/export/das14a/satoh-lab/haolin/nhk/excerpts/2007_11_20_19_00_1.webm;Yasuo FUKUDA.jpg;7957;7969;11309;265;265;0
/net/per920a/export/das14a/satoh-lab/haolin/nhk/excerpts/2007_11_20_19_00_1.webm;Yasuo FUKUDA.jpg;9597;9609;11309;319;320;1
/net/per920a/export/das14a/satoh-lab/haolin/nhk/excerpts/2007_11_20_19_00_1.webm;Yasuo FUKUDA.jpg;9841;9849;11309;328;328;0
/net/per920a/export/das14a/satoh-lab/haolin/nhk/excerpts/2007_11_20_19_00_1.webm;Yasuo FUKUDA.jpg;9861;9901;11309;328;330;2
/net/per920a/export/das14a/satoh-lab/haolin/nhk/excerpts/2007_11_20_19_00_1.webm;Yasuo FUKUDA.jpg;10041;10041;11309;334;334;0
/net/per920a/export/das14a/satoh-lab/haolin/nhk/excerpts/2007_11_20_19_00_1.webm;Yasuo FUKUDA.jpg;10057;10073;11309;335;335;0
/net/per920a/export/das14a/satoh-lab/haolin/nhk/excerpts/2007_11_20_19_00_1.webm;Yasuo FUKUDA.jpg;10109;10113;11309;336;337;1
/net/per920a/export/das14a/satoh-lab/haolin/nhk/excerpts/2007_11_28_19_00_1.webm;Yasuo FUKUDA.jpg;22673;22845;32289;756;761;5
/net/per920a/export/das14a/satoh-lab/haolin/nhk/excerpts/2007_11_28_19_00_1.webm;Yasuo FUKUDA.jpg;22861;23493;32289;762;783;21
/net/per920a/export/das14a/satoh-lab/haolin/nhk/excerpts/2007_11_28_19_00_1.webm;Yasuo FUKUDA.jpg;23505;23505;32289;784;784;0
/net/per920a/export/das14a/satoh-lab/haolin/nhk/excerpts/2007_11_28_19_00_1.webm;Yasuo FUKUDA.jpg;23529;23537;32289;784;785;1
/net/per920a/export/das14a/satoh-lab/haolin/nhk/excerpts/2007_11_28_19_00_1.webm;Yasuo FUKUDA.jpg;23557;23565;32289;785;786;1
/net/per920a/export/das14a/satoh-lab/haolin/nhk/excerpts/2007_11_28_19_00_1.webm;Yasuo FUKUDA.jpg;23577;23577;32289;786;786;0
/net/per920a/export/das14a/satoh-lab/haolin/nhk/excerpts/2007_11_28_19_00_1.webm;Yasuo FUKUDA.jpg;23589;23613;32289;786;787;1
/net/per920a/export/das14a/satoh-lab/haolin/nhk/excerpts/2007_11_28_19_00_1.webm;Yasuo FUKUDA.jpg;23629;23649;32289;788;788;0
/net/per920a/export/das14a/satoh-lab/haolin/nhk/excerpts/2007_11_28_19_00_1.webm;Yasuo FUKUDA.jpg;23661;23661;32289;789;789;0
/net/per920a/export/das14a/satoh-lab/haolin/nhk/excerpts/2007_11_28_19_00_1.webm;Yasuo FUKUDA.jpg;23673;23685;32289;789;790;1
/net/per920a/export/das14a/satoh-lab/haolin/nhk/excerpts/2007_11_28_19_00_1.webm;Yasuo FUKUDA.jpg;23701;24321;32289;790;811;21
/net/per920a/export/das14a/satoh-lab/haolin/nhk/excerpts/2007_11_28_19_00_1.webm;Yasuo FUKUDA.jpg;30961;31081;32289;1032;1036;4
/net/per920a/export/das14a/satoh-lab/haolin/nhk/excerpts/2007_11_28_19_00_1.webm;Yukio HATOYAMA.jpg;25973;26229;32289;866;874;8
/net/per920a/export/das14a/satoh-lab/haolin/nhk/excerpts/2007_11_28_19_00_1.webm;Yukio HATOYAMA.jpg;26245;26289;32289;875;876;1
/net/per920a/export/das14a/satoh-lab/haolin/nhk/excerpts/2007_11_28_19_00_1.webm;Yukio HATOYAMA.jpg;26305;26413;32289;877;881;4
/net/per920a/export/das14a/satoh-lab/haolin/nhk/excerpts/2007_11_28_19_00_1.webm;Yukio HATOYAMA.jpg;26425;26425;32289;881;881;0
/net/per920a/export/das14a/satoh-lab/haolin/nhk/excerpts/2007_11_28_19_00_1.webm;Yukio HATOYAMA.jpg;26437;26445;32289;881;882;1
/net/per920a/export/das14a/satoh-lab/haolin/nhk/excerpts/2007_11_28_19_00_1.webm;Yukio HATOYAMA.jpg;26457;26461;32289;882;882;0
/net/per920a/export/das14a/satoh-lab/haolin/nhk/excerpts/2007_11_28_19_00_1.webm;Yukio HATOYAMA.jpg;26477;26505;32289;883;884;1
/net/per920a/export/das14a/satoh-lab/haolin/nhk/excerpts/2007_11_28_19_00_1.webm;Yukio HATOYAMA.jpg;26537;26541;32289;885;885;0
/net/per920a/export/das14a/satoh-lab/haolin/nhk/excerpts/2007_11_28_19_00_1.webm;Yukio HATOYAMA.jpg;26573;26629;32289;886;888;2
/net/per920a/export/das14a/satoh-lab/haolin/nhk/excerpts/2007_11_28_19_00_1.webm;Yukio HATOYAMA.jpg;26649;26653;32289;888;889;1
/net/per920a/export/das14a/satoh-lab/haolin/nhk/excerpts/2007_11_28_19_00_1.webm;Yukio HATOYAMA.jpg;26665;26669;32289;889;889;0
/net/per920a/export/das14a/satoh-lab/haolin/nhk/excerpts/2007_11_28_19_00_1.webm;Yukio HATOYAMA.jpg;26725;26729;32289;891;891;0
/net/per920a/export/das14a/satoh-lab/haolin/nhk/excerpts/2007_12_10_19_00_1.webm;Takenori KANZAKI.jpg;2257;2269;4977;75;75;0
/net/per920a/export/das14a/satoh-lab/haolin/nhk/excerpts/2007_12_10_19_00_1.webm;Takenori KANZAKI.jpg;2285;2285;4977;76;76;0
/net/per920a/export/das14a/satoh-lab/haolin/nhk/excerpts/2007_12_10_19_00_1.webm;Takenori KANZAKI.jpg;2345;2345;4977;78;78;0
/net/per920a/export/das14a/satoh-lab/haolin/nhk/excerpts/2007_12_10_19_00_1.webm;Takenori KANZAKI.jpg;2361;2365;4977;78;78;0
/net/per920a/export/das14a/satoh-lab/haolin/nhk/excerpts/2007_12_10_19_00_1.webm;Takenori KANZAKI.jpg;2429;2437;4977;81;81;0
/net/per920a/export/das14a/satoh-lab/haolin/nhk/excerpts/2007_12_10_19_00_1.webm;Takenori KANZAKI.jpg;2469;2469;4977;82;82;0
/net/per920a/export/das14a/satoh-lab/haolin/nhk/excerpts/2007_12_10_19_00_1.webm;Takenori KANZAKI.jpg;2489;2489;4977;83;83;0
/net/per920a/export/das14a/satoh-lab/haolin/nhk/excerpts/2007_12_10_19_00_1.webm;Takenori KANZAKI.jpg;2501;2561;4977;83;85;2
/net/per920a/export/das14a/satoh-lab/haolin/nhk/excerpts/2007_12_10_19_00_1.webm;Yukio HATOYAMA.jpg;2585;2585;4977;86;86;0
/net/per920a/export/das14a/satoh-lab/haolin/nhk/excerpts/2007_12_10_19_00_1.webm;Yukio HATOYAMA.jpg;2597;2601;4977;86;86;0
/net/per920a/export/das14a/satoh-lab/haolin/nhk/excerpts/2007_12_10_19_00_1.webm;Yukio HATOYAMA.jpg;2649;2653;4977;88;88;0
/net/per920a/export/das14a/satoh-lab/haolin/nhk/excerpts/2007_12_10_19_00_1.webm;Yukio HATOYAMA.jpg;2681;2685;4977;89;89;0
/net/per920a/export/das14a/satoh-lab/haolin/nhk/excerpts/2007_12_10_19_00_1.webm;Yukio HATOYAMA.jpg;2701;2729;4977;90;91;1
/net/per920a/export/das14a/satoh-lab/haolin/nhk/excerpts/2007_12_10_19_00_1.webm;Yukio HATOYAMA.jpg;2741;2741;4977;91;91;0
/net/per920a/export/das14a/satoh-lab/haolin/nhk/excerpts/2007_12_10_19_00_1.webm;Yukio HATOYAMA.jpg;2753;2781;4977;91;92;1
/net/per920a/export/das14a/satoh-lab/haolin/nhk/excerpts/2007_12_10_19_00_1.webm;Yukio HATOYAMA.jpg;2805;2809;4977;93;93;0
/net/per920a/export/das14a/satoh-lab/haolin/nhk/excerpts/2007_12_10_19_00_1.webm;Yukio HATOYAMA.jpg;2825;2825;4977;94;94;0
/net/per920a/export/das14a/satoh-lab/haolin/nhk/excerpts/2007_12_10_19_00_1.webm;Yukio HATOYAMA.jpg;2837;2837;4977;94;94;0
/net/per920a/export/das14a/satoh-lab/haolin/nhk/excerpts/2007_12_10_19_00_1.webm;Yukio HATOYAMA.jpg;2849;2857;4977;95;95;0
/net/per920a/export/das14a/satoh-lab/haolin/nhk/excerpts/2007_12_10_19_00_1.webm;Yukio HATOYAMA.jpg;2873;2877;4977;95;95;0
/net/per920a/export/das14a/satoh-lab/haolin/nhk/excerpts/2007_12_10_19_00_1.webm;Yukio HATOYAMA.jpg;2897;2913;4977;96;97;1
/net/per920a/export/das14a/satoh-lab/haolin/nhk/excerpts/2007_12_10_19_00_1.webm;Yukio HATOYAMA.jpg;2941;2977;4977;98;99;1
/net/per920a/export/das14a/satoh-lab/haolin/nhk/excerpts/2007_12_10_19_00_1.webm;Yukio HATOYAMA.jpg;2989;2989;4977;99;99;0
/net/per920a/export/das14a/satoh-lab/haolin/nhk/excerpts/2007_12_10_19_00_1.webm;Yukio HATOYAMA.jpg;3033;3037;4977;101;101;0
/net/per920a/export/das14a/satoh-lab/haolin/nhk/excerpts/2007_12_10_19_00_1.webm;Yasuo FUKUDA.jpg;3141;3189;4977;104;106;2
/net/per920a/export/das14a/satoh-lab/haolin/nhk/excerpts/2007_12_10_19_00_1.webm;Yasuo FUKUDA.jpg;3205;3241;4977;106;108;2
/net/per920a/export/das14a/satoh-lab/haolin/nhk/excerpts/2007_12_10_19_00_1.webm;Yasuo FUKUDA.jpg;3261;3321;4977;108;110;2
/net/per920a/export/das14a/satoh-lab/haolin/nhk/excerpts/2007_12_10_19_00_1.webm;Yasuo FUKUDA.jpg;3337;3441;4977;111;114;3
/net/per920a/export/das14a/satoh-lab/haolin/nhk/excerpts/2007_12_10_19_00_1.webm;Yasuo FUKUDA.jpg;4897;4965;4977;163;165;2
/net/per920a/export/das14a/satoh-lab/haolin/nhk/excerpts/2007_12_10_19_00_1.webm;Naoto KAN.jpg;3917;4617;4977;130;153;23
/net/per920a/export/das14a/satoh-lab/haolin/nhk/excerpts/2007_12_12_19_00_1.webm;Shinzo ABE.jpg;3785;3865;8181;126;128;2
/net/per920a/export/das14a/satoh-lab/haolin/nhk/excerpts/2007_12_12_19_00_1.webm;Shinzo ABE.jpg;3877;3889;8181;129;129;0
/net/per920a/export/das14a/satoh-lab/haolin/nhk/excerpts/2007_12_12_19_00_1.webm;Shinzo ABE.jpg;3921;3937;8181;130;131;1
/net/per920a/export/das14a/satoh-lab/haolin/nhk/excerpts/2007_12_12_19_00_1.webm;Shinzo ABE.jpg;3953;4025;8181;131;134;3
/net/per920a/export/das14a/satoh-lab/haolin/nhk/excerpts/2007_12_12_19_00_1.webm;Shinzo ABE.jpg;4041;4049;8181;134;135;1
/net/per920a/export/das14a/satoh-lab/haolin/nhk/excerpts/2007_12_12_19_00_1.webm;Shinzo ABE.jpg;4069;4069;8181;135;135;0
/net/per920a/export/das14a/satoh-lab/haolin/nhk/excerpts/2007_12_12_19_00_1.webm;Shinzo ABE.jpg;4081;4093;8181;136;136;0
/net/per920a/export/das14a/satoh-lab/haolin/nhk/excerpts/2007_12_12_19_00_1.webm;Shinzo ABE.jpg;4165;4225;8181;138;140;2
/net/per920a/export/das14a/satoh-lab/haolin/nhk/excerpts/2007_12_12_19_00_1.webm;Shinzo ABE.jpg;4261;4289;8181;142;143;1
/net/per920a/export/das14a/satoh-lab/haolin/nhk/excerpts/2007_12_12_19_00_1.webm;Shinzo ABE.jpg;4857;4861;8181;162;162;0
/net/per920a/export/das14a/satoh-lab/haolin/nhk/excerpts/2007_12_12_19_00_1.webm;Akihiro OHTA.jpg;4697;4749;8181;156;158;2
/net/per920a/export/das14a/satoh-lab/haolin/nhk/excerpts/2007_12_12_19_00_1.webm;Takenori KANZAKI.jpg;6553;6593;8181;218;220;2
/net/per920a/export/das14a/satoh-lab/haolin/nhk/excerpts/2007_12_12_19_00_1.webm;Takenori KANZAKI.jpg;6609;6669;8181;220;222;2
/net/per920a/export/das14a/satoh-lab/haolin/nhk/excerpts/2007_12_12_19_00_1.webm;Takenori KANZAKI.jpg;6685;6885;8181;223;229;6
/net/per920a/export/das14a/satoh-lab/haolin/nhk/excerpts/2007_12_12_19_00_1.webm;Takenori KANZAKI.jpg;6897;6997;8181;230;233;3
/net/per920a/export/das14a/satoh-lab/haolin/nhk/excerpts/2007_12_12_19_00_1.webm;Takenori KANZAKI.jpg;7029;7029;8181;234;234;0
/net/per920a/export/das14a/satoh-lab/haolin/nhk/excerpts/2007_12_12_19_00_1.webm;Takenori KANZAKI.jpg;7049;7053;8181;235;235;0
/net/per920a/export/das14a/satoh-lab/haolin/nhk/excerpts/2007_12_12_19_00_1.webm;Takenori KANZAKI.jpg;7069;7081;8181;235;236;1
/net/per920a/export/das14a/satoh-lab/haolin/nhk/excerpts/2007_12_12_19_00_1.webm;Takenori KANZAKI.jpg;7097;7129;8181;236;237;1
/net/per920a/export/das14a/satoh-lab/haolin/nhk/excerpts/2007_12_12_19_00_1.webm;Takenori KANZAKI.jpg;7145;7161;8181;238;238;0
/net/per920a/export/das14a/satoh-lab/haolin/nhk/excerpts/2007_12_12_19_00_1.webm;Takenori KANZAKI.jpg;7177;7177;8181;239;239;0
/net/per920a/export/das14a/satoh-lab/haolin/nhk/excerpts/2007_12_12_19_00_1.webm;Takenori KANZAKI.jpg;7197;7237;8181;240;241;1
/net/per920a/export/das14a/satoh-lab/haolin/nhk/excerpts/2007_12_12_19_00_1.webm;Yoshihiko Noda.jpg;7441;7461;8181;248;248;0
/net/per920a/export/das14a/satoh-lab/haolin/nhk/excerpts/2007_12_12_19_00_1.webm;Yoshihiko Noda.jpg;7477;7485;8181;249;249;0
/net/per920a/export/das14a/satoh-lab/haolin/nhk/excerpts/2007_12_12_19_00_1.webm;Yoshihiko Noda.jpg;7501;7521;8181;250;250;0
/net/per920a/export/das14a/satoh-lab/haolin/nhk/excerpts/2007_12_12_19_00_1.webm;Yoshihiko Noda.jpg;7537;7541;8181;251;251;0
/net/per920a/export/das14a/satoh-lab/haolin/nhk/excerpts/2007_12_12_19_00_1.webm;Yoshihiko Noda.jpg;7557;7569;8181;252;252;0
/net/per920a/export/das14a/satoh-lab/haolin/nhk/excerpts/2007_12_12_19_00_1.webm;Yoshihiko Noda.jpg;7585;7585;8181;253;253;0
/net/per920a/export/das14a/satoh-lab/haolin/nhk/excerpts/2007_12_12_19_00_1.webm;Yoshihiko Noda.jpg;7601;7661;8181;253;255;2
/net/per920a/export/das14a/satoh-lab/haolin/nhk/excerpts/2007_12_12_19_00_1.webm;Yoshihiko Noda.jpg;7677;7685;8181;256;256;0
/net/per920a/export/das14a/satoh-lab/haolin/nhk/excerpts/2007_12_12_19_00_1.webm;Yoshihiko Noda.jpg;7701;7749;8181;256;258;2
/net/per920a/export/das14a/satoh-lab/haolin/nhk/excerpts/2007_12_12_19_00_1.webm;Yoshihiko Noda.jpg;7789;7797;8181;259;260;1
/net/per920a/export/das14a/satoh-lab/haolin/nhk/excerpts/2007_12_12_19_00_1.webm;Yoshihiko Noda.jpg;7813;7825;8181;260;261;1
/net/per920a/export/das14a/satoh-lab/haolin/nhk/excerpts/2007_12_12_19_00_1.webm;Yoshihiko Noda.jpg;7845;7857;8181;261;262;1
/net/per920a/export/das14a/satoh-lab/haolin/nhk/excerpts/2007_12_12_19_00_1.webm;Yoshihiko Noda.jpg;7877;7893;8181;262;263;1
/net/per920a/export/das14a/satoh-lab/haolin/nhk/excerpts/2007_12_12_19_00_1.webm;Yasuo FUKUDA.jpg;8077;8177;8181;269;272;3
/net/per920a/export/das14a/satoh-lab/haolin/nhk/excerpts/2007_12_30_19_00_3.webm;Yasuo FUKUDA.jpg;349;349;6537;11;11;0
/net/per920a/export/das14a/satoh-lab/haolin/nhk/excerpts/2007_12_30_19_00_3.webm;Yasuo FUKUDA.jpg;529;533;6537;17;17;0
/net/per920a/export/das14a/satoh-lab/haolin/nhk/excerpts/2007_12_30_19_00_3.webm;Yasuo FUKUDA.jpg;613;613;6537;20;20;0
/net/per920a/export/das14a/satoh-lab/haolin/nhk/excerpts/2007_12_30_19_00_3.webm;Yasuo FUKUDA.jpg;885;885;6537;29;29;0
/net/per920a/export/das14a/satoh-lab/haolin/nhk/excerpts/2007_12_30_19_00_3.webm;Yasuo FUKUDA.jpg;901;909;6537;30;30;0
/net/per920a/export/das14a/satoh-lab/haolin/nhk/excerpts/2007_12_30_19_00_3.webm;Yasuo FUKUDA.jpg;929;929;6537;30;30;0
/net/per920a/export/das14a/satoh-lab/haolin/nhk/excerpts/2007_12_30_19_00_3.webm;Yasuo FUKUDA.jpg;1041;1045;6537;34;34;0
/net/per920a/export/das14a/satoh-lab/haolin/nhk/excerpts/2007_12_30_19_00_3.webm;Yasuo FUKUDA.jpg;1081;1085;6537;36;36;0
/net/per920a/export/das14a/satoh-lab/haolin/nhk/excerpts/2007_12_30_19_00_3.webm;Yasuo FUKUDA.jpg;1097;1105;6537;36;36;0
/net/per920a/export/das14a/satoh-lab/haolin/nhk/excerpts/2007_12_30_19_00_3.webm;Yasuo FUKUDA.jpg;1225;1225;6537;40;40;0
/net/per920a/export/das14a/satoh-lab/haolin/nhk/excerpts/2007_12_30_19_00_3.webm;Yasuo FUKUDA.jpg;1249;1265;6537;41;42;1
/net/per920a/export/das14a/satoh-lab/haolin/nhk/excerpts/2007_12_30_19_00_3.webm;Yasuo FUKUDA.jpg;1277;1285;6537;42;42;0
/net/per920a/export/das14a/satoh-lab/haolin/nhk/excerpts/2007_12_30_19_00_3.webm;Yasuo FUKUDA.jpg;1417;1417;6537;47;47;0
/net/per920a/export/das14a/satoh-lab/haolin/nhk/excerpts/2007_12_30_19_00_3.webm;Yasuo FUKUDA.jpg;1429;1429;6537;47;47;0
/net/per920a/export/das14a/satoh-lab/haolin/nhk/excerpts/2007_12_30_19_00_3.webm;Yasuo FUKUDA.jpg;1493;1493;6537;49;49;0
/net/per920a/export/das14a/satoh-lab/haolin/nhk/excerpts/2007_12_30_19_00_3.webm;Yasuo FUKUDA.jpg;1517;1517;6537;50;50;0
/net/per920a/export/das14a/satoh-lab/haolin/nhk/excerpts/2007_12_30_19_00_3.webm;Yasuo FUKUDA.jpg;1529;1537;6537;50;51;1
/net/per920a/export/das14a/satoh-lab/haolin/nhk/excerpts/2007_12_30_19_00_3.webm;Yasuo FUKUDA.jpg;1853;1857;6537;61;61;0
/net/per920a/export/das14a/satoh-lab/haolin/nhk/excerpts/2007_12_30_19_00_3.webm;Yasuo FUKUDA.jpg;1901;1901;6537;63;63;0
/net/per920a/export/das14a/satoh-lab/haolin/nhk/excerpts/2007_12_30_19_00_3.webm;Yasuo FUKUDA.jpg;1913;1913;6537;63;63;0
/net/per920a/export/das14a/satoh-lab/haolin/nhk/excerpts/2007_12_30_19_00_3.webm;Yasuo FUKUDA.jpg;1949;1953;6537;64;65;1
/net/per920a/export/das14a/satoh-lab/haolin/nhk/excerpts/2007_12_30_19_00_3.webm;Yasuo FUKUDA.jpg;1969;1969;6537;65;65;0
/net/per920a/export/das14a/satoh-lab/haolin/nhk/excerpts/2007_12_30_19_00_3.webm;Yasuo FUKUDA.jpg;2001;2005;6537;66;66;0
/net/per920a/export/das14a/satoh-lab/haolin/nhk/excerpts/2007_12_30_19_00_3.webm;Yasuo FUKUDA.jpg;2021;2021;6537;67;67;0
/net/per920a/export/das14a/satoh-lab/haolin/nhk/excerpts/2007_12_30_19_00_3.webm;Yasuo FUKUDA.jpg;2053;2069;6537;68;68;0
/net/per920a/export/das14a/satoh-lab/haolin/nhk/excerpts/2007_12_30_19_00_3.webm;Yasuo FUKUDA.jpg;2161;2197;6537;72;73;1
/net/per920a/export/das14a/satoh-lab/haolin/nhk/excerpts/2007_12_30_19_00_3.webm;Yasuo FUKUDA.jpg;2233;2233;6537;74;74;0
/net/per920a/export/das14a/satoh-lab/haolin/nhk/excerpts/2007_12_30_19_00_3.webm;Yasuo FUKUDA.jpg;2701;2729;6537;90;91;1
/net/per920a/export/das14a/satoh-lab/haolin/nhk/excerpts/2007_12_30_19_00_3.webm;Yasuo FUKUDA.jpg;2745;2865;6537;91;95;4
/net/per920a/export/das14a/satoh-lab/haolin/nhk/excerpts/2007_12_30_19_00_3.webm;Yasuo FUKUDA.jpg;3229;3401;6537;107;113;6
/net/per920a/export/das14a/satoh-lab/haolin/nhk/excerpts/2007_12_30_19_00_3.webm;Yasuo FUKUDA.jpg;3425;3453;6537;114;115;1
/net/per920a/export/das14a/satoh-lab/haolin/nhk/excerpts/2007_12_30_19_00_3.webm;Yasuo FUKUDA.jpg;3629;3813;6537;121;127;6
/net/per920a/export/das14a/satoh-lab/haolin/nhk/excerpts/2007_12_30_19_00_3.webm;Yasuo FUKUDA.jpg;5369;5369;6537;179;179;0
/net/per920a/export/das14a/satoh-lab/haolin/nhk/excerpts/2007_12_30_19_00_3.webm;Yasuo FUKUDA.jpg;5381;5401;6537;179;180;1
/net/per920a/export/das14a/satoh-lab/haolin/nhk/excerpts/2007_12_30_19_00_3.webm;Yasuo FUKUDA.jpg;5425;5429;6537;180;181;1
/net/per920a/export/das14a/satoh-lab/haolin/nhk/excerpts/2007_12_30_19_00_3.webm;Yasuo FUKUDA.jpg;5477;5489;6537;182;183;1
/net/per920a/export/das14a/satoh-lab/haolin/nhk/excerpts/2007_12_30_19_00_3.webm;Yasuo FUKUDA.jpg;5549;5549;6537;185;185;0
/net/per920a/export/das14a/satoh-lab/haolin/nhk/excerpts/2007_12_30_19_00_3.webm;Yasuo FUKUDA.jpg;5625;5637;6537;187;187;0
/net/per920a/export/das14a/satoh-lab/haolin/nhk/excerpts/2008_01_15_19_00_3.webm;Yasuo FUKUDA.jpg;9;113;3269;0;3;3
/net/per920a/export/das14a/satoh-lab/haolin/nhk/excerpts/2008_01_15_19_00_3.webm;Yasuo FUKUDA.jpg;125;601;3269;4;20;16
/net/per920a/export/das14a/satoh-lab/haolin/nhk/excerpts/2008_01_15_19_00_3.webm;Yasuo FUKUDA.jpg;3185;3265;3269;106;108;2
/net/per920a/export/das14a/satoh-lab/haolin/nhk/excerpts/2008_01_15_19_00_3.webm;Ichiro OZAWA.jpg;1345;1397;3269;44;46;2
/net/per920a/export/das14a/satoh-lab/haolin/nhk/excerpts/2008_01_15_19_00_3.webm;Akihiro OHTA.jpg;2561;2581;3269;85;86;1
/net/per920a/export/das14a/satoh-lab/haolin/nhk/excerpts/2008_01_21_19_00_1.webm;Yasuo FUKUDA.jpg;9;597;4709;0;19;19
/net/per920a/export/das14a/satoh-lab/haolin/nhk/excerpts/2008_01_21_19_00_1.webm;Yasuo FUKUDA.jpg;1273;1701;4709;42;56;14
/net/per920a/export/das14a/satoh-lab/haolin/nhk/excerpts/2008_01_21_19_00_1.webm;Yasuo FUKUDA.jpg;1717;1737;4709;57;57;0
/net/per920a/export/das14a/satoh-lab/haolin/nhk/excerpts/2008_01_21_19_00_1.webm;Yasuo FUKUDA.jpg;1753;2017;4709;58;67;9
/net/per920a/export/das14a/satoh-lab/haolin/nhk/excerpts/2008_01_21_19_00_1.webm;Yasuo FUKUDA.jpg;3033;3033;4709;101;101;0
/net/per920a/export/das14a/satoh-lab/haolin/nhk/excerpts/2008_01_21_19_00_1.webm;Yasuo FUKUDA.jpg;3045;3177;4709;101;105;4
/net/per920a/export/das14a/satoh-lab/haolin/nhk/excerpts/2008_01_21_19_00_1.webm;Yasuo FUKUDA.jpg;3197;3689;4709;106;122;16
/net/per920a/export/das14a/satoh-lab/haolin/nhk/excerpts/2008_01_21_19_00_1.webm;Yasuo FUKUDA.jpg;4325;4337;4709;144;144;0
/net/per920a/export/das14a/satoh-lab/haolin/nhk/excerpts/2008_01_21_19_00_1.webm;Yasuo FUKUDA.jpg;4353;4377;4709;145;145;0
/net/per920a/export/das14a/satoh-lab/haolin/nhk/excerpts/2008_01_21_19_00_1.webm;Yasuo FUKUDA.jpg;4393;4393;4709;146;146;0
/net/per920a/export/das14a/satoh-lab/haolin/nhk/excerpts/2008_01_21_19_00_1.webm;Yasuo FUKUDA.jpg;4409;4465;4709;146;148;2
/net/per920a/export/das14a/satoh-lab/haolin/nhk/excerpts/2008_01_21_19_00_1.webm;Yasuo FUKUDA.jpg;4481;4649;4709;149;154;5
/net/per920a/export/das14a/satoh-lab/haolin/nhk/excerpts/2008_01_21_19_00_1.webm;Yasuo FUKUDA.jpg;4661;4705;4709;155;156;1
/net/per920a/export/das14a/satoh-lab/haolin/nhk/excerpts/2008_01_21_19_00_1.webm;Yukio HATOYAMA.jpg;721;861;4709;24;28;4
/net/per920a/export/das14a/satoh-lab/haolin/nhk/excerpts/2008_01_21_19_00_1.webm;Yukio HATOYAMA.jpg;877;897;4709;29;29;0
/net/per920a/export/das14a/satoh-lab/haolin/nhk/excerpts/2008_01_21_19_00_1.webm;Yukio HATOYAMA.jpg;909;909;4709;30;30;0
/net/per920a/export/das14a/satoh-lab/haolin/nhk/excerpts/2008_01_21_19_00_1.webm;Yukio HATOYAMA.jpg;929;989;4709;30;32;2
/net/per920a/export/das14a/satoh-lab/haolin/nhk/excerpts/2008_01_21_19_00_1.webm;Yukio HATOYAMA.jpg;1005;1009;4709;33;33;0
/net/per920a/export/das14a/satoh-lab/haolin/nhk/excerpts/2008_01_21_19_00_1.webm;Yukio HATOYAMA.jpg;1041;1041;4709;34;34;0
/net/per920a/export/das14a/satoh-lab/haolin/nhk/excerpts/2008_01_21_19_00_1.webm;Yukio HATOYAMA.jpg;1057;1173;4709;35;39;4
/net/per920a/export/das14a/satoh-lab/haolin/nhk/excerpts/2008_01_21_19_00_1.webm;Yukio HATOYAMA.jpg;1185;1185;4709;39;39;0
/net/per920a/export/das14a/satoh-lab/haolin/nhk/excerpts/2008_01_21_19_00_1.webm;Yukio HATOYAMA.jpg;1197;1209;4709;39;40;1
/net/per920a/export/das14a/satoh-lab/haolin/nhk/excerpts/2008_01_21_19_00_1.webm;Yukio HATOYAMA.jpg;1225;1257;4709;40;41;1
/net/per920a/export/das14a/satoh-lab/haolin/nhk/excerpts/2008_03_11_19_00_3.webm;Katsuya OKADA.jpg;5193;5221;6625;173;174;1
/net/per920a/export/das14a/satoh-lab/haolin/nhk/excerpts/2008_03_11_19_00_3.webm;Shintaro ISHIHARA.jpg;6541;6621;6625;218;220;2
/net/per920a/export/das14a/satoh-lab/haolin/nhk/excerpts/2008_03_13_19_00_3.webm;Naoto KAN.jpg;5849;6325;7013;195;211;16
/net/per920a/export/das14a/satoh-lab/haolin/nhk/excerpts/2008_03_13_19_00_3.webm;Naoto KAN.jpg;6341;6365;7013;211;212;1
/net/per920a/export/das14a/satoh-lab/haolin/nhk/excerpts/2008_03_13_19_00_3.webm;Naoto KAN.jpg;6385;6837;7013;213;228;15
/net/per920a/export/das14a/satoh-lab/haolin/nhk/excerpts/2008_03_13_19_00_3.webm;Kazuo SHII.jpg;6853;6937;7013;228;231;3
/net/per920a/export/das14a/satoh-lab/haolin/nhk/excerpts/2008_03_13_19_00_3.webm;Yasuo FUKUDA.jpg;6965;7009;7013;232;233;1
/net/per920a/export/das14a/satoh-lab/haolin/nhk/excerpts/2008_03_14_19_00_2.webm;Yasuo FUKUDA.jpg;381;529;3817;12;17;5
/net/per920a/export/das14a/satoh-lab/haolin/nhk/excerpts/2008_03_14_19_00_2.webm;Yasuo FUKUDA.jpg;545;553;3817;18;18;0
/net/per920a/export/das14a/satoh-lab/haolin/nhk/excerpts/2008_03_14_19_00_2.webm;Yasuo FUKUDA.jpg;589;589;3817;19;19;0
/net/per920a/export/das14a/satoh-lab/haolin/nhk/excerpts/2008_03_14_19_00_2.webm;Yasuo FUKUDA.jpg;605;665;3817;20;22;2
/net/per920a/export/das14a/satoh-lab/haolin/nhk/excerpts/2008_03_14_19_00_2.webm;Yasuo FUKUDA.jpg;681;681;3817;22;22;0
/net/per920a/export/das14a/satoh-lab/haolin/nhk/excerpts/2008_03_14_19_00_2.webm;Yasuo FUKUDA.jpg;697;777;3817;23;25;2
/net/per920a/export/das14a/satoh-lab/haolin/nhk/excerpts/2008_03_14_19_00_2.webm;Yasuo FUKUDA.jpg;793;1257;3817;26;41;15
/net/per920a/export/das14a/satoh-lab/haolin/nhk/excerpts/2008_03_14_19_00_2.webm;Yasuo FUKUDA.jpg;1273;1357;3817;42;45;3
/net/per920a/export/das14a/satoh-lab/haolin/nhk/excerpts/2008_03_14_19_00_2.webm;Akihiro OHTA.jpg;1693;1697;3817;56;56;0
/net/per920a/export/das14a/satoh-lab/haolin/nhk/excerpts/2008_03_14_19_00_2.webm;Akihiro OHTA.jpg;1721;1725;3817;57;57;0
/net/per920a/export/das14a/satoh-lab/haolin/nhk/excerpts/2008_03_14_19_00_2.webm;Akihiro OHTA.jpg;1745;1801;3817;58;59;1
/net/per920a/export/das14a/satoh-lab/haolin/nhk/excerpts/2008_03_14_19_00_2.webm;Akihiro OHTA.jpg;1817;1957;3817;60;65;5
/net/per920a/export/das14a/satoh-lab/haolin/nhk/excerpts/2008_03_14_19_00_2.webm;Akihiro OHTA.jpg;1973;2149;3817;65;71;6
/net/per920a/export/das14a/satoh-lab/haolin/nhk/excerpts/2008_03_14_19_00_2.webm;Akihiro OHTA.jpg;2165;2277;3817;72;75;3
/net/per920a/export/das14a/satoh-lab/haolin/nhk/excerpts/2008_03_17_19_00_1.webm;Akihiro OHTA.jpg;2337;2349;9417;77;78;1
/net/per920a/export/das14a/satoh-lab/haolin/nhk/excerpts/2008_03_17_19_00_1.webm;Akihiro OHTA.jpg;2361;2365;9417;78;78;0
/net/per920a/export/das14a/satoh-lab/haolin/nhk/excerpts/2008_03_17_19_00_1.webm;Akihiro OHTA.jpg;2389;2393;9417;79;79;0
/net/per920a/export/das14a/satoh-lab/haolin/nhk/excerpts/2008_03_17_19_00_1.webm;Akihiro OHTA.jpg;2425;2433;9417;80;81;1
/net/per920a/export/das14a/satoh-lab/haolin/nhk/excerpts/2008_03_17_19_00_1.webm;Akihiro OHTA.jpg;2449;2477;9417;81;82;1
/net/per920a/export/das14a/satoh-lab/haolin/nhk/excerpts/2008_03_17_19_00_1.webm;Akihiro OHTA.jpg;2489;2509;9417;82;83;1
/net/per920a/export/das14a/satoh-lab/haolin/nhk/excerpts/2008_03_17_19_00_1.webm;Akihiro OHTA.jpg;2521;2597;9417;84;86;2
/net/per920a/export/das14a/satoh-lab/haolin/nhk/excerpts/2008_03_17_19_00_1.webm;Akihiro OHTA.jpg;2609;2609;9417;86;86;0
/net/per920a/export/das14a/satoh-lab/haolin/nhk/excerpts/2008_03_17_19_00_1.webm;Akihiro OHTA.jpg;2621;2629;9417;87;87;0
/net/per920a/export/das14a/satoh-lab/haolin/nhk/excerpts/2008_03_17_19_00_1.webm;Akihiro OHTA.jpg;2669;2677;9417;88;89;1
/net/per920a/export/das14a/satoh-lab/haolin/nhk/excerpts/2008_03_17_19_00_1.webm;Yukio HATOYAMA.jpg;3101;3113;9417;103;103;0
/net/per920a/export/das14a/satoh-lab/haolin/nhk/excerpts/2008_03_17_19_00_1.webm;Yasuo FUKUDA.jpg;4105;4397;9417;136;146;10
/net/per920a/export/das14a/satoh-lab/haolin/nhk/excerpts/2008_03_17_19_00_1.webm;Yasuo FUKUDA.jpg;4413;4765;9417;147;158;11
/net/per920a/export/das14a/satoh-lab/haolin/nhk/excerpts/2008_03_17_19_00_1.webm;Yasuo FUKUDA.jpg;4793;4877;9417;159;162;3
/net/per920a/export/das14a/satoh-lab/haolin/nhk/excerpts/2008_03_17_19_00_1.webm;Yasuo FUKUDA.jpg;4893;4901;9417;163;163;0
/net/per920a/export/das14a/satoh-lab/haolin/nhk/excerpts/2008_03_17_19_00_1.webm;Yasuo FUKUDA.jpg;7497;7777;9417;249;259;10
/net/per920a/export/das14a/satoh-lab/haolin/nhk/excerpts/2008_03_17_19_00_1.webm;Yasuo FUKUDA.jpg;7793;7885;9417;259;262;3
/net/per920a/export/das14a/satoh-lab/haolin/nhk/excerpts/2008_03_17_19_00_1.webm;Yasuo FUKUDA.jpg;7901;7913;9417;263;263;0
/net/per920a/export/das14a/satoh-lab/haolin/nhk/excerpts/2008_03_31_19_00_2.webm;Yasuo FUKUDA.jpg;9;185;2281;0;6;6
/net/per920a/export/das14a/satoh-lab/haolin/nhk/excerpts/2008_03_31_19_00_2.webm;Yasuo FUKUDA.jpg;201;373;2281;6;12;6
/net/per920a/export/das14a/satoh-lab/haolin/nhk/excerpts/2008_03_31_19_00_2.webm;Ichiro OZAWA.jpg;385;665;2281;12;22;10
/net/per920a/export/das14a/satoh-lab/haolin/nhk/excerpts/2008_03_31_19_00_2.webm;Ichiro OZAWA.jpg;681;753;2281;22;25;3
/net/per920a/export/das14a/satoh-lab/haolin/nhk/excerpts/2008_03_31_19_00_2.webm;Ichiro OZAWA.jpg;769;1113;2281;25;37;12
/net/per920a/export/das14a/satoh-lab/haolin/nhk/excerpts/2008_03_31_19_00_2.webm;Ichiro OZAWA.jpg;1129;1177;2281;37;39;2
/net/per920a/export/das14a/satoh-lab/haolin/nhk/excerpts/2008_03_31_19_00_2.webm;Ichiro OZAWA.jpg;1193;1249;2281;39;41;2
/net/per920a/export/das14a/satoh-lab/haolin/nhk/excerpts/2008_03_31_19_00_2.webm;Ichiro OZAWA.jpg;1265;1361;2281;42;45;3
/net/per920a/export/das14a/satoh-lab/haolin/nhk/excerpts/2008_03_31_19_00_2.webm;Ichiro OZAWA.jpg;1381;2093;2281;46;69;23
/net/per920a/export/das14a/satoh-lab/haolin/nhk/excerpts/2008_03_31_19_00_2.webm;Ichiro OZAWA.jpg;2129;2141;2281;70;71;1
/net/per920a/export/das14a/satoh-lab/haolin/nhk/excerpts/2008_03_31_19_00_2.webm;Ichiro OZAWA.jpg;2157;2213;2281;71;73;2
/net/per920a/export/das14a/satoh-lab/haolin/nhk/excerpts/2008_04_09_19_00_2.webm;Yasuo FUKUDA.jpg;397;397;6301;13;13;0
/net/per920a/export/das14a/satoh-lab/haolin/nhk/excerpts/2008_04_09_19_00_2.webm;Yasuo FUKUDA.jpg;421;441;6301;14;14;0
/net/per920a/export/das14a/satoh-lab/haolin/nhk/excerpts/2008_04_09_19_00_2.webm;Yasuo FUKUDA.jpg;885;885;6301;29;29;0
/net/per920a/export/das14a/satoh-lab/haolin/nhk/excerpts/2008_04_09_19_00_2.webm;Yasuo FUKUDA.jpg;913;913;6301;30;30;0
/net/per920a/export/das14a/satoh-lab/haolin/nhk/excerpts/2008_04_09_19_00_2.webm;Yasuo FUKUDA.jpg;1241;1249;6301;41;41;0
/net/per920a/export/das14a/satoh-lab/haolin/nhk/excerpts/2008_04_09_19_00_2.webm;Yasuo FUKUDA.jpg;1277;1313;6301;42;43;1
/net/per920a/export/das14a/satoh-lab/haolin/nhk/excerpts/2008_04_09_19_00_2.webm;Yasuo FUKUDA.jpg;1333;1333;6301;44;44;0
/net/per920a/export/das14a/satoh-lab/haolin/nhk/excerpts/2008_04_09_19_00_2.webm;Yasuo FUKUDA.jpg;2085;2097;6301;69;69;0
/net/per920a/export/das14a/satoh-lab/haolin/nhk/excerpts/2008_04_09_19_00_2.webm;Yasuo FUKUDA.jpg;2113;2117;6301;70;70;0
/net/per920a/export/das14a/satoh-lab/haolin/nhk/excerpts/2008_04_09_19_00_2.webm;Yasuo FUKUDA.jpg;2313;2313;6301;77;77;0
/net/per920a/export/das14a/satoh-lab/haolin/nhk/excerpts/2008_04_09_19_00_2.webm;Yasuo FUKUDA.jpg;2341;2341;6301;78;78;0
/net/per920a/export/das14a/satoh-lab/haolin/nhk/excerpts/2008_04_09_19_00_2.webm;Yasuo FUKUDA.jpg;2473;2473;6301;82;82;0
/net/per920a/export/das14a/satoh-lab/haolin/nhk/excerpts/2008_04_09_19_00_2.webm;Yasuo FUKUDA.jpg;2529;2569;6301;84;85;1
/net/per920a/export/das14a/satoh-lab/haolin/nhk/excerpts/2008_04_09_19_00_2.webm;Yasuo FUKUDA.jpg;2585;2585;6301;86;86;0
/net/per920a/export/das14a/satoh-lab/haolin/nhk/excerpts/2008_04_09_19_00_2.webm;Yasuo FUKUDA.jpg;2605;2605;6301;86;86;0
/net/per920a/export/das14a/satoh-lab/haolin/nhk/excerpts/2008_04_09_19_00_2.webm;Yasuo FUKUDA.jpg;2621;2641;6301;87;88;1
/net/per920a/export/das14a/satoh-lab/haolin/nhk/excerpts/2008_04_09_19_00_2.webm;Yasuo FUKUDA.jpg;2669;2673;6301;88;89;1
/net/per920a/export/das14a/satoh-lab/haolin/nhk/excerpts/2008_04_09_19_00_2.webm;Yasuo FUKUDA.jpg;2693;2713;6301;89;90;1
/net/per920a/export/das14a/satoh-lab/haolin/nhk/excerpts/2008_04_09_19_00_2.webm;Yasuo FUKUDA.jpg;2837;2885;6301;94;96;2
/net/per920a/export/das14a/satoh-lab/haolin/nhk/excerpts/2008_04_09_19_00_2.webm;Yasuo FUKUDA.jpg;2901;2901;6301;96;96;0
/net/per920a/export/das14a/satoh-lab/haolin/nhk/excerpts/2008_04_09_19_00_2.webm;Yasuo FUKUDA.jpg;2933;3033;6301;97;101;4
/net/per920a/export/das14a/satoh-lab/haolin/nhk/excerpts/2008_04_09_19_00_2.webm;Yasuo FUKUDA.jpg;3049;3049;6301;101;101;0
/net/per920a/export/das14a/satoh-lab/haolin/nhk/excerpts/2008_04_09_19_00_2.webm;Yasuo FUKUDA.jpg;3077;3093;6301;102;103;1
/net/per920a/export/das14a/satoh-lab/haolin/nhk/excerpts/2008_04_09_19_00_2.webm;Yasuo FUKUDA.jpg;3109;3153;6301;103;105;2
/net/per920a/export/das14a/satoh-lab/haolin/nhk/excerpts/2008_04_09_19_00_2.webm;Yasuo FUKUDA.jpg;3181;3181;6301;106;106;0
/net/per920a/export/das14a/satoh-lab/haolin/nhk/excerpts/2008_04_09_19_00_2.webm;Yasuo FUKUDA.jpg;3213;3233;6301;107;107;0
/net/per920a/export/das14a/satoh-lab/haolin/nhk/excerpts/2008_04_09_19_00_2.webm;Yasuo FUKUDA.jpg;3269;3277;6301;108;109;1
/net/per920a/export/das14a/satoh-lab/haolin/nhk/excerpts/2008_04_09_19_00_2.webm;Yasuo FUKUDA.jpg;3329;3413;6301;110;113;3
/net/per920a/export/das14a/satoh-lab/haolin/nhk/excerpts/2008_04_09_19_00_2.webm;Yasuo FUKUDA.jpg;3425;3433;6301;114;114;0
/net/per920a/export/das14a/satoh-lab/haolin/nhk/excerpts/2008_04_09_19_00_2.webm;Yasuo FUKUDA.jpg;3481;3485;6301;116;116;0
/net/per920a/export/das14a/satoh-lab/haolin/nhk/excerpts/2008_04_09_19_00_2.webm;Yasuo FUKUDA.jpg;3501;3501;6301;116;116;0
/net/per920a/export/das14a/satoh-lab/haolin/nhk/excerpts/2008_04_09_19_00_2.webm;Yasuo FUKUDA.jpg;3513;3517;6301;117;117;0
/net/per920a/export/das14a/satoh-lab/haolin/nhk/excerpts/2008_04_09_19_00_2.webm;Yasuo FUKUDA.jpg;3529;3533;6301;117;117;0
/net/per920a/export/das14a/satoh-lab/haolin/nhk/excerpts/2008_04_09_19_00_2.webm;Yasuo FUKUDA.jpg;3569;3593;6301;118;119;1
/net/per920a/export/das14a/satoh-lab/haolin/nhk/excerpts/2008_04_09_19_00_2.webm;Yasuo FUKUDA.jpg;4533;4541;6301;151;151;0
/net/per920a/export/das14a/satoh-lab/haolin/nhk/excerpts/2008_04_09_19_00_2.webm;Yasuo FUKUDA.jpg;4553;4553;6301;151;151;0
/net/per920a/export/das14a/satoh-lab/haolin/nhk/excerpts/2008_04_09_19_00_2.webm;Yasuo FUKUDA.jpg;4565;4633;6301;152;154;2
/net/per920a/export/das14a/satoh-lab/haolin/nhk/excerpts/2008_04_09_19_00_2.webm;Yasuo FUKUDA.jpg;4897;4901;6301;163;163;0
/net/per920a/export/das14a/satoh-lab/haolin/nhk/excerpts/2008_04_09_19_00_2.webm;Yasuo FUKUDA.jpg;4913;4917;6301;163;163;0
/net/per920a/export/das14a/satoh-lab/haolin/nhk/excerpts/2008_04_09_19_00_2.webm;Yasuo FUKUDA.jpg;4941;4977;6301;164;165;1
/net/per920a/export/das14a/satoh-lab/haolin/nhk/excerpts/2008_04_09_19_00_2.webm;Yasuo FUKUDA.jpg;5341;5465;6301;178;182;4
/net/per920a/export/das14a/satoh-lab/haolin/nhk/excerpts/2008_04_09_19_00_2.webm;Yasuo FUKUDA.jpg;5621;5629;6301;187;187;0
/net/per920a/export/das14a/satoh-lab/haolin/nhk/excerpts/2008_04_09_19_00_2.webm;Yasuo FUKUDA.jpg;5649;5653;6301;188;188;0
/net/per920a/export/das14a/satoh-lab/haolin/nhk/excerpts/2008_04_09_19_00_2.webm;Yasuo FUKUDA.jpg;5685;5685;6301;189;189;0
/net/per920a/export/das14a/satoh-lab/haolin/nhk/excerpts/2008_04_09_19_00_2.webm;Yasuo FUKUDA.jpg;5697;5701;6301;189;190;1
/net/per920a/export/das14a/satoh-lab/haolin/nhk/excerpts/2008_04_09_19_00_2.webm;Yasuo FUKUDA.jpg;5725;5733;6301;190;191;1
/net/per920a/export/das14a/satoh-lab/haolin/nhk/excerpts/2008_04_09_19_00_2.webm;Yasuo FUKUDA.jpg;5765;5777;6301;192;192;0
/net/per920a/export/das14a/satoh-lab/haolin/nhk/excerpts/2008_04_09_19_00_2.webm;Yasuo FUKUDA.jpg;5789;5789;6301;192;192;0
/net/per920a/export/das14a/satoh-lab/haolin/nhk/excerpts/2008_04_09_19_00_2.webm;Yasuo FUKUDA.jpg;5873;5877;6301;195;195;0
/net/per920a/export/das14a/satoh-lab/haolin/nhk/excerpts/2008_04_09_19_00_2.webm;Yasuo FUKUDA.jpg;5957;5969;6301;198;198;0
/net/per920a/export/das14a/satoh-lab/haolin/nhk/excerpts/2008_04_09_19_00_2.webm;Ichiro OZAWA.jpg;1009;1097;6301;33;36;3
/net/per920a/export/das14a/satoh-lab/haolin/nhk/excerpts/2008_04_09_19_00_2.webm;Ichiro OZAWA.jpg;1141;1169;6301;38;38;0
/net/per920a/export/das14a/satoh-lab/haolin/nhk/excerpts/2008_04_09_19_00_2.webm;Ichiro OZAWA.jpg;1185;1225;6301;39;40;1
/net/per920a/export/das14a/satoh-lab/haolin/nhk/excerpts/2008_04_09_19_00_2.webm;Ichiro OZAWA.jpg;1345;1345;6301;44;44;0
/net/per920a/export/das14a/satoh-lab/haolin/nhk/excerpts/2008_04_09_19_00_2.webm;Ichiro OZAWA.jpg;1369;1385;6301;45;46;1
/net/per920a/export/das14a/satoh-lab/haolin/nhk/excerpts/2008_04_09_19_00_2.webm;Ichiro OZAWA.jpg;1397;1397;6301;46;46;0
/net/per920a/export/das14a/satoh-lab/haolin/nhk/excerpts/2008_04_09_19_00_2.webm;Ichiro OZAWA.jpg;1421;1421;6301;47;47;0
/net/per920a/export/das14a/satoh-lab/haolin/nhk/excerpts/2008_04_09_19_00_2.webm;Ichiro OZAWA.jpg;1433;1465;6301;47;48;1
/net/per920a/export/das14a/satoh-lab/haolin/nhk/excerpts/2008_04_09_19_00_2.webm;Ichiro OZAWA.jpg;1489;1489;6301;49;49;0
/net/per920a/export/das14a/satoh-lab/haolin/nhk/excerpts/2008_04_09_19_00_2.webm;Ichiro OZAWA.jpg;1509;1509;6301;50;50;0
/net/per920a/export/das14a/satoh-lab/haolin/nhk/excerpts/2008_04_09_19_00_2.webm;Ichiro OZAWA.jpg;1601;1601;6301;53;53;0
/net/per920a/export/das14a/satoh-lab/haolin/nhk/excerpts/2008_04_09_19_00_2.webm;Ichiro OZAWA.jpg;1629;1677;6301;54;55;1
/net/per920a/export/das14a/satoh-lab/haolin/nhk/excerpts/2008_04_09_19_00_2.webm;Ichiro OZAWA.jpg;1749;1753;6301;58;58;0
/net/per920a/export/das14a/satoh-lab/haolin/nhk/excerpts/2008_04_09_19_00_2.webm;Ichiro OZAWA.jpg;1841;2029;6301;61;67;6
/net/per920a/export/das14a/satoh-lab/haolin/nhk/excerpts/2008_04_09_19_00_2.webm;Ichiro OZAWA.jpg;2129;2133;6301;70;71;1
/net/per920a/export/das14a/satoh-lab/haolin/nhk/excerpts/2008_04_09_19_00_2.webm;Ichiro OZAWA.jpg;2237;2293;6301;74;76;2
/net/per920a/export/das14a/satoh-lab/haolin/nhk/excerpts/2008_04_09_19_00_2.webm;Ichiro OZAWA.jpg;3709;3717;6301;123;123;0
/net/per920a/export/das14a/satoh-lab/haolin/nhk/excerpts/2008_04_09_19_00_2.webm;Ichiro OZAWA.jpg;3729;3741;6301;124;124;0
/net/per920a/export/das14a/satoh-lab/haolin/nhk/excerpts/2008_04_09_19_00_2.webm;Ichiro OZAWA.jpg;3753;3753;6301;125;125;0
/net/per920a/export/das14a/satoh-lab/haolin/nhk/excerpts/2008_04_09_19_00_2.webm;Ichiro OZAWA.jpg;3765;3765;6301;125;125;0
/net/per920a/export/das14a/satoh-lab/haolin/nhk/excerpts/2008_04_09_19_00_2.webm;Ichiro OZAWA.jpg;3781;3793;6301;126;126;0
/net/per920a/export/das14a/satoh-lab/haolin/nhk/excerpts/2008_04_09_19_00_2.webm;Ichiro OZAWA.jpg;3805;3805;6301;126;126;0
/net/per920a/export/das14a/satoh-lab/haolin/nhk/excerpts/2008_04_09_19_00_2.webm;Ichiro OZAWA.jpg;3817;3821;6301;127;127;0
/net/per920a/export/das14a/satoh-lab/haolin/nhk/excerpts/2008_04_09_19_00_2.webm;Ichiro OZAWA.jpg;3833;3885;6301;127;129;2
/net/per920a/export/das14a/satoh-lab/haolin/nhk/excerpts/2008_04_09_19_00_2.webm;Ichiro OZAWA.jpg;3897;3897;6301;129;129;0
/net/per920a/export/das14a/satoh-lab/haolin/nhk/excerpts/2008_04_09_19_00_2.webm;Ichiro OZAWA.jpg;3909;3933;6301;130;131;1
/net/per920a/export/das14a/satoh-lab/haolin/nhk/excerpts/2008_04_09_19_00_2.webm;Ichiro OZAWA.jpg;3945;3945;6301;131;131;0
/net/per920a/export/das14a/satoh-lab/haolin/nhk/excerpts/2008_04_09_19_00_2.webm;Ichiro OZAWA.jpg;4069;4069;6301;135;135;0
/net/per920a/export/das14a/satoh-lab/haolin/nhk/excerpts/2008_04_09_19_00_2.webm;Ichiro OZAWA.jpg;4089;4093;6301;136;136;0
/net/per920a/export/das14a/satoh-lab/haolin/nhk/excerpts/2008_04_09_19_00_2.webm;Ichiro OZAWA.jpg;4117;4121;6301;137;137;0
/net/per920a/export/das14a/satoh-lab/haolin/nhk/excerpts/2008_04_09_19_00_2.webm;Ichiro OZAWA.jpg;4137;4141;6301;137;138;1
/net/per920a/export/das14a/satoh-lab/haolin/nhk/excerpts/2008_04_09_19_00_2.webm;Ichiro OZAWA.jpg;4153;4161;6301;138;138;0
/net/per920a/export/das14a/satoh-lab/haolin/nhk/excerpts/2008_04_09_19_00_2.webm;Ichiro OZAWA.jpg;4173;4177;6301;139;139;0
/net/per920a/export/das14a/satoh-lab/haolin/nhk/excerpts/2008_04_09_19_00_2.webm;Ichiro OZAWA.jpg;4189;4201;6301;139;140;1
/net/per920a/export/das14a/satoh-lab/haolin/nhk/excerpts/2008_04_09_19_00_2.webm;Ichiro OZAWA.jpg;4217;4245;6301;140;141;1
/net/per920a/export/das14a/satoh-lab/haolin/nhk/excerpts/2008_04_09_19_00_2.webm;Ichiro OZAWA.jpg;4337;4361;6301;144;145;1
/net/per920a/export/das14a/satoh-lab/haolin/nhk/excerpts/2008_04_09_19_00_2.webm;Ichiro OZAWA.jpg;4645;4669;6301;154;155;1
/net/per920a/export/das14a/satoh-lab/haolin/nhk/excerpts/2008_04_09_19_00_2.webm;Ichiro OZAWA.jpg;4681;4681;6301;156;156;0
/net/per920a/export/das14a/satoh-lab/haolin/nhk/excerpts/2008_04_09_19_00_2.webm;Ichiro OZAWA.jpg;4693;4829;6301;156;160;4
/net/per920a/export/das14a/satoh-lab/haolin/nhk/excerpts/2008_04_09_19_00_2.webm;Ichiro OZAWA.jpg;5085;5117;6301;169;170;1
/net/per920a/export/das14a/satoh-lab/haolin/nhk/excerpts/2008_04_09_19_00_2.webm;Ichiro OZAWA.jpg;6005;6041;6301;200;201;1
/net/per920a/export/das14a/satoh-lab/haolin/nhk/excerpts/2008_04_09_19_00_2.webm;Ichiro OZAWA.jpg;6081;6093;6301;202;203;1
/net/per920a/export/das14a/satoh-lab/haolin/nhk/excerpts/2008_04_09_19_00_2.webm;Ichiro OZAWA.jpg;6137;6145;6301;204;204;0
/net/per920a/export/das14a/satoh-lab/haolin/nhk/excerpts/2008_06_11_19_00_1.webm;Yasuo FUKUDA.jpg;9;629;14121;0;20;20
/net/per920a/export/das14a/satoh-lab/haolin/nhk/excerpts/2008_06_11_19_00_1.webm;Yasuo FUKUDA.jpg;1249;1249;14121;41;41;0
/net/per920a/export/das14a/satoh-lab/haolin/nhk/excerpts/2008_06_11_19_00_1.webm;Yasuo FUKUDA.jpg;1273;1273;14121;42;42;0
/net/per920a/export/das14a/satoh-lab/haolin/nhk/excerpts/2008_06_11_19_00_1.webm;Yasuo FUKUDA.jpg;1289;1485;14121;42;49;7
/net/per920a/export/das14a/satoh-lab/haolin/nhk/excerpts/2008_06_11_19_00_1.webm;Yasuo FUKUDA.jpg;1501;1621;14121;50;54;4
/net/per920a/export/das14a/satoh-lab/haolin/nhk/excerpts/2008_06_11_19_00_1.webm;Yasuo FUKUDA.jpg;2205;2205;14121;73;73;0
/net/per920a/export/das14a/satoh-lab/haolin/nhk/excerpts/2008_06_11_19_00_1.webm;Yasuo FUKUDA.jpg;2221;2313;14121;74;77;3
/net/per920a/export/das14a/satoh-lab/haolin/nhk/excerpts/2008_06_11_19_00_1.webm;Yasuo FUKUDA.jpg;3189;3189;14121;106;106;0
/net/per920a/export/das14a/satoh-lab/haolin/nhk/excerpts/2008_06_11_19_00_1.webm;Yasuo FUKUDA.jpg;3221;3417;14121;107;113;6
/net/per920a/export/das14a/satoh-lab/haolin/nhk/excerpts/2008_06_11_19_00_1.webm;Yasuo FUKUDA.jpg;3601;3633;14121;120;121;1
/net/per920a/export/das14a/satoh-lab/haolin/nhk/excerpts/2008_06_11_19_00_1.webm;Yasuo FUKUDA.jpg;3681;3789;14121;122;126;4
/net/per920a/export/das14a/satoh-lab/haolin/nhk/excerpts/2008_06_11_19_00_1.webm;Yasuo FUKUDA.jpg;3873;3937;14121;129;131;2
/net/per920a/export/das14a/satoh-lab/haolin/nhk/excerpts/2008_06_11_19_00_1.webm;Yasuo FUKUDA.jpg;3969;4097;14121;132;136;4
/net/per920a/export/das14a/satoh-lab/haolin/nhk/excerpts/2008_06_11_19_00_1.webm;Yasuo FUKUDA.jpg;4113;4365;14121;137;145;8
/net/per920a/export/das14a/satoh-lab/haolin/nhk/excerpts/2008_06_11_19_00_1.webm;Yasuo FUKUDA.jpg;4737;4757;14121;158;158;0
/net/per920a/export/das14a/satoh-lab/haolin/nhk/excerpts/2008_06_11_19_00_1.webm;Yasuo FUKUDA.jpg;4777;5045;14121;159;168;9
/net/per920a/export/das14a/satoh-lab/haolin/nhk/excerpts/2008_06_11_19_00_1.webm;Yasuo FUKUDA.jpg;7581;7629;14121;252;254;2
/net/per920a/export/das14a/satoh-lab/haolin/nhk/excerpts/2008_06_11_19_00_1.webm;Yasuo FUKUDA.jpg;7765;7877;14121;258;262;4
/net/per920a/export/das14a/satoh-lab/haolin/nhk/excerpts/2008_06_11_19_00_1.webm;Yasuo FUKUDA.jpg;9065;9153;14121;302;305;3
/net/per920a/export/das14a/satoh-lab/haolin/nhk/excerpts/2008_06_11_19_00_1.webm;Yukio HATOYAMA.jpg;1865;1873;14121;62;62;0
/net/per920a/export/das14a/satoh-lab/haolin/nhk/excerpts/2008_06_11_19_00_1.webm;Yukio HATOYAMA.jpg;1889;2057;14121;63;68;5
/net/per920a/export/das14a/satoh-lab/haolin/nhk/excerpts/2008_06_11_19_00_1.webm;Yukio HATOYAMA.jpg;10429;10449;14121;347;348;1
/net/per920a/export/das14a/satoh-lab/haolin/nhk/excerpts/2008_06_11_19_00_1.webm;Yukio HATOYAMA.jpg;10589;10609;14121;353;353;0
/net/per920a/export/das14a/satoh-lab/haolin/nhk/excerpts/2008_06_11_19_00_1.webm;Ichiro OZAWA.jpg;5057;5505;14121;168;183;15
/net/per920a/export/das14a/satoh-lab/haolin/nhk/excerpts/2008_06_11_19_00_1.webm;Ichiro OZAWA.jpg;5529;5769;14121;184;192;8
/net/per920a/export/das14a/satoh-lab/haolin/nhk/excerpts/2008_06_11_19_00_1.webm;Ichiro OZAWA.jpg;9809;9821;14121;327;327;0
/net/per920a/export/das14a/satoh-lab/haolin/nhk/excerpts/2008_06_11_19_00_1.webm;Ichiro OZAWA.jpg;9841;9861;14121;328;328;0
/net/per920a/export/das14a/satoh-lab/haolin/nhk/excerpts/2008_06_11_19_00_1.webm;Ichiro OZAWA.jpg;10789;11441;14121;359;381;22
/net/per920a/export/das14a/satoh-lab/haolin/nhk/excerpts/2008_06_11_19_00_1.webm;Kazuo SHII.jpg;5785;6417;14121;192;214;22
/net/per920a/export/das14a/satoh-lab/haolin/nhk/excerpts/2008_06_11_19_00_1.webm;Mizuho FUKUSHIMA.jpg;6437;6537;14121;214;218;4
/net/per920a/export/das14a/satoh-lab/haolin/nhk/excerpts/2008_06_11_19_00_1.webm;Mizuho FUKUSHIMA.jpg;6561;6613;14121;218;220;2
/net/per920a/export/das14a/satoh-lab/haolin/nhk/excerpts/2008_06_11_19_00_1.webm;Mizuho FUKUSHIMA.jpg;6661;6665;14121;222;222;0
/net/per920a/export/das14a/satoh-lab/haolin/nhk/excerpts/2008_06_11_19_00_1.webm;Mizuho FUKUSHIMA.jpg;6677;6677;14121;222;222;0
/net/per920a/export/das14a/satoh-lab/haolin/nhk/excerpts/2008_06_11_19_00_1.webm;Mizuho FUKUSHIMA.jpg;6693;6885;14121;223;229;6
/net/per920a/export/das14a/satoh-lab/haolin/nhk/excerpts/2008_06_11_19_00_1.webm;Mizuho FUKUSHIMA.jpg;6897;6905;14121;230;230;0
/net/per920a/export/das14a/satoh-lab/haolin/nhk/excerpts/2008_06_11_19_00_1.webm;Mizuho FUKUSHIMA.jpg;6917;6949;14121;230;231;1
/net/per920a/export/das14a/satoh-lab/haolin/nhk/excerpts/2008_06_11_19_00_1.webm;Mizuho FUKUSHIMA.jpg;6965;7013;14121;232;233;1
/net/per920a/export/das14a/satoh-lab/haolin/nhk/excerpts/2008_06_26_19_00_1.webm;Yasuo FUKUDA.jpg;3653;3725;25865;121;124;3
/net/per920a/export/das14a/satoh-lab/haolin/nhk/excerpts/2008_06_26_19_00_1.webm;Yasuo FUKUDA.jpg;3753;4157;25865;125;138;13
/net/per920a/export/das14a/satoh-lab/haolin/nhk/excerpts/2008_06_26_19_00_1.webm;Yasuo FUKUDA.jpg;4173;4189;25865;139;139;0
/net/per920a/export/das14a/satoh-lab/haolin/nhk/excerpts/2008_06_26_19_00_1.webm;Yasuo FUKUDA.jpg;4205;4293;25865;140;143;3
/net/per920a/export/das14a/satoh-lab/haolin/nhk/excerpts/2008_06_26_19_00_1.webm;Yasuo FUKUDA.jpg;4309;4313;25865;143;143;0
/net/per920a/export/das14a/satoh-lab/haolin/nhk/excerpts/2008_06_26_19_00_1.webm;Yasuo FUKUDA.jpg;4325;4325;25865;144;144;0
/net/per920a/export/das14a/satoh-lab/haolin/nhk/excerpts/2008_06_26_19_00_1.webm;Yasuo FUKUDA.jpg;4337;4461;25865;144;148;4
/net/per920a/export/das14a/satoh-lab/haolin/nhk/excerpts/2008_06_26_19_00_1.webm;Yasuo FUKUDA.jpg;4489;4501;25865;149;150;1
/net/per920a/export/das14a/satoh-lab/haolin/nhk/excerpts/2008_06_26_19_00_1.webm;Yasuo FUKUDA.jpg;4517;4573;25865;150;152;2
/net/per920a/export/das14a/satoh-lab/haolin/nhk/excerpts/2008_06_26_19_00_1.webm;Yasuo FUKUDA.jpg;4589;5357;25865;153;178;25
/net/per920a/export/das14a/satoh-lab/haolin/nhk/excerpts/2008_06_26_19_00_1.webm;Yasuo FUKUDA.jpg;12489;12613;25865;416;420;4
/net/per920a/export/das14a/satoh-lab/haolin/nhk/excerpts/2008_06_26_19_00_1.webm;Yasuo FUKUDA.jpg;12629;12637;25865;421;421;0
/net/per920a/export/das14a/satoh-lab/haolin/nhk/excerpts/2008_06_26_19_00_1.webm;Yasuo FUKUDA.jpg;12665;12713;25865;422;424;2
/net/per920a/export/das14a/satoh-lab/haolin/nhk/excerpts/2008_07_06_19_00_1.webm;Yasuo FUKUDA.jpg;849;849;3393;28;28;0
/net/per920a/export/das14a/satoh-lab/haolin/nhk/excerpts/2008_07_06_19_00_1.webm;Yasuo FUKUDA.jpg;861;861;3393;28;28;0
/net/per920a/export/das14a/satoh-lab/haolin/nhk/excerpts/2008_07_06_19_00_1.webm;Yasuo FUKUDA.jpg;873;909;3393;29;30;1
/net/per920a/export/das14a/satoh-lab/haolin/nhk/excerpts/2008_07_06_19_00_1.webm;Yasuo FUKUDA.jpg;925;945;3393;30;31;1
/net/per920a/export/das14a/satoh-lab/haolin/nhk/excerpts/2008_07_06_19_00_1.webm;Yasuo FUKUDA.jpg;969;1045;3393;32;34;2
/net/per920a/export/das14a/satoh-lab/haolin/nhk/excerpts/2008_07_06_19_00_1.webm;Yasuo FUKUDA.jpg;1065;1217;3393;35;40;5
/net/per920a/export/das14a/satoh-lab/haolin/nhk/excerpts/2008_07_06_19_00_1.webm;Yasuo FUKUDA.jpg;1229;1229;3393;40;40;0
/net/per920a/export/das14a/satoh-lab/haolin/nhk/excerpts/2008_07_06_19_00_1.webm;Yasuo FUKUDA.jpg;1245;1245;3393;41;41;0
/net/per920a/export/das14a/satoh-lab/haolin/nhk/excerpts/2008_07_06_19_00_1.webm;Yasuo FUKUDA.jpg;1261;1261;3393;41;41;0
/net/per920a/export/das14a/satoh-lab/haolin/nhk/excerpts/2008_07_06_19_00_1.webm;Yasuo FUKUDA.jpg;1613;1709;3393;53;56;3
/net/per920a/export/das14a/satoh-lab/haolin/nhk/excerpts/2008_07_06_19_00_1.webm;Yasuo FUKUDA.jpg;1729;1753;3393;57;58;1
/net/per920a/export/das14a/satoh-lab/haolin/nhk/excerpts/2008_07_09_19_00_2.webm;Yasuo FUKUDA.jpg;629;1153;21201;20;38;18
/net/per920a/export/das14a/satoh-lab/haolin/nhk/excerpts/2008_07_09_19_00_2.webm;Yasuo FUKUDA.jpg;1169;1485;21201;38;49;11
/net/per920a/export/das14a/satoh-lab/haolin/nhk/excerpts/2008_07_09_19_00_2.webm;Yasuo FUKUDA.jpg;1565;1565;21201;52;52;0
/net/per920a/export/das14a/satoh-lab/haolin/nhk/excerpts/2008_07_09_19_00_2.webm;Yasuo FUKUDA.jpg;3157;3161;21201;105;105;0
/net/per920a/export/das14a/satoh-lab/haolin/nhk/excerpts/2008_07_09_19_00_2.webm;Yasuo FUKUDA.jpg;3265;3269;21201;108;109;1
/net/per920a/export/das14a/satoh-lab/haolin/nhk/excerpts/2008_07_09_19_00_2.webm;Yasuo FUKUDA.jpg;3285;3293;21201;109;109;0
/net/per920a/export/das14a/satoh-lab/haolin/nhk/excerpts/2008_07_09_19_00_2.webm;Yasuo FUKUDA.jpg;4049;4077;21201;135;135;0
/net/per920a/export/das14a/satoh-lab/haolin/nhk/excerpts/2008_07_09_19_00_2.webm;Yasuo FUKUDA.jpg;4105;4133;21201;136;137;1
/net/per920a/export/das14a/satoh-lab/haolin/nhk/excerpts/2008_07_09_19_00_2.webm;Yasuo FUKUDA.jpg;11933;12185;21201;397;406;9
/net/per920a/export/das14a/satoh-lab/haolin/nhk/excerpts/2008_07_09_19_00_2.webm;Yasuo FUKUDA.jpg;12633;12633;21201;421;421;0
/net/per920a/export/das14a/satoh-lab/haolin/nhk/excerpts/2008_07_09_19_00_2.webm;Yasuo FUKUDA.jpg;12709;12861;21201;423;428;5
/net/per920a/export/das14a/satoh-lab/haolin/nhk/excerpts/2008_07_09_19_00_2.webm;Yasuo FUKUDA.jpg;12877;13101;21201;429;436;7
/net/per920a/export/das14a/satoh-lab/haolin/nhk/excerpts/2008_07_09_19_00_2.webm;Yasuo FUKUDA.jpg;13117;13281;21201;437;442;5
/net/per920a/export/das14a/satoh-lab/haolin/nhk/excerpts/2008_07_09_19_00_2.webm;Yasuo FUKUDA.jpg;15769;15949;21201;525;531;6
/net/per920a/export/das14a/satoh-lab/haolin/nhk/excerpts/2008_07_09_19_00_2.webm;Yasuo FUKUDA.jpg;16113;16261;21201;537;542;5
/net/per920a/export/das14a/satoh-lab/haolin/nhk/excerpts/2008_07_09_19_00_2.webm;Yasuo FUKUDA.jpg;19241;19265;21201;641;642;1
/net/per920a/export/das14a/satoh-lab/haolin/nhk/excerpts/2008_07_09_19_00_2.webm;Yasuo FUKUDA.jpg;19277;19277;21201;642;642;0
/net/per920a/export/das14a/satoh-lab/haolin/nhk/excerpts/2008_07_09_19_00_2.webm;Yasuo FUKUDA.jpg;19289;19453;21201;643;648;5
/net/per920a/export/das14a/satoh-lab/haolin/nhk/excerpts/2008_07_09_19_00_2.webm;Yasuo FUKUDA.jpg;19689;19741;21201;656;658;2
/net/per920a/export/das14a/satoh-lab/haolin/nhk/excerpts/2008_07_09_19_00_2.webm;Yasuo FUKUDA.jpg;19829;19841;21201;661;661;0
/net/per920a/export/das14a/satoh-lab/haolin/nhk/excerpts/2008_07_09_19_00_2.webm;Yasuo FUKUDA.jpg;19853;19989;21201;662;666;4
/net/per920a/export/das14a/satoh-lab/haolin/nhk/excerpts/2008_07_09_19_00_2.webm;Yasuo FUKUDA.jpg;20297;20385;21201;676;679;3
/net/per920a/export/das14a/satoh-lab/haolin/nhk/excerpts/2008_09_06_19_00_2.webm;Taro ASO.jpg;693;773;1689;22;25;3
/net/per920a/export/das14a/satoh-lab/haolin/nhk/excerpts/2008_09_06_19_00_2.webm;Taro ASO.jpg;789;1129;1689;26;37;11
/net/per920a/export/das14a/satoh-lab/haolin/nhk/excerpts/2008_09_06_19_00_2.webm;Taro ASO.jpg;1145;1685;1689;37;55;18
/net/per920a/export/das14a/satoh-lab/haolin/nhk/excerpts/2008_09_24_19_00_2.webm;Taro ASO.jpg;289;289;7889;9;9;0
/net/per920a/export/das14a/satoh-lab/haolin/nhk/excerpts/2008_09_24_19_00_2.webm;Taro ASO.jpg;313;317;7889;10;10;0
/net/per920a/export/das14a/satoh-lab/haolin/nhk/excerpts/2008_09_24_19_00_2.webm;Taro ASO.jpg;329;329;7889;10;10;0
/net/per920a/export/das14a/satoh-lab/haolin/nhk/excerpts/2008_09_24_19_00_2.webm;Taro ASO.jpg;353;441;7889;11;14;3
/net/per920a/export/das14a/satoh-lab/haolin/nhk/excerpts/2008_09_24_19_00_2.webm;Taro ASO.jpg;461;513;7889;15;17;2
/net/per920a/export/das14a/satoh-lab/haolin/nhk/excerpts/2008_09_24_19_00_2.webm;Taro ASO.jpg;2097;2101;7889;69;70;1
/net/per920a/export/das14a/satoh-lab/haolin/nhk/excerpts/2008_09_24_19_00_2.webm;Taro ASO.jpg;2113;2113;7889;70;70;0
/net/per920a/export/das14a/satoh-lab/haolin/nhk/excerpts/2008_09_24_19_00_2.webm;Taro ASO.jpg;2125;2165;7889;70;72;2
/net/per920a/export/das14a/satoh-lab/haolin/nhk/excerpts/2008_09_24_19_00_2.webm;Taro ASO.jpg;2181;2217;7889;72;73;1
/net/per920a/export/das14a/satoh-lab/haolin/nhk/excerpts/2008_09_24_19_00_2.webm;Taro ASO.jpg;2233;2305;7889;74;76;2
/net/per920a/export/das14a/satoh-lab/haolin/nhk/excerpts/2008_09_24_19_00_2.webm;Taro ASO.jpg;2333;2333;7889;77;77;0
/net/per920a/export/das14a/satoh-lab/haolin/nhk/excerpts/2008_09_24_19_00_2.webm;Taro ASO.jpg;2349;2369;7889;78;78;0
/net/per920a/export/das14a/satoh-lab/haolin/nhk/excerpts/2008_09_24_19_00_2.webm;Taro ASO.jpg;2397;2405;7889;79;80;1
/net/per920a/export/das14a/satoh-lab/haolin/nhk/excerpts/2008_09_24_19_00_2.webm;Taro ASO.jpg;2437;2449;7889;81;81;0
/net/per920a/export/das14a/satoh-lab/haolin/nhk/excerpts/2008_09_24_19_00_2.webm;Taro ASO.jpg;3241;3341;7889;108;111;3
/net/per920a/export/das14a/satoh-lab/haolin/nhk/excerpts/2008_09_24_19_00_2.webm;Taro ASO.jpg;3413;3445;7889;113;114;1
/net/per920a/export/das14a/satoh-lab/haolin/nhk/excerpts/2008_09_24_19_00_2.webm;Taro ASO.jpg;3497;3505;7889;116;116;0
/net/per920a/export/das14a/satoh-lab/haolin/nhk/excerpts/2008_09_24_19_00_2.webm;Taro ASO.jpg;4029;4033;7889;134;134;0
/net/per920a/export/das14a/satoh-lab/haolin/nhk/excerpts/2008_09_24_19_00_2.webm;Taro ASO.jpg;6853;6857;7889;228;228;0
/net/per920a/export/das14a/satoh-lab/haolin/nhk/excerpts/2008_09_24_19_00_2.webm;Taro ASO.jpg;7445;7465;7889;248;248;0
/net/per920a/export/das14a/satoh-lab/haolin/nhk/excerpts/2008_09_24_19_00_2.webm;Taro ASO.jpg;7513;7537;7889;250;251;1
/net/per920a/export/das14a/satoh-lab/haolin/nhk/excerpts/2008_09_24_19_00_2.webm;Taro ASO.jpg;7597;7657;7889;253;255;2
/net/per920a/export/das14a/satoh-lab/haolin/nhk/excerpts/2008_09_24_19_00_2.webm;Taro ASO.jpg;7701;7789;7889;256;259;3
/net/per920a/export/das14a/satoh-lab/haolin/nhk/excerpts/2008_09_24_19_00_2.webm;Akihiro OHTA.jpg;1013;1013;7889;33;33;0
/net/per920a/export/das14a/satoh-lab/haolin/nhk/excerpts/2008_09_24_19_00_2.webm;Akihiro OHTA.jpg;1041;1053;7889;34;35;1
/net/per920a/export/das14a/satoh-lab/haolin/nhk/excerpts/2008_09_24_19_00_2.webm;Akihiro OHTA.jpg;6553;6613;7889;218;220;2
/net/per920a/export/das14a/satoh-lab/haolin/nhk/excerpts/2008_09_24_19_00_2.webm;Akihiro OHTA.jpg;6785;6805;7889;226;226;0
/net/per920a/export/das14a/satoh-lab/haolin/nhk/excerpts/2008_09_24_19_00_2.webm;Ichiro OZAWA.jpg;1609;1609;7889;53;53;0
/net/per920a/export/das14a/satoh-lab/haolin/nhk/excerpts/2008_09_24_19_00_2.webm;Ichiro OZAWA.jpg;1629;1853;7889;54;61;7
/net/per920a/export/das14a/satoh-lab/haolin/nhk/excerpts/2008_09_24_19_00_2.webm;Ichiro OZAWA.jpg;1869;1933;7889;62;64;2
/net/per920a/export/das14a/satoh-lab/haolin/nhk/excerpts/2008_09_24_19_00_2.webm;Ichiro OZAWA.jpg;4201;4213;7889;140;140;0
/net/per920a/export/das14a/satoh-lab/haolin/nhk/excerpts/2008_09_24_19_00_2.webm;Ichiro OZAWA.jpg;4237;4245;7889;141;141;0
/net/per920a/export/das14a/satoh-lab/haolin/nhk/excerpts/2008_09_24_19_00_2.webm;Ichiro OZAWA.jpg;4261;4269;7889;142;142;0
/net/per920a/export/das14a/satoh-lab/haolin/nhk/excerpts/2008_09_24_19_00_2.webm;Yasuo FUKUDA.jpg;2741;2825;7889;91;94;3
/net/per920a/export/das14a/satoh-lab/haolin/nhk/excerpts/2008_10_09_19_00_2.webm;Taro ASO.jpg;1337;1449;2793;44;48;4
/net/per920a/export/das14a/satoh-lab/haolin/nhk/excerpts/2008_11_17_19_00_1.webm;Ichiro OZAWA.jpg;25;777;9865;0;25;25
/net/per920a/export/das14a/satoh-lab/haolin/nhk/excerpts/2008_11_17_19_00_1.webm;Ichiro OZAWA.jpg;1293;1461;9865;43;48;5
/net/per920a/export/das14a/satoh-lab/haolin/nhk/excerpts/2008_11_17_19_00_1.webm;Ichiro OZAWA.jpg;1497;1613;9865;49;53;4
/net/per920a/export/das14a/satoh-lab/haolin/nhk/excerpts/2008_11_17_19_00_1.webm;Ichiro OZAWA.jpg;2109;2241;9865;70;74;4
/net/per920a/export/das14a/satoh-lab/haolin/nhk/excerpts/2008_11_17_19_00_1.webm;Ichiro OZAWA.jpg;2253;2529;9865;75;84;9
/net/per920a/export/das14a/satoh-lab/haolin/nhk/excerpts/2008_11_17_19_00_1.webm;Ichiro OZAWA.jpg;4489;4653;9865;149;155;6
/net/per920a/export/das14a/satoh-lab/haolin/nhk/excerpts/2008_11_17_19_00_1.webm;Ichiro OZAWA.jpg;4665;4825;9865;155;160;5
/net/per920a/export/das14a/satoh-lab/haolin/nhk/excerpts/2008_11_17_19_00_1.webm;Ichiro OZAWA.jpg;6381;6389;9865;212;213;1
/net/per920a/export/das14a/satoh-lab/haolin/nhk/excerpts/2008_11_17_19_00_1.webm;Ichiro OZAWA.jpg;6413;6413;9865;213;213;0
/net/per920a/export/das14a/satoh-lab/haolin/nhk/excerpts/2008_11_17_19_00_1.webm;Ichiro OZAWA.jpg;6429;7133;9865;214;237;23
/net/per920a/export/das14a/satoh-lab/haolin/nhk/excerpts/2008_11_17_19_00_1.webm;Taro ASO.jpg;1741;2005;9865;58;66;8
/net/per920a/export/das14a/satoh-lab/haolin/nhk/excerpts/2008_11_17_19_00_1.webm;Taro ASO.jpg;2253;2529;9865;75;84;9
/net/per920a/export/das14a/satoh-lab/haolin/nhk/excerpts/2008_11_17_19_00_1.webm;Taro ASO.jpg;4269;4293;9865;142;143;1
/net/per920a/export/das14a/satoh-lab/haolin/nhk/excerpts/2008_11_17_19_00_1.webm;Taro ASO.jpg;4381;4453;9865;146;148;2
/net/per920a/export/das14a/satoh-lab/haolin/nhk/excerpts/2008_11_17_19_00_1.webm;Taro ASO.jpg;4665;4825;9865;155;160;5
/net/per920a/export/das14a/satoh-lab/haolin/nhk/excerpts/2008_11_17_19_00_1.webm;Taro ASO.jpg;8581;8817;9865;286;294;8
/net/per920a/export/das14a/satoh-lab/haolin/nhk/excerpts/2008_11_17_19_00_1.webm;Taro ASO.jpg;8833;8865;9865;294;295;1
/net/per920a/export/das14a/satoh-lab/haolin/nhk/excerpts/2008_11_17_19_00_1.webm;Taro ASO.jpg;8881;9185;9865;296;306;10
/net/per920a/export/das14a/satoh-lab/haolin/nhk/excerpts/2008_11_17_19_00_1.webm;Taro ASO.jpg;9201;9425;9865;306;314;8
/net/per920a/export/das14a/satoh-lab/haolin/nhk/excerpts/2008_11_17_19_00_1.webm;Taro ASO.jpg;9453;9525;9865;315;317;2
/net/per920a/export/das14a/satoh-lab/haolin/nhk/excerpts/2008_11_17_19_00_1.webm;Taro ASO.jpg;9545;9693;9865;318;323;5
/net/per920a/export/das14a/satoh-lab/haolin/nhk/excerpts/2008_11_17_19_00_1.webm;Taro ASO.jpg;9709;9845;9865;323;328;5
/net/per920a/export/das14a/satoh-lab/haolin/nhk/excerpts/2008_11_17_19_00_1.webm;Naoto KAN.jpg;2669;2729;9865;89;91;2
/net/per920a/export/das14a/satoh-lab/haolin/nhk/excerpts/2008_11_17_19_00_1.webm;Naoto KAN.jpg;5505;5577;9865;183;185;2
/net/per920a/export/das14a/satoh-lab/haolin/nhk/excerpts/2008_11_17_19_00_1.webm;Yukio HATOYAMA.jpg;2841;2925;9865;94;97;3
/net/per920a/export/das14a/satoh-lab/haolin/nhk/excerpts/2008_11_17_19_00_1.webm;Yukio HATOYAMA.jpg;3197;3213;9865;106;107;1
/net/per920a/export/das14a/satoh-lab/haolin/nhk/excerpts/2008_11_17_19_00_1.webm;Yukio HATOYAMA.jpg;3317;3317;9865;110;110;0
/net/per920a/export/das14a/satoh-lab/haolin/nhk/excerpts/2008_11_17_19_00_1.webm;Yukio HATOYAMA.jpg;3341;3341;9865;111;111;0
/net/per920a/export/das14a/satoh-lab/haolin/nhk/excerpts/2008_11_17_19_00_1.webm;Yukio HATOYAMA.jpg;3365;3365;9865;112;112;0
/net/per920a/export/das14a/satoh-lab/haolin/nhk/excerpts/2008_11_17_19_00_1.webm;Yukio HATOYAMA.jpg;3381;3381;9865;112;112;0
/net/per920a/export/das14a/satoh-lab/haolin/nhk/excerpts/2008_11_17_19_00_1.webm;Yukio HATOYAMA.jpg;3401;3405;9865;113;113;0
/net/per920a/export/das14a/satoh-lab/haolin/nhk/excerpts/2008_11_17_19_00_1.webm;Yukio HATOYAMA.jpg;3433;3433;9865;114;114;0
/net/per920a/export/das14a/satoh-lab/haolin/nhk/excerpts/2008_11_17_19_00_1.webm;Yukio HATOYAMA.jpg;3445;3445;9865;114;114;0
/net/per920a/export/das14a/satoh-lab/haolin/nhk/excerpts/2008_11_17_19_00_1.webm;Yukio HATOYAMA.jpg;3457;3457;9865;115;115;0
/net/per920a/export/das14a/satoh-lab/haolin/nhk/excerpts/2008_11_17_19_00_1.webm;Yukio HATOYAMA.jpg;3473;3485;9865;115;116;1
/net/per920a/export/das14a/satoh-lab/haolin/nhk/excerpts/2008_11_17_19_00_1.webm;Yukio HATOYAMA.jpg;5693;5781;9865;189;192;3
/net/per920a/export/das14a/satoh-lab/haolin/nhk/excerpts/2008_11_17_19_00_1.webm;Kazuo SHII.jpg;3777;3777;9865;125;125;0
/net/per920a/export/das14a/satoh-lab/haolin/nhk/excerpts/2008_11_17_19_00_1.webm;Kazuo SHII.jpg;3789;3789;9865;126;126;0
/net/per920a/export/das14a/satoh-lab/haolin/nhk/excerpts/2008_11_17_19_00_1.webm;Kazuo SHII.jpg;3805;3825;9865;126;127;1
/net/per920a/export/das14a/satoh-lab/haolin/nhk/excerpts/2008_11_17_19_00_1.webm;Kazuo SHII.jpg;3837;3845;9865;127;128;1
/net/per920a/export/das14a/satoh-lab/haolin/nhk/excerpts/2008_11_17_19_00_1.webm;Kazuo SHII.jpg;3869;3877;9865;129;129;0
/net/per920a/export/das14a/satoh-lab/haolin/nhk/excerpts/2008_11_17_19_00_1.webm;Kazuo SHII.jpg;3905;3909;9865;130;130;0
/net/per920a/export/das14a/satoh-lab/haolin/nhk/excerpts/2008_11_17_19_00_1.webm;Kazuo SHII.jpg;5857;5953;9865;195;198;3
/net/per920a/export/das14a/satoh-lab/haolin/nhk/excerpts/2008_11_18_19_00_2.webm;Ichiro OZAWA.jpg;9;741;10249;0;24;24
/net/per920a/export/das14a/satoh-lab/haolin/nhk/excerpts/2008_11_18_19_00_2.webm;Ichiro OZAWA.jpg;949;1109;10249;31;37;6
/net/per920a/export/das14a/satoh-lab/haolin/nhk/excerpts/2008_11_18_19_00_2.webm;Ichiro OZAWA.jpg;3849;3881;10249;128;129;1
/net/per920a/export/das14a/satoh-lab/haolin/nhk/excerpts/2008_11_18_19_00_2.webm;Ichiro OZAWA.jpg;3973;3973;10249;132;132;0
/net/per920a/export/das14a/satoh-lab/haolin/nhk/excerpts/2008_11_18_19_00_2.webm;Ichiro OZAWA.jpg;4013;4017;10249;133;134;1
/net/per920a/export/das14a/satoh-lab/haolin/nhk/excerpts/2008_11_18_19_00_2.webm;Ichiro OZAWA.jpg;6677;6853;10249;222;228;6
/net/per920a/export/das14a/satoh-lab/haolin/nhk/excerpts/2008_11_18_19_00_2.webm;Taro ASO.jpg;9;741;10249;0;24;24
/net/per920a/export/das14a/satoh-lab/haolin/nhk/excerpts/2008_11_18_19_00_2.webm;Taro ASO.jpg;4233;4293;10249;141;143;2
/net/per920a/export/das14a/satoh-lab/haolin/nhk/excerpts/2008_11_18_19_00_2.webm;Taro ASO.jpg;4309;4405;10249;143;146;3
/net/per920a/export/das14a/satoh-lab/haolin/nhk/excerpts/2008_11_18_19_00_2.webm;Taro ASO.jpg;4425;4425;10249;147;147;0
/net/per920a/export/das14a/satoh-lab/haolin/nhk/excerpts/2008_11_18_19_00_2.webm;Taro ASO.jpg;4437;4437;10249;148;148;0
/net/per920a/export/das14a/satoh-lab/haolin/nhk/excerpts/2008_11_18_19_00_2.webm;Taro ASO.jpg;4453;4457;10249;148;148;0
/net/per920a/export/das14a/satoh-lab/haolin/nhk/excerpts/2008_11_18_19_00_2.webm;Taro ASO.jpg;4485;6009;10249;149;200;51
/net/per920a/export/das14a/satoh-lab/haolin/nhk/excerpts/2008_11_18_19_00_2.webm;Taro ASO.jpg;6685;6853;10249;223;228;5
/net/per920a/export/das14a/satoh-lab/haolin/nhk/excerpts/2008_11_18_19_00_2.webm;Taro ASO.jpg;6873;6873;10249;229;229;0
/net/per920a/export/das14a/satoh-lab/haolin/nhk/excerpts/2008_11_18_19_00_2.webm;Taro ASO.jpg;6901;6901;10249;230;230;0
/net/per920a/export/das14a/satoh-lab/haolin/nhk/excerpts/2008_11_18_19_00_2.webm;Taro ASO.jpg;6917;6937;10249;230;231;1
/net/per920a/export/das14a/satoh-lab/haolin/nhk/excerpts/2008_11_18_19_00_2.webm;Taro ASO.jpg;9117;9393;10249;304;313;9
/net/per920a/export/das14a/satoh-lab/haolin/nhk/excerpts/2008_11_18_19_00_2.webm;Taro ASO.jpg;9409;9737;10249;313;324;11
/net/per920a/export/das14a/satoh-lab/haolin/nhk/excerpts/2008_11_18_19_00_2.webm;Taro ASO.jpg;9765;10129;10249;325;337;12
/net/per920a/export/das14a/satoh-lab/haolin/nhk/excerpts/2008_11_18_19_00_2.webm;Yukio HATOYAMA.jpg;3737;3773;10249;124;125;1
/net/per920a/export/das14a/satoh-lab/haolin/nhk/excerpts/2008_11_18_19_00_2.webm;Yukio HATOYAMA.jpg;3789;3837;10249;126;128;2
/net/per920a/export/das14a/satoh-lab/haolin/nhk/excerpts/2008_11_25_19_00_1.webm;Taro ASO.jpg;11209;11301;11305;373;376;3
/net/per920a/export/das14a/satoh-lab/haolin/nhk/excerpts/2008_12_21_19_00_2.webm;Natsuo YAMAGUCHI.jpg;2049;2049;4953;68;68;0
/net/per920a/export/das14a/satoh-lab/haolin/nhk/excerpts/2008_12_21_19_00_2.webm;Natsuo YAMAGUCHI.jpg;2061;2061;4953;68;68;0
/net/per920a/export/das14a/satoh-lab/haolin/nhk/excerpts/2008_12_21_19_00_2.webm;Natsuo YAMAGUCHI.jpg;3093;3101;4953;103;103;0
/net/per920a/export/das14a/satoh-lab/haolin/nhk/excerpts/2008_12_21_19_00_2.webm;Natsuo YAMAGUCHI.jpg;3113;3133;4953;103;104;1
/net/per920a/export/das14a/satoh-lab/haolin/nhk/excerpts/2008_12_21_19_00_2.webm;Natsuo YAMAGUCHI.jpg;3145;3145;4953;104;104;0
/net/per920a/export/das14a/satoh-lab/haolin/nhk/excerpts/2008_12_21_19_00_2.webm;Natsuo YAMAGUCHI.jpg;3157;3161;4953;105;105;0
/net/per920a/export/das14a/satoh-lab/haolin/nhk/excerpts/2008_12_21_19_00_2.webm;Natsuo YAMAGUCHI.jpg;3177;3189;4953;105;106;1
/net/per920a/export/das14a/satoh-lab/haolin/nhk/excerpts/2008_12_21_19_00_2.webm;Natsuo YAMAGUCHI.jpg;3201;3201;4953;106;106;0
/net/per920a/export/das14a/satoh-lab/haolin/nhk/excerpts/2008_12_21_19_00_2.webm;Natsuo YAMAGUCHI.jpg;3217;3217;4953;107;107;0
/net/per920a/export/das14a/satoh-lab/haolin/nhk/excerpts/2008_12_21_19_00_2.webm;Natsuo YAMAGUCHI.jpg;3237;3237;4953;107;107;0
/net/per920a/export/das14a/satoh-lab/haolin/nhk/excerpts/2008_12_21_19_00_2.webm;Natsuo YAMAGUCHI.jpg;3253;3257;4953;108;108;0
/net/per920a/export/das14a/satoh-lab/haolin/nhk/excerpts/2008_12_21_19_00_2.webm;Natsuo YAMAGUCHI.jpg;3273;3277;4953;109;109;0
/net/per920a/export/das14a/satoh-lab/haolin/nhk/excerpts/2008_12_21_19_00_2.webm;Natsuo YAMAGUCHI.jpg;3289;3289;4953;109;109;0
/net/per920a/export/das14a/satoh-lab/haolin/nhk/excerpts/2008_12_21_19_00_2.webm;Natsuo YAMAGUCHI.jpg;3309;3309;4953;110;110;0
/net/per920a/export/das14a/satoh-lab/haolin/nhk/excerpts/2008_12_21_19_00_2.webm;Natsuo YAMAGUCHI.jpg;3329;3329;4953;110;110;0
/net/per920a/export/das14a/satoh-lab/haolin/nhk/excerpts/2008_12_21_19_00_2.webm;Natsuo YAMAGUCHI.jpg;3349;3357;4953;111;111;0
/net/per920a/export/das14a/satoh-lab/haolin/nhk/excerpts/2008_12_21_19_00_2.webm;Natsuo YAMAGUCHI.jpg;3377;3381;4953;112;112;0
/net/per920a/export/das14a/satoh-lab/haolin/nhk/excerpts/2008_12_21_19_00_2.webm;Natsuo YAMAGUCHI.jpg;3393;3405;4953;113;113;0
/net/per920a/export/das14a/satoh-lab/haolin/nhk/excerpts/2009_01_26_19_00_1.webm;Ichiro OZAWA.jpg;3873;3953;3957;129;131;2
/net/per920a/export/das14a/satoh-lab/haolin/nhk/excerpts/2009_01_26_19_00_1.webm;Taro ASO.jpg;3873;3953;3957;129;131;2
/net/per920a/export/das14a/satoh-lab/haolin/nhk/excerpts/2009_02_03_19_00_1.webm;Taro ASO.jpg;6805;6817;18441;226;227;1
/net/per920a/export/das14a/satoh-lab/haolin/nhk/excerpts/2009_02_03_19_00_1.webm;Taro ASO.jpg;6853;6865;18441;228;228;0
/net/per920a/export/das14a/satoh-lab/haolin/nhk/excerpts/2009_02_03_19_00_1.webm;Taro ASO.jpg;6877;6909;18441;229;230;1
/net/per920a/export/das14a/satoh-lab/haolin/nhk/excerpts/2009_02_03_19_00_1.webm;Taro ASO.jpg;6925;6929;18441;230;231;1
/net/per920a/export/das14a/satoh-lab/haolin/nhk/excerpts/2009_02_03_19_00_1.webm;Taro ASO.jpg;6941;6941;18441;231;231;0
/net/per920a/export/das14a/satoh-lab/haolin/nhk/excerpts/2009_02_03_19_00_1.webm;Taro ASO.jpg;6957;6973;18441;232;232;0
/net/per920a/export/das14a/satoh-lab/haolin/nhk/excerpts/2009_02_03_19_00_1.webm;Taro ASO.jpg;7785;8185;18441;259;272;13
/net/per920a/export/das14a/satoh-lab/haolin/nhk/excerpts/2009_02_03_19_00_1.webm;Taro ASO.jpg;8285;8285;18441;276;276;0
/net/per920a/export/das14a/satoh-lab/haolin/nhk/excerpts/2009_02_03_19_00_1.webm;Taro ASO.jpg;8297;8305;18441;276;276;0
/net/per920a/export/das14a/satoh-lab/haolin/nhk/excerpts/2009_02_03_19_00_1.webm;Taro ASO.jpg;8317;8329;18441;277;277;0
/net/per920a/export/das14a/satoh-lab/haolin/nhk/excerpts/2009_02_03_19_00_1.webm;Taro ASO.jpg;8389;8389;18441;279;279;0
/net/per920a/export/das14a/satoh-lab/haolin/nhk/excerpts/2009_02_03_19_00_1.webm;Taro ASO.jpg;8401;8405;18441;280;280;0
/net/per920a/export/das14a/satoh-lab/haolin/nhk/excerpts/2009_02_03_19_00_1.webm;Taro ASO.jpg;8421;8425;18441;280;280;0
/net/per920a/export/das14a/satoh-lab/haolin/nhk/excerpts/2009_02_03_19_00_1.webm;Taro ASO.jpg;8485;8493;18441;282;283;1
/net/per920a/export/das14a/satoh-lab/haolin/nhk/excerpts/2009_02_03_19_00_1.webm;Taro ASO.jpg;8525;8525;18441;284;284;0
/net/per920a/export/das14a/satoh-lab/haolin/nhk/excerpts/2009_02_03_19_00_1.webm;Taro ASO.jpg;8549;8553;18441;285;285;0
/net/per920a/export/das14a/satoh-lab/haolin/nhk/excerpts/2009_02_03_19_00_1.webm;Taro ASO.jpg;8761;8769;18441;292;292;0
/net/per920a/export/das14a/satoh-lab/haolin/nhk/excerpts/2009_02_03_19_00_1.webm;Taro ASO.jpg;8785;8785;18441;292;292;0
/net/per920a/export/das14a/satoh-lab/haolin/nhk/excerpts/2009_02_03_19_00_1.webm;Taro ASO.jpg;8853;8885;18441;295;296;1
/net/per920a/export/das14a/satoh-lab/haolin/nhk/excerpts/2009_02_03_19_00_1.webm;Taro ASO.jpg;8961;8981;18441;298;299;1
/net/per920a/export/das14a/satoh-lab/haolin/nhk/excerpts/2009_02_03_19_00_1.webm;Taro ASO.jpg;8997;8997;18441;300;300;0
/net/per920a/export/das14a/satoh-lab/haolin/nhk/excerpts/2009_02_03_19_00_1.webm;Taro ASO.jpg;9013;9033;18441;300;301;1
/net/per920a/export/das14a/satoh-lab/haolin/nhk/excerpts/2009_02_03_19_00_1.webm;Taro ASO.jpg;9049;9065;18441;301;302;1
/net/per920a/export/das14a/satoh-lab/haolin/nhk/excerpts/2009_02_03_19_00_1.webm;Taro ASO.jpg;9105;9469;18441;303;315;12
/net/per920a/export/das14a/satoh-lab/haolin/nhk/excerpts/2009_02_03_19_00_1.webm;Taro ASO.jpg;9605;9809;18441;320;327;7
/net/per920a/export/das14a/satoh-lab/haolin/nhk/excerpts/2009_02_03_19_00_1.webm;Taro ASO.jpg;10077;10349;18441;336;345;9
/net/per920a/export/das14a/satoh-lab/haolin/nhk/excerpts/2009_02_03_19_00_1.webm;Taro ASO.jpg;11601;12129;18441;386;404;18
/net/per920a/export/das14a/satoh-lab/haolin/nhk/excerpts/2009_02_03_19_00_1.webm;Taro ASO.jpg;12625;12649;18441;421;421;0
/net/per920a/export/das14a/satoh-lab/haolin/nhk/excerpts/2009_02_03_19_00_1.webm;Taro ASO.jpg;12805;12809;18441;427;427;0
/net/per920a/export/das14a/satoh-lab/haolin/nhk/excerpts/2009_02_03_19_00_1.webm;Taro ASO.jpg;12829;12849;18441;427;428;1
/net/per920a/export/das14a/satoh-lab/haolin/nhk/excerpts/2009_02_03_19_00_1.webm;Taro ASO.jpg;12913;12913;18441;430;430;0
/net/per920a/export/das14a/satoh-lab/haolin/nhk/excerpts/2009_02_03_19_00_1.webm;Taro ASO.jpg;12929;12953;18441;431;431;0
/net/per920a/export/das14a/satoh-lab/haolin/nhk/excerpts/2009_02_03_19_00_1.webm;Taro ASO.jpg;12969;13237;18441;432;441;9
/net/per920a/export/das14a/satoh-lab/haolin/nhk/excerpts/2009_02_03_19_00_1.webm;Taro ASO.jpg;13449;13637;18441;448;454;6
/net/per920a/export/das14a/satoh-lab/haolin/nhk/excerpts/2009_02_03_19_00_1.webm;Taro ASO.jpg;13665;13697;18441;455;456;1
/net/per920a/export/das14a/satoh-lab/haolin/nhk/excerpts/2009_02_03_19_00_1.webm;Taro ASO.jpg;15857;16137;18441;528;538;10
/net/per920a/export/das14a/satoh-lab/haolin/nhk/excerpts/2009_02_03_19_00_1.webm;Taro ASO.jpg;16153;16305;18441;538;543;5
/net/per920a/export/das14a/satoh-lab/haolin/nhk/excerpts/2009_02_03_19_00_1.webm;Taro ASO.jpg;16333;16345;18441;544;545;1
/net/per920a/export/das14a/satoh-lab/haolin/nhk/excerpts/2009_02_13_19_00_2.webm;Junichiro KOIZUMI.jpg;9;21;10229;0;0;0
/net/per920a/export/das14a/satoh-lab/haolin/nhk/excerpts/2009_02_13_19_00_2.webm;Junichiro KOIZUMI.jpg;37;69;10229;1;2;1
/net/per920a/export/das14a/satoh-lab/haolin/nhk/excerpts/2009_02_13_19_00_2.webm;Junichiro KOIZUMI.jpg;81;81;10229;2;2;0
/net/per920a/export/das14a/satoh-lab/haolin/nhk/excerpts/2009_02_13_19_00_2.webm;Junichiro KOIZUMI.jpg;93;281;10229;3;9;6
/net/per920a/export/das14a/satoh-lab/haolin/nhk/excerpts/2009_02_13_19_00_2.webm;Junichiro KOIZUMI.jpg;297;597;10229;9;19;10
/net/per920a/export/das14a/satoh-lab/haolin/nhk/excerpts/2009_02_13_19_00_2.webm;Junichiro KOIZUMI.jpg;613;765;10229;20;25;5
/net/per920a/export/das14a/satoh-lab/haolin/nhk/excerpts/2009_02_13_19_00_2.webm;Junichiro KOIZUMI.jpg;793;817;10229;26;27;1
/net/per920a/export/das14a/satoh-lab/haolin/nhk/excerpts/2009_02_13_19_00_2.webm;Junichiro KOIZUMI.jpg;1033;1169;10229;34;38;4
/net/per920a/export/das14a/satoh-lab/haolin/nhk/excerpts/2009_02_13_19_00_2.webm;Junichiro KOIZUMI.jpg;2577;2625;10229;85;87;2
/net/per920a/export/das14a/satoh-lab/haolin/nhk/excerpts/2009_02_13_19_00_2.webm;Junichiro KOIZUMI.jpg;2641;2929;10229;88;97;9
/net/per920a/export/das14a/satoh-lab/haolin/nhk/excerpts/2009_02_13_19_00_2.webm;Junichiro KOIZUMI.jpg;2945;3181;10229;98;106;8
/net/per920a/export/das14a/satoh-lab/haolin/nhk/excerpts/2009_02_13_19_00_2.webm;Junichiro KOIZUMI.jpg;3205;3217;10229;106;107;1
/net/per920a/export/das14a/satoh-lab/haolin/nhk/excerpts/2009_02_13_19_00_2.webm;Taro ASO.jpg;9;21;10229;0;0;0
/net/per920a/export/das14a/satoh-lab/haolin/nhk/excerpts/2009_02_13_19_00_2.webm;Taro ASO.jpg;37;69;10229;1;2;1
/net/per920a/export/das14a/satoh-lab/haolin/nhk/excerpts/2009_02_13_19_00_2.webm;Taro ASO.jpg;81;81;10229;2;2;0
/net/per920a/export/das14a/satoh-lab/haolin/nhk/excerpts/2009_02_13_19_00_2.webm;Taro ASO.jpg;93;281;10229;3;9;6
/net/per920a/export/das14a/satoh-lab/haolin/nhk/excerpts/2009_02_13_19_00_2.webm;Taro ASO.jpg;297;597;10229;9;19;10
/net/per920a/export/das14a/satoh-lab/haolin/nhk/excerpts/2009_02_13_19_00_2.webm;Taro ASO.jpg;613;765;10229;20;25;5
/net/per920a/export/das14a/satoh-lab/haolin/nhk/excerpts/2009_02_13_19_00_2.webm;Taro ASO.jpg;1189;1225;10229;39;40;1
/net/per920a/export/das14a/satoh-lab/haolin/nhk/excerpts/2009_02_13_19_00_2.webm;Taro ASO.jpg;1281;1297;10229;42;43;1
/net/per920a/export/das14a/satoh-lab/haolin/nhk/excerpts/2009_02_13_19_00_2.webm;Taro ASO.jpg;1337;1353;10229;44;45;1
/net/per920a/export/das14a/satoh-lab/haolin/nhk/excerpts/2009_02_13_19_00_2.webm;Taro ASO.jpg;1365;1369;10229;45;45;0
/net/per920a/export/das14a/satoh-lab/haolin/nhk/excerpts/2009_02_13_19_00_2.webm;Taro ASO.jpg;1381;1381;10229;46;46;0
/net/per920a/export/das14a/satoh-lab/haolin/nhk/excerpts/2009_02_13_19_00_2.webm;Taro ASO.jpg;1401;1401;10229;46;46;0
/net/per920a/export/das14a/satoh-lab/haolin/nhk/excerpts/2009_02_13_19_00_2.webm;Taro ASO.jpg;1585;1753;10229;52;58;6
/net/per920a/export/das14a/satoh-lab/haolin/nhk/excerpts/2009_02_13_19_00_2.webm;Taro ASO.jpg;9357;9365;10229;311;312;1
/net/per920a/export/das14a/satoh-lab/haolin/nhk/excerpts/2009_02_13_19_00_2.webm;Taro ASO.jpg;9381;9381;10229;312;312;0
/net/per920a/export/das14a/satoh-lab/haolin/nhk/excerpts/2009_02_13_19_00_2.webm;Taro ASO.jpg;9393;9393;10229;313;313;0
/net/per920a/export/das14a/satoh-lab/haolin/nhk/excerpts/2009_02_13_19_00_2.webm;Taro ASO.jpg;9405;9413;10229;313;313;0
/net/per920a/export/das14a/satoh-lab/haolin/nhk/excerpts/2009_02_13_19_00_2.webm;Taro ASO.jpg;9429;9429;10229;314;314;0
/net/per920a/export/das14a/satoh-lab/haolin/nhk/excerpts/2009_02_13_19_00_2.webm;Taro ASO.jpg;9449;9473;10229;314;315;1
/net/per920a/export/das14a/satoh-lab/haolin/nhk/excerpts/2009_02_13_19_00_2.webm;Taro ASO.jpg;9501;9509;10229;316;316;0
/net/per920a/export/das14a/satoh-lab/haolin/nhk/excerpts/2009_02_13_19_00_2.webm;Taro ASO.jpg;9525;9545;10229;317;318;1
/net/per920a/export/das14a/satoh-lab/haolin/nhk/excerpts/2009_02_13_19_00_2.webm;Taro ASO.jpg;9561;9577;10229;318;319;1
/net/per920a/export/das14a/satoh-lab/haolin/nhk/excerpts/2009_02_13_19_00_2.webm;Taro ASO.jpg;9593;9677;10229;319;322;3
/net/per920a/export/das14a/satoh-lab/haolin/nhk/excerpts/2009_02_13_19_00_2.webm;Taro ASO.jpg;9693;9785;10229;323;326;3
/net/per920a/export/das14a/satoh-lab/haolin/nhk/excerpts/2009_02_13_19_00_2.webm;Taro ASO.jpg;9801;9829;10229;326;327;1
/net/per920a/export/das14a/satoh-lab/haolin/nhk/excerpts/2009_02_13_19_00_2.webm;Taro ASO.jpg;9845;9857;10229;328;328;0
/net/per920a/export/das14a/satoh-lab/haolin/nhk/excerpts/2009_02_13_19_00_2.webm;Taro ASO.jpg;9877;10037;10229;329;334;5
/net/per920a/export/das14a/satoh-lab/haolin/nhk/excerpts/2009_02_13_19_00_2.webm;Shintaro ISHIHARA.jpg;4049;4173;10229;134;139;5
/net/per920a/export/das14a/satoh-lab/haolin/nhk/excerpts/2009_02_13_19_00_2.webm;Shintaro ISHIHARA.jpg;4185;4185;10229;139;139;0
/net/per920a/export/das14a/satoh-lab/haolin/nhk/excerpts/2009_02_13_19_00_2.webm;Shintaro ISHIHARA.jpg;4209;4213;10229;140;140;0
/net/per920a/export/das14a/satoh-lab/haolin/nhk/excerpts/2009_02_13_19_00_2.webm;Shintaro ISHIHARA.jpg;4241;4241;10229;141;141;0
/net/per920a/export/das14a/satoh-lab/haolin/nhk/excerpts/2009_02_13_19_00_2.webm;Shintaro ISHIHARA.jpg;4273;4289;10229;142;142;0
/net/per920a/export/das14a/satoh-lab/haolin/nhk/excerpts/2009_02_13_19_00_2.webm;Shintaro ISHIHARA.jpg;4301;4325;10229;143;144;1
/net/per920a/export/das14a/satoh-lab/haolin/nhk/excerpts/2009_02_13_19_00_2.webm;Shintaro ISHIHARA.jpg;4337;4349;10229;144;144;0
/net/per920a/export/das14a/satoh-lab/haolin/nhk/excerpts/2009_02_13_19_00_2.webm;Ichiro OZAWA.jpg;7509;7513;10229;250;250;0
/net/per920a/export/das14a/satoh-lab/haolin/nhk/excerpts/2009_02_13_19_00_2.webm;Ichiro OZAWA.jpg;7525;7541;10229;250;251;1
/net/per920a/export/das14a/satoh-lab/haolin/nhk/excerpts/2009_02_13_19_00_2.webm;Ichiro OZAWA.jpg;7553;7581;10229;251;252;1
/net/per920a/export/das14a/satoh-lab/haolin/nhk/excerpts/2009_02_13_19_00_2.webm;Ichiro OZAWA.jpg;7597;7613;10229;253;253;0
/net/per920a/export/das14a/satoh-lab/haolin/nhk/excerpts/2009_02_13_19_00_2.webm;Ichiro OZAWA.jpg;10053;10097;10229;335;336;1
/net/per920a/export/das14a/satoh-lab/haolin/nhk/excerpts/2009_02_13_19_00_2.webm;Ichiro OZAWA.jpg;10113;10225;10229;337;340;3
/net/per920a/export/das14a/satoh-lab/haolin/nhk/excerpts/2009_02_13_19_00_2.webm;Yukio HATOYAMA.jpg;7909;7933;10229;263;264;1
/net/per920a/export/das14a/satoh-lab/haolin/nhk/excerpts/2009_02_13_19_00_2.webm;Yukio HATOYAMA.jpg;7949;8001;10229;264;266;2
/net/per920a/export/das14a/satoh-lab/haolin/nhk/excerpts/2009_02_13_19_00_2.webm;Yukio HATOYAMA.jpg;8701;8957;10229;290;298;8
/net/per920a/export/das14a/satoh-lab/haolin/nhk/excerpts/2009_02_13_19_00_2.webm;Yukio HATOYAMA.jpg;8973;9001;10229;299;300;1
/net/per920a/export/das14a/satoh-lab/haolin/nhk/excerpts/2009_02_13_19_00_2.webm;Yukio HATOYAMA.jpg;9021;9089;10229;300;302;2
/net/per920a/export/das14a/satoh-lab/haolin/nhk/excerpts/2009_02_13_19_00_2.webm;Yukio HATOYAMA.jpg;9105;9225;10229;303;307;4
/net/per920a/export/das14a/satoh-lab/haolin/nhk/excerpts/2009_02_13_19_00_2.webm;Yukio HATOYAMA.jpg;9241;9277;10229;308;309;1
/net/per920a/export/das14a/satoh-lab/haolin/nhk/excerpts/2009_02_13_19_00_2.webm;Yukio HATOYAMA.jpg;10061;10097;10229;335;336;1
/net/per920a/export/das14a/satoh-lab/haolin/nhk/excerpts/2009_02_13_19_00_2.webm;Yukio HATOYAMA.jpg;10113;10225;10229;337;340;3
/net/per920a/export/das14a/satoh-lab/haolin/nhk/excerpts/2009_02_24_19_00_2.webm;Taro ASO.jpg;9;541;11277;0;18;18
/net/per920a/export/das14a/satoh-lab/haolin/nhk/excerpts/2009_02_24_19_00_2.webm;Taro ASO.jpg;1437;1485;11277;47;49;2
/net/per920a/export/das14a/satoh-lab/haolin/nhk/excerpts/2009_02_24_19_00_2.webm;Taro ASO.jpg;1513;1541;11277;50;51;1
/net/per920a/export/das14a/satoh-lab/haolin/nhk/excerpts/2009_02_24_19_00_2.webm;Taro ASO.jpg;1553;1561;11277;51;52;1
/net/per920a/export/das14a/satoh-lab/haolin/nhk/excerpts/2009_02_24_19_00_2.webm;Taro ASO.jpg;1573;1601;11277;52;53;1
/net/per920a/export/das14a/satoh-lab/haolin/nhk/excerpts/2009_02_24_19_00_2.webm;Taro ASO.jpg;1613;1637;11277;53;54;1
/net/per920a/export/das14a/satoh-lab/haolin/nhk/excerpts/2009_02_24_19_00_2.webm;Taro ASO.jpg;1657;1657;11277;55;55;0
/net/per920a/export/das14a/satoh-lab/haolin/nhk/excerpts/2009_02_24_19_00_2.webm;Taro ASO.jpg;1669;1725;11277;55;57;2
/net/per920a/export/das14a/satoh-lab/haolin/nhk/excerpts/2009_02_24_19_00_2.webm;Taro ASO.jpg;1769;1773;11277;58;59;1
/net/per920a/export/das14a/satoh-lab/haolin/nhk/excerpts/2009_02_24_19_00_2.webm;Taro ASO.jpg;1785;1789;11277;59;59;0
/net/per920a/export/das14a/satoh-lab/haolin/nhk/excerpts/2009_02_24_19_00_2.webm;Taro ASO.jpg;1801;1801;11277;60;60;0
/net/per920a/export/das14a/satoh-lab/haolin/nhk/excerpts/2009_02_24_19_00_2.webm;Taro ASO.jpg;1829;1833;11277;60;61;1
/net/per920a/export/das14a/satoh-lab/haolin/nhk/excerpts/2009_02_24_19_00_2.webm;Taro ASO.jpg;1889;1905;11277;62;63;1
/net/per920a/export/das14a/satoh-lab/haolin/nhk/excerpts/2009_02_24_19_00_2.webm;Taro ASO.jpg;1921;1921;11277;64;64;0
/net/per920a/export/das14a/satoh-lab/haolin/nhk/excerpts/2009_02_24_19_00_2.webm;Taro ASO.jpg;1953;1985;11277;65;66;1
/net/per920a/export/das14a/satoh-lab/haolin/nhk/excerpts/2009_02_24_19_00_2.webm;Taro ASO.jpg;2001;2017;11277;66;67;1
/net/per920a/export/das14a/satoh-lab/haolin/nhk/excerpts/2009_02_24_19_00_2.webm;Taro ASO.jpg;2033;2033;11277;67;67;0
/net/per920a/export/das14a/satoh-lab/haolin/nhk/excerpts/2009_02_24_19_00_2.webm;Taro ASO.jpg;2049;2049;11277;68;68;0
/net/per920a/export/das14a/satoh-lab/haolin/nhk/excerpts/2009_02_24_19_00_2.webm;Taro ASO.jpg;2073;2085;11277;69;69;0
/net/per920a/export/das14a/satoh-lab/haolin/nhk/excerpts/2009_02_24_19_00_2.webm;Taro ASO.jpg;2097;2205;11277;69;73;4
/net/per920a/export/das14a/satoh-lab/haolin/nhk/excerpts/2009_02_24_19_00_2.webm;Taro ASO.jpg;2217;2245;11277;73;74;1
/net/per920a/export/das14a/satoh-lab/haolin/nhk/excerpts/2009_02_24_19_00_2.webm;Taro ASO.jpg;2269;2269;11277;75;75;0
/net/per920a/export/das14a/satoh-lab/haolin/nhk/excerpts/2009_02_24_19_00_2.webm;Taro ASO.jpg;2285;2345;11277;76;78;2
/net/per920a/export/das14a/satoh-lab/haolin/nhk/excerpts/2009_02_24_19_00_2.webm;Taro ASO.jpg;2357;2357;11277;78;78;0
/net/per920a/export/das14a/satoh-lab/haolin/nhk/excerpts/2009_02_24_19_00_2.webm;Taro ASO.jpg;2369;2385;11277;78;79;1
/net/per920a/export/das14a/satoh-lab/haolin/nhk/excerpts/2009_02_24_19_00_2.webm;Taro ASO.jpg;2397;2429;11277;79;80;1
/net/per920a/export/das14a/satoh-lab/haolin/nhk/excerpts/2009_02_24_19_00_2.webm;Taro ASO.jpg;2453;2473;11277;81;82;1
/net/per920a/export/das14a/satoh-lab/haolin/nhk/excerpts/2009_02_24_19_00_2.webm;Taro ASO.jpg;2501;2501;11277;83;83;0
/net/per920a/export/das14a/satoh-lab/haolin/nhk/excerpts/2009_02_24_19_00_2.webm;Taro ASO.jpg;2537;2545;11277;84;84;0
/net/per920a/export/das14a/satoh-lab/haolin/nhk/excerpts/2009_02_24_19_00_2.webm;Taro ASO.jpg;2557;2557;11277;85;85;0
/net/per920a/export/das14a/satoh-lab/haolin/nhk/excerpts/2009_02_24_19_00_2.webm;Taro ASO.jpg;2569;2569;11277;85;85;0
/net/per920a/export/das14a/satoh-lab/haolin/nhk/excerpts/2009_02_24_19_00_2.webm;Taro ASO.jpg;2581;2581;11277;86;86;0
/net/per920a/export/das14a/satoh-lab/haolin/nhk/excerpts/2009_02_24_19_00_2.webm;Taro ASO.jpg;2593;2597;11277;86;86;0
/net/per920a/export/das14a/satoh-lab/haolin/nhk/excerpts/2009_02_24_19_00_2.webm;Taro ASO.jpg;2609;2613;11277;86;87;1
/net/per920a/export/das14a/satoh-lab/haolin/nhk/excerpts/2009_02_24_19_00_2.webm;Taro ASO.jpg;2657;2665;11277;88;88;0
/net/per920a/export/das14a/satoh-lab/haolin/nhk/excerpts/2009_02_24_19_00_2.webm;Taro ASO.jpg;2729;2765;11277;90;92;2
/net/per920a/export/das14a/satoh-lab/haolin/nhk/excerpts/2009_02_24_19_00_2.webm;Taro ASO.jpg;2781;2821;11277;92;94;2
/net/per920a/export/das14a/satoh-lab/haolin/nhk/excerpts/2009_02_24_19_00_2.webm;Taro ASO.jpg;2833;2833;11277;94;94;0
/net/per920a/export/das14a/satoh-lab/haolin/nhk/excerpts/2009_02_24_19_00_2.webm;Taro ASO.jpg;2845;2881;11277;94;96;2
/net/per920a/export/das14a/satoh-lab/haolin/nhk/excerpts/2009_02_24_19_00_2.webm;Taro ASO.jpg;2893;2909;11277;96;96;0
/net/per920a/export/das14a/satoh-lab/haolin/nhk/excerpts/2009_02_24_19_00_2.webm;Taro ASO.jpg;2921;2921;11277;97;97;0
/net/per920a/export/das14a/satoh-lab/haolin/nhk/excerpts/2009_02_24_19_00_2.webm;Taro ASO.jpg;2933;2933;11277;97;97;0
/net/per920a/export/das14a/satoh-lab/haolin/nhk/excerpts/2009_02_24_19_00_2.webm;Taro ASO.jpg;2945;2969;11277;98;98;0
/net/per920a/export/das14a/satoh-lab/haolin/nhk/excerpts/2009_02_24_19_00_2.webm;Taro ASO.jpg;3505;3513;11277;116;117;1
/net/per920a/export/das14a/satoh-lab/haolin/nhk/excerpts/2009_02_24_19_00_2.webm;Taro ASO.jpg;3549;3549;11277;118;118;0
/net/per920a/export/das14a/satoh-lab/haolin/nhk/excerpts/2009_02_24_19_00_2.webm;Taro ASO.jpg;3561;3573;11277;118;119;1
/net/per920a/export/das14a/satoh-lab/haolin/nhk/excerpts/2009_02_24_19_00_2.webm;Taro ASO.jpg;3669;3717;11277;122;123;1
/net/per920a/export/das14a/satoh-lab/haolin/nhk/excerpts/2009_02_24_19_00_2.webm;Taro ASO.jpg;3733;3769;11277;124;125;1
/net/per920a/export/das14a/satoh-lab/haolin/nhk/excerpts/2009_02_24_19_00_2.webm;Taro ASO.jpg;4745;5289;11277;158;176;18
/net/per920a/export/das14a/satoh-lab/haolin/nhk/excerpts/2009_02_24_19_00_2.webm;Taro ASO.jpg;5305;5433;11277;176;181;5
/net/per920a/export/das14a/satoh-lab/haolin/nhk/excerpts/2009_02_24_19_00_2.webm;Taro ASO.jpg;9293;9409;11277;309;313;4
/net/per920a/export/das14a/satoh-lab/haolin/nhk/excerpts/2009_02_24_19_00_2.webm;Ichiro OZAWA.jpg;11241;11273;11277;374;375;1
/net/per920a/export/das14a/satoh-lab/haolin/nhk/excerpts/2009_02_25_19_00_1.webm;Taro ASO.jpg;8149;8373;12261;271;279;8
/net/per920a/export/das14a/satoh-lab/haolin/nhk/excerpts/2009_02_25_19_00_1.webm;Taro ASO.jpg;8389;8737;12261;279;291;12
/net/per920a/export/das14a/satoh-lab/haolin/nhk/excerpts/2009_02_25_19_00_1.webm;Taro ASO.jpg;9105;9501;12261;303;316;13
/net/per920a/export/das14a/satoh-lab/haolin/nhk/excerpts/2009_02_25_19_00_1.webm;Taro ASO.jpg;9625;9837;12261;321;328;7
/net/per920a/export/das14a/satoh-lab/haolin/nhk/excerpts/2009_02_25_19_00_1.webm;Taro ASO.jpg;10169;10169;12261;339;339;0
/net/per920a/export/das14a/satoh-lab/haolin/nhk/excerpts/2009_02_25_19_00_1.webm;Taro ASO.jpg;10185;10185;12261;339;339;0
/net/per920a/export/das14a/satoh-lab/haolin/nhk/excerpts/2009_02_25_19_00_1.webm;Taro ASO.jpg;10201;10229;12261;340;341;1
/net/per920a/export/das14a/satoh-lab/haolin/nhk/excerpts/2009_02_25_19_00_1.webm;Taro ASO.jpg;10245;10249;12261;341;341;0
/net/per920a/export/das14a/satoh-lab/haolin/nhk/excerpts/2009_02_25_19_00_1.webm;Taro ASO.jpg;10265;10265;12261;342;342;0
/net/per920a/export/das14a/satoh-lab/haolin/nhk/excerpts/2009_02_25_19_00_1.webm;Taro ASO.jpg;10289;10437;12261;343;348;5
/net/per920a/export/das14a/satoh-lab/haolin/nhk/excerpts/2009_02_25_19_00_1.webm;Taro ASO.jpg;11585;11617;12261;386;387;1
/net/per920a/export/das14a/satoh-lab/haolin/nhk/excerpts/2009_02_25_19_00_1.webm;Taro ASO.jpg;11637;11685;12261;388;389;1
/net/per920a/export/das14a/satoh-lab/haolin/nhk/excerpts/2009_02_25_19_00_1.webm;Taro ASO.jpg;11701;11965;12261;390;399;9
/net/per920a/export/das14a/satoh-lab/haolin/nhk/excerpts/2009_02_27_19_00_1.webm;Taro ASO.jpg;9;581;3873;0;19;19
/net/per920a/export/das14a/satoh-lab/haolin/nhk/excerpts/2009_02_27_19_00_1.webm;Taro ASO.jpg;805;805;3873;26;26;0
/net/per920a/export/das14a/satoh-lab/haolin/nhk/excerpts/2009_02_27_19_00_1.webm;Taro ASO.jpg;825;829;3873;27;27;0
/net/per920a/export/das14a/satoh-lab/haolin/nhk/excerpts/2009_02_27_19_00_1.webm;Taro ASO.jpg;849;849;3873;28;28;0
/net/per920a/export/das14a/satoh-lab/haolin/nhk/excerpts/2009_02_27_19_00_1.webm;Taro ASO.jpg;861;861;3873;28;28;0
/net/per920a/export/das14a/satoh-lab/haolin/nhk/excerpts/2009_02_27_19_00_1.webm;Taro ASO.jpg;873;909;3873;29;30;1
/net/per920a/export/das14a/satoh-lab/haolin/nhk/excerpts/2009_02_27_19_00_1.webm;Taro ASO.jpg;1033;1061;3873;34;35;1
/net/per920a/export/das14a/satoh-lab/haolin/nhk/excerpts/2009_02_27_19_00_1.webm;Taro ASO.jpg;1077;1325;3873;35;44;9
/net/per920a/export/das14a/satoh-lab/haolin/nhk/excerpts/2009_02_27_19_00_1.webm;Taro ASO.jpg;1637;1637;3873;54;54;0
/net/per920a/export/das14a/satoh-lab/haolin/nhk/excerpts/2009_02_27_19_00_1.webm;Taro ASO.jpg;1681;1693;3873;55;56;1
/net/per920a/export/das14a/satoh-lab/haolin/nhk/excerpts/2009_02_27_19_00_1.webm;Taro ASO.jpg;2641;2649;3873;87;88;1
/net/per920a/export/das14a/satoh-lab/haolin/nhk/excerpts/2009_02_27_19_00_1.webm;Taro ASO.jpg;3009;3041;3873;100;101;1
/net/per920a/export/das14a/satoh-lab/haolin/nhk/excerpts/2009_02_27_19_00_1.webm;Naoto KAN.jpg;2293;2329;3873;76;77;1
/net/per920a/export/das14a/satoh-lab/haolin/nhk/excerpts/2009_02_27_19_00_1.webm;Naoto KAN.jpg;2345;2453;3873;78;81;3
/net/per920a/export/das14a/satoh-lab/haolin/nhk/excerpts/2009_02_27_19_00_1.webm;Naoto KAN.jpg;2465;2469;3873;82;82;0
/net/per920a/export/das14a/satoh-lab/haolin/nhk/excerpts/2009_02_27_19_00_1.webm;Naoto KAN.jpg;2509;2573;3873;83;85;2
/net/per920a/export/das14a/satoh-lab/haolin/nhk/excerpts/2009_02_27_19_00_1.webm;Naoto KAN.jpg;2589;2625;3873;86;87;1
/net/per920a/export/das14a/satoh-lab/haolin/nhk/excerpts/2009_02_27_19_00_1.webm;Ichiro OZAWA.jpg;3069;3093;3873;102;103;1
/net/per920a/export/das14a/satoh-lab/haolin/nhk/excerpts/2009_02_27_19_00_1.webm;Ichiro OZAWA.jpg;3105;3169;3873;103;105;2
/net/per920a/export/das14a/satoh-lab/haolin/nhk/excerpts/2009_03_04_19_00_1.webm;Ichiro OZAWA.jpg;181;185;23477;6;6;0
/net/per920a/export/das14a/satoh-lab/haolin/nhk/excerpts/2009_03_04_19_00_1.webm;Ichiro OZAWA.jpg;221;241;23477;7;8;1
/net/per920a/export/das14a/satoh-lab/haolin/nhk/excerpts/2009_03_04_19_00_1.webm;Ichiro OZAWA.jpg;265;289;23477;8;9;1
/net/per920a/export/das14a/satoh-lab/haolin/nhk/excerpts/2009_03_04_19_00_1.webm;Ichiro OZAWA.jpg;309;333;23477;10;11;1
/net/per920a/export/das14a/satoh-lab/haolin/nhk/excerpts/2009_03_04_19_00_1.webm;Ichiro OZAWA.jpg;381;381;23477;12;12;0
/net/per920a/export/das14a/satoh-lab/haolin/nhk/excerpts/2009_03_04_19_00_1.webm;Ichiro OZAWA.jpg;405;405;23477;13;13;0
/net/per920a/export/das14a/satoh-lab/haolin/nhk/excerpts/2009_03_04_19_00_1.webm;Ichiro OZAWA.jpg;425;449;23477;14;14;0
/net/per920a/export/das14a/satoh-lab/haolin/nhk/excerpts/2009_03_04_19_00_1.webm;Ichiro OZAWA.jpg;669;1237;23477;22;41;19
/net/per920a/export/das14a/satoh-lab/haolin/nhk/excerpts/2009_03_04_19_00_1.webm;Ichiro OZAWA.jpg;1253;1297;23477;41;43;2
/net/per920a/export/das14a/satoh-lab/haolin/nhk/excerpts/2009_03_04_19_00_1.webm;Ichiro OZAWA.jpg;1313;1397;23477;43;46;3
/net/per920a/export/das14a/satoh-lab/haolin/nhk/excerpts/2009_03_04_19_00_1.webm;Ichiro OZAWA.jpg;1413;1629;23477;47;54;7
/net/per920a/export/das14a/satoh-lab/haolin/nhk/excerpts/2009_03_04_19_00_1.webm;Ichiro OZAWA.jpg;1645;1665;23477;54;55;1
/net/per920a/export/das14a/satoh-lab/haolin/nhk/excerpts/2009_03_04_19_00_1.webm;Ichiro OZAWA.jpg;1681;1685;23477;56;56;0
/net/per920a/export/das14a/satoh-lab/haolin/nhk/excerpts/2009_03_04_19_00_1.webm;Ichiro OZAWA.jpg;1701;1769;23477;56;58;2
/net/per920a/export/das14a/satoh-lab/haolin/nhk/excerpts/2009_03_04_19_00_1.webm;Ichiro OZAWA.jpg;1785;1785;23477;59;59;0
/net/per920a/export/das14a/satoh-lab/haolin/nhk/excerpts/2009_03_04_19_00_1.webm;Ichiro OZAWA.jpg;1801;1821;23477;60;60;0
/net/per920a/export/das14a/satoh-lab/haolin/nhk/excerpts/2009_03_04_19_00_1.webm;Ichiro OZAWA.jpg;1837;2665;23477;61;88;27
/net/per920a/export/das14a/satoh-lab/haolin/nhk/excerpts/2009_03_04_19_00_1.webm;Ichiro OZAWA.jpg;2729;2817;23477;91;93;2
/net/per920a/export/das14a/satoh-lab/haolin/nhk/excerpts/2009_03_04_19_00_1.webm;Ichiro OZAWA.jpg;2833;2909;23477;94;97;3
/net/per920a/export/das14a/satoh-lab/haolin/nhk/excerpts/2009_03_04_19_00_1.webm;Ichiro OZAWA.jpg;2961;3265;23477;98;108;10
/net/per920a/export/das14a/satoh-lab/haolin/nhk/excerpts/2009_03_04_19_00_1.webm;Ichiro OZAWA.jpg;5609;5893;23477;187;196;9
/net/per920a/export/das14a/satoh-lab/haolin/nhk/excerpts/2009_03_04_19_00_1.webm;Ichiro OZAWA.jpg;5909;6097;23477;197;203;6
/net/per920a/export/das14a/satoh-lab/haolin/nhk/excerpts/2009_03_04_19_00_1.webm;Ichiro OZAWA.jpg;6125;6333;23477;204;211;7
/net/per920a/export/das14a/satoh-lab/haolin/nhk/excerpts/2009_03_04_19_00_1.webm;Ichiro OZAWA.jpg;6349;7717;23477;211;257;46
/net/per920a/export/das14a/satoh-lab/haolin/nhk/excerpts/2009_03_04_19_00_1.webm;Ichiro OZAWA.jpg;7733;8033;23477;257;267;10
/net/per920a/export/das14a/satoh-lab/haolin/nhk/excerpts/2009_03_04_19_00_1.webm;Ichiro OZAWA.jpg;8049;8069;23477;268;269;1
/net/per920a/export/das14a/satoh-lab/haolin/nhk/excerpts/2009_03_04_19_00_1.webm;Ichiro OZAWA.jpg;8085;8497;23477;269;283;14
/net/per920a/export/das14a/satoh-lab/haolin/nhk/excerpts/2009_03_04_19_00_1.webm;Ichiro OZAWA.jpg;8513;9713;23477;283;323;40
/net/per920a/export/das14a/satoh-lab/haolin/nhk/excerpts/2009_03_04_19_00_1.webm;Ichiro OZAWA.jpg;9729;9817;23477;324;327;3
/net/per920a/export/das14a/satoh-lab/haolin/nhk/excerpts/2009_03_04_19_00_1.webm;Ichiro OZAWA.jpg;9833;10029;23477;327;334;7
/net/per920a/export/das14a/satoh-lab/haolin/nhk/excerpts/2009_03_04_19_00_1.webm;Ichiro OZAWA.jpg;10045;10153;23477;335;338;3
/net/per920a/export/das14a/satoh-lab/haolin/nhk/excerpts/2009_03_04_19_00_1.webm;Yukio HATOYAMA.jpg;10249;10369;23477;341;345;4
/net/per920a/export/das14a/satoh-lab/haolin/nhk/excerpts/2009_03_04_19_00_1.webm;Yukio HATOYAMA.jpg;10397;10645;23477;346;355;9
/net/per920a/export/das14a/satoh-lab/haolin/nhk/excerpts/2009_03_04_19_00_1.webm;Yukio HATOYAMA.jpg;10689;10729;23477;356;357;1
/net/per920a/export/das14a/satoh-lab/haolin/nhk/excerpts/2009_03_04_19_00_1.webm;Yukio HATOYAMA.jpg;10745;10821;23477;358;360;2
/net/per920a/export/das14a/satoh-lab/haolin/nhk/excerpts/2009_03_04_19_00_1.webm;Yukio HATOYAMA.jpg;10837;10841;23477;361;361;0
/net/per920a/export/das14a/satoh-lab/haolin/nhk/excerpts/2009_03_04_19_00_1.webm;Yukio HATOYAMA.jpg;10857;10865;23477;362;362;0
/net/per920a/export/das14a/satoh-lab/haolin/nhk/excerpts/2009_03_04_19_00_1.webm;Yukio HATOYAMA.jpg;10881;10897;23477;362;363;1
/net/per920a/export/das14a/satoh-lab/haolin/nhk/excerpts/2009_03_04_19_00_1.webm;Yukio HATOYAMA.jpg;10913;10957;23477;363;365;2
/net/per920a/export/das14a/satoh-lab/haolin/nhk/excerpts/2009_03_04_19_00_1.webm;Yukio HATOYAMA.jpg;10973;11197;23477;365;373;8
/net/per920a/export/das14a/satoh-lab/haolin/nhk/excerpts/2009_03_04_19_00_1.webm;Katsuya OKADA.jpg;11525;11529;23477;384;384;0
/net/per920a/export/das14a/satoh-lab/haolin/nhk/excerpts/2009_03_04_19_00_1.webm;Katsuya OKADA.jpg;11565;11565;23477;385;385;0
/net/per920a/export/das14a/satoh-lab/haolin/nhk/excerpts/2009_03_04_19_00_1.webm;Katsuya OKADA.jpg;11577;11593;23477;386;386;0
/net/per920a/export/das14a/satoh-lab/haolin/nhk/excerpts/2009_03_04_19_00_1.webm;Katsuya OKADA.jpg;11625;11633;23477;387;387;0
/net/per920a/export/das14a/satoh-lab/haolin/nhk/excerpts/2009_03_04_19_00_1.webm;Katsuya OKADA.jpg;11649;11701;23477;388;390;2
/net/per920a/export/das14a/satoh-lab/haolin/nhk/excerpts/2009_03_04_19_00_1.webm;Katsuya OKADA.jpg;11717;11769;23477;390;392;2
/net/per920a/export/das14a/satoh-lab/haolin/nhk/excerpts/2009_03_04_19_00_1.webm;Katsuya OKADA.jpg;11781;11781;23477;392;392;0
/net/per920a/export/das14a/satoh-lab/haolin/nhk/excerpts/2009_03_04_19_00_1.webm;Katsuya OKADA.jpg;11793;11793;23477;393;393;0
/net/per920a/export/das14a/satoh-lab/haolin/nhk/excerpts/2009_03_04_19_00_1.webm;Katsuya OKADA.jpg;11805;11849;23477;393;395;2
/net/per920a/export/das14a/satoh-lab/haolin/nhk/excerpts/2009_03_04_19_00_1.webm;Katsuya OKADA.jpg;11865;11905;23477;395;397;2
/net/per920a/export/das14a/satoh-lab/haolin/nhk/excerpts/2009_03_04_19_00_1.webm;Kazuo SHII.jpg;13373;13617;23477;446;454;8
/net/per920a/export/das14a/satoh-lab/haolin/nhk/excerpts/2009_03_04_19_00_1.webm;Kazuo SHII.jpg;13633;13681;23477;454;456;2
/net/per920a/export/das14a/satoh-lab/haolin/nhk/excerpts/2009_03_04_19_00_1.webm;Kazuo SHII.jpg;13697;13949;23477;456;465;9
/net/per920a/export/das14a/satoh-lab/haolin/nhk/excerpts/2009_03_04_19_00_1.webm;Kazuo SHII.jpg;13969;13997;23477;465;466;1
/net/per920a/export/das14a/satoh-lab/haolin/nhk/excerpts/2009_03_04_19_00_1.webm;Taro ASO.jpg;15201;15213;23477;506;507;1
/net/per920a/export/das14a/satoh-lab/haolin/nhk/excerpts/2009_03_04_19_00_1.webm;Taro ASO.jpg;15229;15229;23477;507;507;0
/net/per920a/export/das14a/satoh-lab/haolin/nhk/excerpts/2009_03_04_19_00_1.webm;Taro ASO.jpg;15245;15293;23477;508;510;2
/net/per920a/export/das14a/satoh-lab/haolin/nhk/excerpts/2009_03_04_19_00_1.webm;Taro ASO.jpg;15309;15325;23477;510;511;1
/net/per920a/export/das14a/satoh-lab/haolin/nhk/excerpts/2009_03_04_19_00_1.webm;Taro ASO.jpg;15337;15337;23477;511;511;0
/net/per920a/export/das14a/satoh-lab/haolin/nhk/excerpts/2009_03_04_19_00_1.webm;Taro ASO.jpg;15349;15365;23477;511;512;1
/net/per920a/export/das14a/satoh-lab/haolin/nhk/excerpts/2009_03_04_19_00_1.webm;Taro ASO.jpg;15381;15381;23477;512;512;0
/net/per920a/export/das14a/satoh-lab/haolin/nhk/excerpts/2009_03_04_19_00_1.webm;Taro ASO.jpg;15417;15425;23477;514;514;0
/net/per920a/export/das14a/satoh-lab/haolin/nhk/excerpts/2009_03_04_19_00_1.webm;Taro ASO.jpg;15453;15465;23477;515;515;0
/net/per920a/export/das14a/satoh-lab/haolin/nhk/excerpts/2009_03_04_19_00_1.webm;Taro ASO.jpg;15481;15509;23477;516;517;1
/net/per920a/export/das14a/satoh-lab/haolin/nhk/excerpts/2009_03_04_19_00_1.webm;Taro ASO.jpg;15525;15525;23477;517;517;0
/net/per920a/export/das14a/satoh-lab/haolin/nhk/excerpts/2009_03_04_19_00_1.webm;Taro ASO.jpg;15541;15557;23477;518;518;0
/net/per920a/export/das14a/satoh-lab/haolin/nhk/excerpts/2009_03_04_19_00_1.webm;Taro ASO.jpg;15577;15585;23477;519;519;0
/net/per920a/export/das14a/satoh-lab/haolin/nhk/excerpts/2009_03_04_19_00_1.webm;Taro ASO.jpg;15597;15609;23477;520;520;0
/net/per920a/export/das14a/satoh-lab/haolin/nhk/excerpts/2009_03_04_19_00_1.webm;Taro ASO.jpg;15621;15621;23477;520;520;0
/net/per920a/export/das14a/satoh-lab/haolin/nhk/excerpts/2009_03_04_19_00_1.webm;Taro ASO.jpg;15633;15641;23477;521;521;0
/net/per920a/export/das14a/satoh-lab/haolin/nhk/excerpts/2009_03_04_19_00_1.webm;Taro ASO.jpg;15657;15677;23477;522;522;0
/net/per920a/export/das14a/satoh-lab/haolin/nhk/excerpts/2009_03_04_19_00_1.webm;Taro ASO.jpg;15709;15717;23477;523;524;1
/net/per920a/export/das14a/satoh-lab/haolin/nhk/excerpts/2009_03_04_19_00_1.webm;Taro ASO.jpg;15765;15765;23477;525;525;0
/net/per920a/export/das14a/satoh-lab/haolin/nhk/excerpts/2009_03_04_19_00_1.webm;Taro ASO.jpg;15777;15797;23477;526;526;0
/net/per920a/export/das14a/satoh-lab/haolin/nhk/excerpts/2009_03_04_19_00_1.webm;Yukio EDANO.jpg;22193;22193;23477;740;740;0
/net/per920a/export/das14a/satoh-lab/haolin/nhk/excerpts/2009_03_04_19_00_1.webm;Yukio EDANO.jpg;22253;22257;23477;742;742;0
/net/per920a/export/das14a/satoh-lab/haolin/nhk/excerpts/2009_03_04_19_00_1.webm;Shintaro ISHIHARA.jpg;22757;23065;23477;758;769;11
/net/per920a/export/das14a/satoh-lab/haolin/nhk/excerpts/2009_03_04_19_00_1.webm;Shintaro ISHIHARA.jpg;23081;23313;23477;769;777;8
/net/per920a/export/das14a/satoh-lab/haolin/nhk/excerpts/2009_03_06_19_00_1.webm;Ichiro OZAWA.jpg;9;609;25953;0;20;20
/net/per920a/export/das14a/satoh-lab/haolin/nhk/excerpts/2009_03_06_19_00_1.webm;Ichiro OZAWA.jpg;689;777;25953;22;25;3
/net/per920a/export/das14a/satoh-lab/haolin/nhk/excerpts/2009_03_06_19_00_1.webm;Ichiro OZAWA.jpg;793;793;25953;26;26;0
/net/per920a/export/das14a/satoh-lab/haolin/nhk/excerpts/2009_03_06_19_00_1.webm;Ichiro OZAWA.jpg;809;813;25953;26;27;1
/net/per920a/export/das14a/satoh-lab/haolin/nhk/excerpts/2009_03_06_19_00_1.webm;Ichiro OZAWA.jpg;829;837;25953;27;27;0
/net/per920a/export/das14a/satoh-lab/haolin/nhk/excerpts/2009_03_06_19_00_1.webm;Ichiro OZAWA.jpg;1001;1017;25953;33;33;0
/net/per920a/export/das14a/satoh-lab/haolin/nhk/excerpts/2009_03_06_19_00_1.webm;Ichiro OZAWA.jpg;1633;1641;25953;54;54;0
/net/per920a/export/das14a/satoh-lab/haolin/nhk/excerpts/2009_03_06_19_00_1.webm;Ichiro OZAWA.jpg;1801;1849;25953;60;61;1
/net/per920a/export/das14a/satoh-lab/haolin/nhk/excerpts/2009_03_06_19_00_1.webm;Ichiro OZAWA.jpg;1865;1977;25953;62;65;3
/net/per920a/export/das14a/satoh-lab/haolin/nhk/excerpts/2009_03_06_19_00_1.webm;Ichiro OZAWA.jpg;1993;2025;25953;66;67;1
/net/per920a/export/das14a/satoh-lab/haolin/nhk/excerpts/2009_03_06_19_00_1.webm;Ichiro OZAWA.jpg;2045;2241;25953;68;74;6
/net/per920a/export/das14a/satoh-lab/haolin/nhk/excerpts/2009_03_06_19_00_1.webm;Ichiro OZAWA.jpg;2473;2497;25953;82;83;1
/net/per920a/export/das14a/satoh-lab/haolin/nhk/excerpts/2009_03_06_19_00_1.webm;Ichiro OZAWA.jpg;2561;2577;25953;85;85;0
/net/per920a/export/das14a/satoh-lab/haolin/nhk/excerpts/2009_03_06_19_00_1.webm;Ichiro OZAWA.jpg;2805;2813;25953;93;93;0
/net/per920a/export/das14a/satoh-lab/haolin/nhk/excerpts/2009_03_06_19_00_1.webm;Ichiro OZAWA.jpg;2841;2845;25953;94;94;0
/net/per920a/export/das14a/satoh-lab/haolin/nhk/excerpts/2009_03_06_19_00_1.webm;Ichiro OZAWA.jpg;2893;2905;25953;96;96;0
/net/per920a/export/das14a/satoh-lab/haolin/nhk/excerpts/2009_03_06_19_00_1.webm;Ichiro OZAWA.jpg;2925;2957;25953;97;98;1
/net/per920a/export/das14a/satoh-lab/haolin/nhk/excerpts/2009_03_06_19_00_1.webm;Ichiro OZAWA.jpg;2973;2997;25953;99;100;1
/net/per920a/export/das14a/satoh-lab/haolin/nhk/excerpts/2009_03_06_19_00_1.webm;Ichiro OZAWA.jpg;3025;3029;25953;100;101;1
/net/per920a/export/das14a/satoh-lab/haolin/nhk/excerpts/2009_03_06_19_00_1.webm;Ichiro OZAWA.jpg;3049;3049;25953;101;101;0
/net/per920a/export/das14a/satoh-lab/haolin/nhk/excerpts/2009_03_06_19_00_1.webm;Ichiro OZAWA.jpg;3061;3093;25953;102;103;1
/net/per920a/export/das14a/satoh-lab/haolin/nhk/excerpts/2009_03_06_19_00_1.webm;Ichiro OZAWA.jpg;3117;3133;25953;104;104;0
/net/per920a/export/das14a/satoh-lab/haolin/nhk/excerpts/2009_03_06_19_00_1.webm;Ichiro OZAWA.jpg;3145;3153;25953;104;105;1
/net/per920a/export/das14a/satoh-lab/haolin/nhk/excerpts/2009_03_06_19_00_1.webm;Ichiro OZAWA.jpg;3177;3205;25953;106;106;0
/net/per920a/export/das14a/satoh-lab/haolin/nhk/excerpts/2009_03_06_19_00_1.webm;Ichiro OZAWA.jpg;3217;3217;25953;107;107;0
/net/per920a/export/das14a/satoh-lab/haolin/nhk/excerpts/2009_03_06_19_00_1.webm;Ichiro OZAWA.jpg;3229;3237;25953;107;108;1
/net/per920a/export/das14a/satoh-lab/haolin/nhk/excerpts/2009_03_06_19_00_1.webm;Ichiro OZAWA.jpg;3253;3277;25953;108;109;1
/net/per920a/export/das14a/satoh-lab/haolin/nhk/excerpts/2009_03_06_19_00_1.webm;Ichiro OZAWA.jpg;3309;3349;25953;110;111;1
/net/per920a/export/das14a/satoh-lab/haolin/nhk/excerpts/2009_03_06_19_00_1.webm;Ichiro OZAWA.jpg;3377;3469;25953;112;115;3
/net/per920a/export/das14a/satoh-lab/haolin/nhk/excerpts/2009_03_06_19_00_1.webm;Ichiro OZAWA.jpg;3489;3509;25953;116;117;1
/net/per920a/export/das14a/satoh-lab/haolin/nhk/excerpts/2009_03_06_19_00_1.webm;Ichiro OZAWA.jpg;4709;4957;25953;157;165;8
/net/per920a/export/das14a/satoh-lab/haolin/nhk/excerpts/2009_03_06_19_00_1.webm;Ichiro OZAWA.jpg;4973;5009;25953;165;167;2
/net/per920a/export/das14a/satoh-lab/haolin/nhk/excerpts/2009_03_06_19_00_1.webm;Ichiro OZAWA.jpg;5029;5213;25953;167;173;6
/net/per920a/export/das14a/satoh-lab/haolin/nhk/excerpts/2009_03_06_19_00_1.webm;Ichiro OZAWA.jpg;5265;5269;25953;175;175;0
/net/per920a/export/das14a/satoh-lab/haolin/nhk/excerpts/2009_03_06_19_00_1.webm;Ichiro OZAWA.jpg;5309;5337;25953;177;178;1
/net/per920a/export/das14a/satoh-lab/haolin/nhk/excerpts/2009_03_06_19_00_1.webm;Ichiro OZAWA.jpg;5353;5377;25953;178;179;1
/net/per920a/export/das14a/satoh-lab/haolin/nhk/excerpts/2009_03_06_19_00_1.webm;Ichiro OZAWA.jpg;8257;8517;25953;275;284;9
/net/per920a/export/das14a/satoh-lab/haolin/nhk/excerpts/2009_03_06_19_00_1.webm;Ichiro OZAWA.jpg;8529;8589;25953;284;286;2
/net/per920a/export/das14a/satoh-lab/haolin/nhk/excerpts/2009_03_06_19_00_1.webm;Ichiro OZAWA.jpg;8605;8789;25953;287;293;6
/net/per920a/export/das14a/satoh-lab/haolin/nhk/excerpts/2009_03_06_19_00_1.webm;Ichiro OZAWA.jpg;8805;8905;25953;293;297;4
/net/per920a/export/das14a/satoh-lab/haolin/nhk/excerpts/2009_03_06_19_00_1.webm;Ichiro OZAWA.jpg;8937;8957;25953;298;298;0
/net/per920a/export/das14a/satoh-lab/haolin/nhk/excerpts/2009_03_06_19_00_1.webm;Ichiro OZAWA.jpg;9001;9049;25953;300;301;1
/net/per920a/export/das14a/satoh-lab/haolin/nhk/excerpts/2009_03_06_19_00_1.webm;Ichiro OZAWA.jpg;9097;9145;25953;303;305;2
/net/per920a/export/das14a/satoh-lab/haolin/nhk/excerpts/2009_03_06_19_00_1.webm;Ichiro OZAWA.jpg;9169;9173;25953;305;306;1
/net/per920a/export/das14a/satoh-lab/haolin/nhk/excerpts/2009_03_06_19_00_1.webm;Ichiro OZAWA.jpg;9185;9249;25953;306;308;2
/net/per920a/export/das14a/satoh-lab/haolin/nhk/excerpts/2009_03_06_19_00_1.webm;Ichiro OZAWA.jpg;9277;9301;25953;309;310;1
/net/per920a/export/das14a/satoh-lab/haolin/nhk/excerpts/2009_03_06_19_00_1.webm;Ichiro OZAWA.jpg;9317;9473;25953;310;316;6
/net/per920a/export/das14a/satoh-lab/haolin/nhk/excerpts/2009_03_06_19_00_1.webm;Ichiro OZAWA.jpg;9493;9533;25953;316;318;2
/net/per920a/export/das14a/satoh-lab/haolin/nhk/excerpts/2009_03_06_19_00_1.webm;Ichiro OZAWA.jpg;9545;9557;25953;318;318;0
/net/per920a/export/das14a/satoh-lab/haolin/nhk/excerpts/2009_03_06_19_00_1.webm;Ichiro OZAWA.jpg;9577;9665;25953;319;322;3
/net/per920a/export/das14a/satoh-lab/haolin/nhk/excerpts/2009_03_06_19_00_1.webm;Ichiro OZAWA.jpg;9681;9701;25953;323;323;0
/net/per920a/export/das14a/satoh-lab/haolin/nhk/excerpts/2009_03_06_19_00_1.webm;Ichiro OZAWA.jpg;9753;9757;25953;325;325;0
/net/per920a/export/das14a/satoh-lab/haolin/nhk/excerpts/2009_03_06_19_00_1.webm;Ichiro OZAWA.jpg;9817;9821;25953;327;327;0
/net/per920a/export/das14a/satoh-lab/haolin/nhk/excerpts/2009_03_06_19_00_1.webm;Ichiro OZAWA.jpg;9841;9869;25953;328;329;1
/net/per920a/export/das14a/satoh-lab/haolin/nhk/excerpts/2009_03_06_19_00_1.webm;Ichiro OZAWA.jpg;9893;9993;25953;330;333;3
/net/per920a/export/das14a/satoh-lab/haolin/nhk/excerpts/2009_03_06_19_00_1.webm;Ichiro OZAWA.jpg;10009;10029;25953;333;334;1
/net/per920a/export/das14a/satoh-lab/haolin/nhk/excerpts/2009_03_06_19_00_1.webm;Ichiro OZAWA.jpg;10049;10185;25953;335;339;4
/net/per920a/export/das14a/satoh-lab/haolin/nhk/excerpts/2009_03_06_19_00_1.webm;Ichiro OZAWA.jpg;10201;10241;25953;340;341;1
/net/per920a/export/das14a/satoh-lab/haolin/nhk/excerpts/2009_03_06_19_00_1.webm;Ichiro OZAWA.jpg;10257;10301;25953;342;343;1
/net/per920a/export/das14a/satoh-lab/haolin/nhk/excerpts/2009_03_06_19_00_1.webm;Ichiro OZAWA.jpg;10317;10405;25953;344;347;3
/net/per920a/export/das14a/satoh-lab/haolin/nhk/excerpts/2009_03_06_19_00_1.webm;Ichiro OZAWA.jpg;10425;10437;25953;347;348;1
/net/per920a/export/das14a/satoh-lab/haolin/nhk/excerpts/2009_03_06_19_00_1.webm;Ichiro OZAWA.jpg;10517;10561;25953;350;352;2
/net/per920a/export/das14a/satoh-lab/haolin/nhk/excerpts/2009_03_06_19_00_1.webm;Ichiro OZAWA.jpg;10577;10633;25953;352;354;2
/net/per920a/export/das14a/satoh-lab/haolin/nhk/excerpts/2009_03_06_19_00_1.webm;Ichiro OZAWA.jpg;10649;10649;25953;355;355;0
/net/per920a/export/das14a/satoh-lab/haolin/nhk/excerpts/2009_03_06_19_00_1.webm;Ichiro OZAWA.jpg;10665;10665;25953;355;355;0
/net/per920a/export/das14a/satoh-lab/haolin/nhk/excerpts/2009_03_06_19_00_1.webm;Ichiro OZAWA.jpg;10681;10685;25953;356;356;0
/net/per920a/export/das14a/satoh-lab/haolin/nhk/excerpts/2009_03_06_19_00_1.webm;Ichiro OZAWA.jpg;10701;10745;25953;357;358;1
/net/per920a/export/das14a/satoh-lab/haolin/nhk/excerpts/2009_03_06_19_00_1.webm;Ichiro OZAWA.jpg;10761;10793;25953;359;360;1
/net/per920a/export/das14a/satoh-lab/haolin/nhk/excerpts/2009_03_06_19_00_1.webm;Ichiro OZAWA.jpg;10805;10805;25953;360;360;0
/net/per920a/export/das14a/satoh-lab/haolin/nhk/excerpts/2009_03_06_19_00_1.webm;Ichiro OZAWA.jpg;10829;10905;25953;361;363;2
/net/per920a/export/das14a/satoh-lab/haolin/nhk/excerpts/2009_03_06_19_00_1.webm;Ichiro OZAWA.jpg;10921;10925;25953;364;364;0
/net/per920a/export/das14a/satoh-lab/haolin/nhk/excerpts/2009_03_06_19_00_1.webm;Ichiro OZAWA.jpg;10949;11041;25953;365;368;3
/net/per920a/export/das14a/satoh-lab/haolin/nhk/excerpts/2009_03_06_19_00_1.webm;Ichiro OZAWA.jpg;11069;11081;25953;369;369;0
/net/per920a/export/das14a/satoh-lab/haolin/nhk/excerpts/2009_03_06_19_00_1.webm;Ichiro OZAWA.jpg;11097;11097;25953;370;370;0
/net/per920a/export/das14a/satoh-lab/haolin/nhk/excerpts/2009_03_06_19_00_1.webm;Ichiro OZAWA.jpg;11113;11185;25953;370;373;3
/net/per920a/export/das14a/satoh-lab/haolin/nhk/excerpts/2009_03_06_19_00_1.webm;Ichiro OZAWA.jpg;11201;11201;25953;373;373;0
/net/per920a/export/das14a/satoh-lab/haolin/nhk/excerpts/2009_03_06_19_00_1.webm;Ichiro OZAWA.jpg;11217;11601;25953;374;387;13
/net/per920a/export/das14a/satoh-lab/haolin/nhk/excerpts/2009_03_06_19_00_1.webm;Ichiro OZAWA.jpg;11617;11765;25953;387;392;5
/net/per920a/export/das14a/satoh-lab/haolin/nhk/excerpts/2009_03_06_19_00_1.webm;Ichiro OZAWA.jpg;11781;12121;25953;393;404;11
/net/per920a/export/das14a/satoh-lab/haolin/nhk/excerpts/2009_03_06_19_00_1.webm;Ichiro OZAWA.jpg;13085;13121;25953;436;437;1
/net/per920a/export/das14a/satoh-lab/haolin/nhk/excerpts/2009_03_06_19_00_1.webm;Ichiro OZAWA.jpg;13201;13205;25953;440;440;0
/net/per920a/export/das14a/satoh-lab/haolin/nhk/excerpts/2009_03_06_19_00_1.webm;Ichiro OZAWA.jpg;13233;13233;25953;441;441;0
/net/per920a/export/das14a/satoh-lab/haolin/nhk/excerpts/2009_03_06_19_00_1.webm;Ichiro OZAWA.jpg;13329;13329;25953;444;444;0
/net/per920a/export/das14a/satoh-lab/haolin/nhk/excerpts/2009_03_06_19_00_1.webm;Ichiro OZAWA.jpg;13389;13389;25953;446;446;0
/net/per920a/export/das14a/satoh-lab/haolin/nhk/excerpts/2009_03_06_19_00_1.webm;Ichiro OZAWA.jpg;13429;13477;25953;448;449;1
/net/per920a/export/das14a/satoh-lab/haolin/nhk/excerpts/2009_03_06_19_00_1.webm;Ichiro OZAWA.jpg;13545;13545;25953;451;451;0
/net/per920a/export/das14a/satoh-lab/haolin/nhk/excerpts/2009_03_06_19_00_1.webm;Ichiro OZAWA.jpg;13573;13581;25953;452;453;1
/net/per920a/export/das14a/satoh-lab/haolin/nhk/excerpts/2009_03_06_19_00_1.webm;Ichiro OZAWA.jpg;13701;13705;25953;457;457;0
/net/per920a/export/das14a/satoh-lab/haolin/nhk/excerpts/2009_03_06_19_00_1.webm;Ichiro OZAWA.jpg;13789;13801;25953;460;460;0
/net/per920a/export/das14a/satoh-lab/haolin/nhk/excerpts/2009_03_06_19_00_1.webm;Ichiro OZAWA.jpg;13865;13873;25953;462;462;0
/net/per920a/export/das14a/satoh-lab/haolin/nhk/excerpts/2009_03_06_19_00_1.webm;Ichiro OZAWA.jpg;14505;14597;25953;484;487;3
/net/per920a/export/das14a/satoh-lab/haolin/nhk/excerpts/2009_03_06_19_00_1.webm;Ichiro OZAWA.jpg;14613;14645;25953;487;488;1
/net/per920a/export/das14a/satoh-lab/haolin/nhk/excerpts/2009_03_06_19_00_1.webm;Ichiro OZAWA.jpg;14661;14685;25953;489;490;1
/net/per920a/export/das14a/satoh-lab/haolin/nhk/excerpts/2009_03_06_19_00_1.webm;Ichiro OZAWA.jpg;14701;14765;25953;490;492;2
/net/per920a/export/das14a/satoh-lab/haolin/nhk/excerpts/2009_03_06_19_00_1.webm;Ichiro OZAWA.jpg;14781;14821;25953;493;494;1
/net/per920a/export/das14a/satoh-lab/haolin/nhk/excerpts/2009_03_06_19_00_1.webm;Ichiro OZAWA.jpg;16153;16153;25953;538;538;0
/net/per920a/export/das14a/satoh-lab/haolin/nhk/excerpts/2009_03_06_19_00_1.webm;Ichiro OZAWA.jpg;16173;16425;25953;539;548;9
/net/per920a/export/das14a/satoh-lab/haolin/nhk/excerpts/2009_03_06_19_00_1.webm;Ichiro OZAWA.jpg;16465;16521;25953;549;551;2
/net/per920a/export/das14a/satoh-lab/haolin/nhk/excerpts/2009_03_06_19_00_1.webm;Ichiro OZAWA.jpg;16541;16581;25953;551;553;2
/net/per920a/export/das14a/satoh-lab/haolin/nhk/excerpts/2009_03_06_19_00_1.webm;Ichiro OZAWA.jpg;16605;16637;25953;554;555;1
/net/per920a/export/das14a/satoh-lab/haolin/nhk/excerpts/2009_03_06_19_00_1.webm;Ichiro OZAWA.jpg;16677;16685;25953;556;556;0
/net/per920a/export/das14a/satoh-lab/haolin/nhk/excerpts/2009_03_06_19_00_1.webm;Ichiro OZAWA.jpg;16833;16849;25953;561;562;1
/net/per920a/export/das14a/satoh-lab/haolin/nhk/excerpts/2009_03_06_19_00_1.webm;Ichiro OZAWA.jpg;16909;16913;25953;564;564;0
/net/per920a/export/das14a/satoh-lab/haolin/nhk/excerpts/2009_03_06_19_00_1.webm;Ichiro OZAWA.jpg;16937;16949;25953;565;565;0
/net/per920a/export/das14a/satoh-lab/haolin/nhk/excerpts/2009_03_06_19_00_1.webm;Ichiro OZAWA.jpg;17277;17277;25953;576;576;0
/net/per920a/export/das14a/satoh-lab/haolin/nhk/excerpts/2009_03_06_19_00_1.webm;Ichiro OZAWA.jpg;17405;17437;25953;580;581;1
/net/per920a/export/das14a/satoh-lab/haolin/nhk/excerpts/2009_03_06_19_00_1.webm;Ichiro OZAWA.jpg;17477;17477;25953;583;583;0
/net/per920a/export/das14a/satoh-lab/haolin/nhk/excerpts/2009_03_06_19_00_1.webm;Ichiro OZAWA.jpg;17529;17533;25953;584;585;1
/net/per920a/export/das14a/satoh-lab/haolin/nhk/excerpts/2009_03_06_19_00_1.webm;Ichiro OZAWA.jpg;17565;17581;25953;586;586;0
/net/per920a/export/das14a/satoh-lab/haolin/nhk/excerpts/2009_03_06_19_00_1.webm;Ichiro OZAWA.jpg;17605;17609;25953;587;587;0
/net/per920a/export/das14a/satoh-lab/haolin/nhk/excerpts/2009_03_06_19_00_1.webm;Ichiro OZAWA.jpg;17641;17641;25953;588;588;0
/net/per920a/export/das14a/satoh-lab/haolin/nhk/excerpts/2009_03_06_19_00_1.webm;Ichiro OZAWA.jpg;17673;17709;25953;589;590;1
/net/per920a/export/das14a/satoh-lab/haolin/nhk/excerpts/2009_03_06_19_00_1.webm;Taro ASO.jpg;22273;22281;25953;743;743;0
/net/per920a/export/das14a/satoh-lab/haolin/nhk/excerpts/2009_03_06_19_00_1.webm;Taro ASO.jpg;22313;22325;25953;744;744;0
/net/per920a/export/das14a/satoh-lab/haolin/nhk/excerpts/2009_03_06_19_00_1.webm;Taro ASO.jpg;22349;22405;25953;745;747;2
/net/per920a/export/das14a/satoh-lab/haolin/nhk/excerpts/2009_03_06_19_00_1.webm;Yukio HATOYAMA.jpg;24205;25197;25953;807;840;33
/net/per920a/export/das14a/satoh-lab/haolin/nhk/excerpts/2009_03_10_19_00_1.webm;Ichiro OZAWA.jpg;829;833;18705;27;27;0
/net/per920a/export/das14a/satoh-lab/haolin/nhk/excerpts/2009_03_10_19_00_1.webm;Ichiro OZAWA.jpg;857;885;18705;28;29;1
/net/per920a/export/das14a/satoh-lab/haolin/nhk/excerpts/2009_03_10_19_00_1.webm;Ichiro OZAWA.jpg;4889;5357;18705;163;178;15
/net/per920a/export/das14a/satoh-lab/haolin/nhk/excerpts/2009_03_10_19_00_1.webm;Ichiro OZAWA.jpg;5369;5377;18705;179;179;0
/net/per920a/export/das14a/satoh-lab/haolin/nhk/excerpts/2009_03_10_19_00_1.webm;Ichiro OZAWA.jpg;5397;5421;18705;180;180;0
/net/per920a/export/das14a/satoh-lab/haolin/nhk/excerpts/2009_03_10_19_00_1.webm;Ichiro OZAWA.jpg;5553;5649;18705;185;188;3
/net/per920a/export/das14a/satoh-lab/haolin/nhk/excerpts/2009_03_10_19_00_1.webm;Ichiro OZAWA.jpg;5665;5673;18705;188;189;1
/net/per920a/export/das14a/satoh-lab/haolin/nhk/excerpts/2009_03_10_19_00_1.webm;Ichiro OZAWA.jpg;5689;5689;18705;189;189;0
/net/per920a/export/das14a/satoh-lab/haolin/nhk/excerpts/2009_03_10_19_00_1.webm;Ichiro OZAWA.jpg;5717;5745;18705;190;191;1
/net/per920a/export/das14a/satoh-lab/haolin/nhk/excerpts/2009_03_10_19_00_1.webm;Ichiro OZAWA.jpg;5761;5817;18705;192;194;2
/net/per920a/export/das14a/satoh-lab/haolin/nhk/excerpts/2009_03_10_19_00_1.webm;Ichiro OZAWA.jpg;5845;5857;18705;194;195;1
/net/per920a/export/das14a/satoh-lab/haolin/nhk/excerpts/2009_03_10_19_00_1.webm;Ichiro OZAWA.jpg;5901;5925;18705;196;197;1
/net/per920a/export/das14a/satoh-lab/haolin/nhk/excerpts/2009_03_10_19_00_1.webm;Ichiro OZAWA.jpg;5957;5957;18705;198;198;0
/net/per920a/export/das14a/satoh-lab/haolin/nhk/excerpts/2009_03_10_19_00_1.webm;Ichiro OZAWA.jpg;5981;6045;18705;199;201;2
/net/per920a/export/das14a/satoh-lab/haolin/nhk/excerpts/2009_03_10_19_00_1.webm;Ichiro OZAWA.jpg;6093;6093;18705;203;203;0
/net/per920a/export/das14a/satoh-lab/haolin/nhk/excerpts/2009_03_10_19_00_1.webm;Ichiro OZAWA.jpg;6105;6117;18705;203;204;1
/net/per920a/export/das14a/satoh-lab/haolin/nhk/excerpts/2009_03_10_19_00_1.webm;Ichiro OZAWA.jpg;6145;6217;18705;204;207;3
/net/per920a/export/das14a/satoh-lab/haolin/nhk/excerpts/2009_03_10_19_00_1.webm;Ichiro OZAWA.jpg;6233;6261;18705;207;208;1
/net/per920a/export/das14a/satoh-lab/haolin/nhk/excerpts/2009_03_10_19_00_1.webm;Ichiro OZAWA.jpg;6289;6501;18705;209;216;7
/net/per920a/export/das14a/satoh-lab/haolin/nhk/excerpts/2009_03_10_19_00_1.webm;Ichiro OZAWA.jpg;6525;6565;18705;217;219;2
/net/per920a/export/das14a/satoh-lab/haolin/nhk/excerpts/2009_03_10_19_00_1.webm;Ichiro OZAWA.jpg;6581;6921;18705;219;230;11
/net/per920a/export/das14a/satoh-lab/haolin/nhk/excerpts/2009_03_10_19_00_1.webm;Ichiro OZAWA.jpg;6949;7037;18705;231;234;3
/net/per920a/export/das14a/satoh-lab/haolin/nhk/excerpts/2009_03_10_19_00_1.webm;Ichiro OZAWA.jpg;7053;7301;18705;235;243;8
/net/per920a/export/das14a/satoh-lab/haolin/nhk/excerpts/2009_03_10_19_00_1.webm;Ichiro OZAWA.jpg;7317;7353;18705;244;245;1
/net/per920a/export/das14a/satoh-lab/haolin/nhk/excerpts/2009_03_10_19_00_1.webm;Ichiro OZAWA.jpg;7373;7389;18705;245;246;1
/net/per920a/export/das14a/satoh-lab/haolin/nhk/excerpts/2009_03_10_19_00_1.webm;Ichiro OZAWA.jpg;7405;7409;18705;247;247;0
/net/per920a/export/das14a/satoh-lab/haolin/nhk/excerpts/2009_03_10_19_00_1.webm;Ichiro OZAWA.jpg;7433;7589;18705;247;253;6
/net/per920a/export/das14a/satoh-lab/haolin/nhk/excerpts/2009_03_10_19_00_1.webm;Ichiro OZAWA.jpg;7605;7609;18705;253;253;0
/net/per920a/export/das14a/satoh-lab/haolin/nhk/excerpts/2009_03_10_19_00_1.webm;Ichiro OZAWA.jpg;7705;7901;18705;257;263;6
/net/per920a/export/das14a/satoh-lab/haolin/nhk/excerpts/2009_03_10_19_00_1.webm;Ichiro OZAWA.jpg;7933;8013;18705;264;267;3
/net/per920a/export/das14a/satoh-lab/haolin/nhk/excerpts/2009_03_10_19_00_1.webm;Ichiro OZAWA.jpg;8045;8225;18705;268;274;6
/net/per920a/export/das14a/satoh-lab/haolin/nhk/excerpts/2009_03_10_19_00_1.webm;Ichiro OZAWA.jpg;8245;8277;18705;275;276;1
/net/per920a/export/das14a/satoh-lab/haolin/nhk/excerpts/2009_03_10_19_00_1.webm;Ichiro OZAWA.jpg;8305;8385;18705;277;279;2
/net/per920a/export/das14a/satoh-lab/haolin/nhk/excerpts/2009_03_10_19_00_1.webm;Ichiro OZAWA.jpg;8401;8425;18705;280;281;1
/net/per920a/export/das14a/satoh-lab/haolin/nhk/excerpts/2009_03_10_19_00_1.webm;Ichiro OZAWA.jpg;8441;8497;18705;281;283;2
/net/per920a/export/das14a/satoh-lab/haolin/nhk/excerpts/2009_03_10_19_00_1.webm;Ichiro OZAWA.jpg;8509;8513;18705;283;283;0
/net/per920a/export/das14a/satoh-lab/haolin/nhk/excerpts/2009_03_10_19_00_1.webm;Ichiro OZAWA.jpg;8537;8661;18705;284;288;4
/net/per920a/export/das14a/satoh-lab/haolin/nhk/excerpts/2009_03_10_19_00_1.webm;Ichiro OZAWA.jpg;8677;9041;18705;289;301;12
/net/per920a/export/das14a/satoh-lab/haolin/nhk/excerpts/2009_03_10_19_00_1.webm;Ichiro OZAWA.jpg;9505;9921;18705;317;330;13
/net/per920a/export/das14a/satoh-lab/haolin/nhk/excerpts/2009_03_10_19_00_1.webm;Ichiro OZAWA.jpg;9937;10057;18705;331;335;4
/net/per920a/export/das14a/satoh-lab/haolin/nhk/excerpts/2009_03_10_19_00_1.webm;Ichiro OZAWA.jpg;10073;10649;18705;336;355;19
/net/per920a/export/das14a/satoh-lab/haolin/nhk/excerpts/2009_03_10_19_00_1.webm;Ichiro OZAWA.jpg;10821;10877;18705;360;362;2
/net/per920a/export/das14a/satoh-lab/haolin/nhk/excerpts/2009_03_10_19_00_1.webm;Ichiro OZAWA.jpg;10893;11085;18705;363;369;6
/net/per920a/export/das14a/satoh-lab/haolin/nhk/excerpts/2009_03_10_19_00_1.webm;Ichiro OZAWA.jpg;11101;11165;18705;370;372;2
/net/per920a/export/das14a/satoh-lab/haolin/nhk/excerpts/2009_03_10_19_00_1.webm;Ichiro OZAWA.jpg;11353;11401;18705;378;380;2
/net/per920a/export/das14a/satoh-lab/haolin/nhk/excerpts/2009_03_10_19_00_1.webm;Ichiro OZAWA.jpg;11613;11629;18705;387;387;0
/net/per920a/export/das14a/satoh-lab/haolin/nhk/excerpts/2009_03_10_19_00_1.webm;Yukio HATOYAMA.jpg;11277;11313;18705;376;377;1
/net/per920a/export/das14a/satoh-lab/haolin/nhk/excerpts/2009_03_10_19_00_1.webm;Naoto KAN.jpg;11421;11461;18705;381;382;1
/net/per920a/export/das14a/satoh-lab/haolin/nhk/excerpts/2009_03_10_19_00_1.webm;Akihiro OHTA.jpg;13845;13881;18705;461;463;2
/net/per920a/export/das14a/satoh-lab/haolin/nhk/excerpts/2009_03_10_19_00_1.webm;Akihiro OHTA.jpg;14009;14053;18705;467;468;1
/net/per920a/export/das14a/satoh-lab/haolin/nhk/excerpts/2009_03_10_19_00_1.webm;Akihiro OHTA.jpg;14069;14081;18705;469;469;0
/net/per920a/export/das14a/satoh-lab/haolin/nhk/excerpts/2009_03_10_19_00_1.webm;Akihiro OHTA.jpg;14093;14153;18705;470;472;2
/net/per920a/export/das14a/satoh-lab/haolin/nhk/excerpts/2009_03_10_19_00_1.webm;Akihiro OHTA.jpg;14173;14181;18705;472;473;1
/net/per920a/export/das14a/satoh-lab/haolin/nhk/excerpts/2009_03_10_19_00_1.webm;Akihiro OHTA.jpg;14197;14237;18705;473;474;1
/net/per920a/export/das14a/satoh-lab/haolin/nhk/excerpts/2009_03_10_19_00_1.webm;Akihiro OHTA.jpg;14265;14289;18705;475;476;1
/net/per920a/export/das14a/satoh-lab/haolin/nhk/excerpts/2009_03_10_19_00_1.webm;Akihiro OHTA.jpg;14305;14341;18705;477;478;1
/net/per920a/export/das14a/satoh-lab/haolin/nhk/excerpts/2009_03_10_19_00_1.webm;Akihiro OHTA.jpg;14357;14361;18705;478;479;1
/net/per920a/export/das14a/satoh-lab/haolin/nhk/excerpts/2009_03_10_19_00_1.webm;Akihiro OHTA.jpg;14377;14425;18705;479;481;2
/net/per920a/export/das14a/satoh-lab/haolin/nhk/excerpts/2009_04_02_19_00_1.webm;Taro ASO.jpg;26009;26717;32433;867;891;24
/net/per920a/export/das14a/satoh-lab/haolin/nhk/excerpts/2009_04_02_19_00_1.webm;Yukio HATOYAMA.jpg;29173;29197;32433;973;974;1
/net/per920a/export/das14a/satoh-lab/haolin/nhk/excerpts/2009_04_02_19_00_1.webm;Yukio HATOYAMA.jpg;29213;29461;32433;974;982;8
/net/per920a/export/das14a/satoh-lab/haolin/nhk/excerpts/2009_04_02_19_00_1.webm;Yukio HATOYAMA.jpg;29693;29717;32433;990;991;1
/net/per920a/export/das14a/satoh-lab/haolin/nhk/excerpts/2009_04_02_19_00_1.webm;Yukio HATOYAMA.jpg;29745;29773;32433;992;993;1
/net/per920a/export/das14a/satoh-lab/haolin/nhk/excerpts/2009_04_02_19_00_1.webm;Naoto KAN.jpg;29489;29589;32433;983;987;4
/net/per920a/export/das14a/satoh-lab/haolin/nhk/excerpts/2009_04_02_19_00_1.webm;Naoto KAN.jpg;30469;30809;32433;1016;1027;11
/net/per920a/export/das14a/satoh-lab/haolin/nhk/excerpts/2009_04_02_19_00_1.webm;Naoto KAN.jpg;30825;30837;32433;1028;1028;0
/net/per920a/export/das14a/satoh-lab/haolin/nhk/excerpts/2009_04_02_19_00_1.webm;Naoto KAN.jpg;30853;30861;32433;1029;1029;0
/net/per920a/export/das14a/satoh-lab/haolin/nhk/excerpts/2009_04_02_19_00_1.webm;Naoto KAN.jpg;30889;30913;32433;1030;1031;1
/net/per920a/export/das14a/satoh-lab/haolin/nhk/excerpts/2009_04_02_19_00_1.webm;Naoto KAN.jpg;30929;31005;32433;1031;1034;3
/net/per920a/export/das14a/satoh-lab/haolin/nhk/excerpts/2009_04_02_19_00_1.webm;Naoto KAN.jpg;31037;31041;32433;1035;1035;0
/net/per920a/export/das14a/satoh-lab/haolin/nhk/excerpts/2009_04_02_19_00_1.webm;Takenori KANZAKI.jpg;32329;32349;32433;1078;1079;1
/net/per920a/export/das14a/satoh-lab/haolin/nhk/excerpts/2009_04_06_19_00_3.webm;Taro ASO.jpg;541;641;7109;18;21;3
/net/per920a/export/das14a/satoh-lab/haolin/nhk/excerpts/2009_04_06_19_00_3.webm;Taro ASO.jpg;657;697;7109;21;23;2
/net/per920a/export/das14a/satoh-lab/haolin/nhk/excerpts/2009_04_06_19_00_3.webm;Taro ASO.jpg;981;1117;7109;32;37;5
/net/per920a/export/das14a/satoh-lab/haolin/nhk/excerpts/2009_04_06_19_00_3.webm;Taro ASO.jpg;1185;1885;7109;39;62;23
/net/per920a/export/das14a/satoh-lab/haolin/nhk/excerpts/2009_04_06_19_00_3.webm;Taro ASO.jpg;7045;7061;7109;234;235;1
/net/per920a/export/das14a/satoh-lab/haolin/nhk/excerpts/2009_04_06_19_00_3.webm;Ichiro OZAWA.jpg;2229;2253;7109;74;75;1
/net/per920a/export/das14a/satoh-lab/haolin/nhk/excerpts/2009_04_06_19_00_3.webm;Yukio HATOYAMA.jpg;2705;2721;7109;90;90;0
/net/per920a/export/das14a/satoh-lab/haolin/nhk/excerpts/2009_04_18_19_00_3.webm;Naoto KAN.jpg;481;693;2013;16;23;7
/net/per920a/export/das14a/satoh-lab/haolin/nhk/excerpts/2009_04_18_19_00_3.webm;Naoto KAN.jpg;749;761;2013;24;25;1
/net/per920a/export/das14a/satoh-lab/haolin/nhk/excerpts/2009_04_18_19_00_3.webm;Naoto KAN.jpg;777;845;2013;25;28;3
/net/per920a/export/das14a/satoh-lab/haolin/nhk/excerpts/2009_04_18_19_00_3.webm;Naoto KAN.jpg;937;965;2013;31;32;1
/net/per920a/export/das14a/satoh-lab/haolin/nhk/excerpts/2009_04_18_19_00_3.webm;Naoto KAN.jpg;981;1181;2013;32;39;7
/net/per920a/export/das14a/satoh-lab/haolin/nhk/excerpts/2009_04_18_19_00_3.webm;Naoto KAN.jpg;1529;1721;2013;50;57;7
/net/per920a/export/das14a/satoh-lab/haolin/nhk/excerpts/2009_04_18_19_00_3.webm;Naoto KAN.jpg;1833;1937;2013;61;64;3
/net/per920a/export/das14a/satoh-lab/haolin/nhk/excerpts/2009_04_19_19_00_2.webm;Shintaro ISHIHARA.jpg;2877;2889;10701;95;96;1
/net/per920a/export/das14a/satoh-lab/haolin/nhk/excerpts/2009_04_19_19_00_2.webm;Shintaro ISHIHARA.jpg;2905;3013;10701;96;100;4
/net/per920a/export/das14a/satoh-lab/haolin/nhk/excerpts/2009_04_19_19_00_2.webm;Shintaro ISHIHARA.jpg;3029;3173;10701;101;105;4
/net/per920a/export/das14a/satoh-lab/haolin/nhk/excerpts/2009_04_19_19_00_2.webm;Shintaro ISHIHARA.jpg;5629;5901;10701;187;196;9
/net/per920a/export/das14a/satoh-lab/haolin/nhk/excerpts/2009_04_19_19_00_2.webm;Shintaro ISHIHARA.jpg;5925;5925;10701;197;197;0
/net/per920a/export/das14a/satoh-lab/haolin/nhk/excerpts/2009_05_15_19_00_2.webm;Yukio HATOYAMA.jpg;1945;1997;2793;64;66;2
/net/per920a/export/das14a/satoh-lab/haolin/nhk/excerpts/2009_05_15_19_00_2.webm;Yukio HATOYAMA.jpg;2013;2181;2793;67;72;5
/net/per920a/export/das14a/satoh-lab/haolin/nhk/excerpts/2009_05_15_19_00_2.webm;Yukio HATOYAMA.jpg;2197;2209;2793;73;73;0
/net/per920a/export/das14a/satoh-lab/haolin/nhk/excerpts/2009_05_15_19_00_2.webm;Yukio HATOYAMA.jpg;2401;2477;2793;79;82;3
/net/per920a/export/das14a/satoh-lab/haolin/nhk/excerpts/2009_05_15_19_00_2.webm;Yukio HATOYAMA.jpg;2625;2705;2793;87;90;3
/net/per920a/export/das14a/satoh-lab/haolin/nhk/excerpts/2009_06_01_19_00_3.webm;Taro ASO.jpg;1849;1945;8457;61;64;3
/net/per920a/export/das14a/satoh-lab/haolin/nhk/excerpts/2009_06_01_19_00_3.webm;Taro ASO.jpg;2125;2149;8457;70;71;1
/net/per920a/export/das14a/satoh-lab/haolin/nhk/excerpts/2009_06_01_19_00_3.webm;Taro ASO.jpg;2165;2209;8457;72;73;1
/net/per920a/export/das14a/satoh-lab/haolin/nhk/excerpts/2009_06_01_19_00_3.webm;Taro ASO.jpg;2225;2277;8457;74;75;1
/net/per920a/export/das14a/satoh-lab/haolin/nhk/excerpts/2009_06_01_19_00_3.webm;Taro ASO.jpg;2401;2449;8457;80;81;1
/net/per920a/export/das14a/satoh-lab/haolin/nhk/excerpts/2009_06_01_19_00_3.webm;Taro ASO.jpg;2537;2577;8457;84;85;1
/net/per920a/export/das14a/satoh-lab/haolin/nhk/excerpts/2009_06_01_19_00_3.webm;Taro ASO.jpg;6649;6661;8457;221;222;1
/net/per920a/export/das14a/satoh-lab/haolin/nhk/excerpts/2009_06_01_19_00_3.webm;Taro ASO.jpg;6673;6689;8457;222;223;1
/net/per920a/export/das14a/satoh-lab/haolin/nhk/excerpts/2009_06_01_19_00_3.webm;Taro ASO.jpg;6705;6745;8457;223;224;1
/net/per920a/export/das14a/satoh-lab/haolin/nhk/excerpts/2009_06_01_19_00_3.webm;Taro ASO.jpg;6761;6809;8457;225;227;2
/net/per920a/export/das14a/satoh-lab/haolin/nhk/excerpts/2009_06_01_19_00_3.webm;Taro ASO.jpg;6825;6841;8457;227;228;1
/net/per920a/export/das14a/satoh-lab/haolin/nhk/excerpts/2009_06_01_19_00_3.webm;Taro ASO.jpg;6857;6869;8457;228;229;1
/net/per920a/export/das14a/satoh-lab/haolin/nhk/excerpts/2009_06_01_19_00_3.webm;Taro ASO.jpg;6897;7425;8457;229;247;18
/net/per920a/export/das14a/satoh-lab/haolin/nhk/excerpts/2009_06_01_19_00_3.webm;Akihiro OHTA.jpg;2289;2329;8457;76;77;1
/net/per920a/export/das14a/satoh-lab/haolin/nhk/excerpts/2009_06_01_19_00_3.webm;Akihiro OHTA.jpg;2345;2349;8457;78;78;0
/net/per920a/export/das14a/satoh-lab/haolin/nhk/excerpts/2009_06_01_19_00_3.webm;Akihiro OHTA.jpg;2665;2669;8457;88;88;0
/net/per920a/export/das14a/satoh-lab/haolin/nhk/excerpts/2009_06_01_19_00_3.webm;Akihiro OHTA.jpg;2705;2733;8457;90;91;1
/net/per920a/export/das14a/satoh-lab/haolin/nhk/excerpts/2009_06_01_19_00_3.webm;Akihiro OHTA.jpg;2749;2749;8457;91;91;0
/net/per920a/export/das14a/satoh-lab/haolin/nhk/excerpts/2009_06_01_19_00_3.webm;Akihiro OHTA.jpg;2829;2829;8457;94;94;0
/net/per920a/export/das14a/satoh-lab/haolin/nhk/excerpts/2009_06_01_19_00_3.webm;Akihiro OHTA.jpg;2893;2893;8457;96;96;0
/net/per920a/export/das14a/satoh-lab/haolin/nhk/excerpts/2009_06_01_19_00_3.webm;Akihiro OHTA.jpg;3081;3093;8457;102;103;1
/net/per920a/export/das14a/satoh-lab/haolin/nhk/excerpts/2009_06_01_19_00_3.webm;Akihiro OHTA.jpg;3105;3113;8457;103;103;0
/net/per920a/export/das14a/satoh-lab/haolin/nhk/excerpts/2009_06_01_19_00_3.webm;Yoshihiko Noda.jpg;3825;3829;8457;127;127;0
/net/per920a/export/das14a/satoh-lab/haolin/nhk/excerpts/2009_06_01_19_00_3.webm;Yoshihiko Noda.jpg;3841;3845;8457;128;128;0
/net/per920a/export/das14a/satoh-lab/haolin/nhk/excerpts/2009_06_01_19_00_3.webm;Yoshihiko Noda.jpg;3857;3861;8457;128;128;0
/net/per920a/export/das14a/satoh-lab/haolin/nhk/excerpts/2009_06_01_19_00_3.webm;Yoshihiko Noda.jpg;3889;3897;8457;129;129;0
/net/per920a/export/das14a/satoh-lab/haolin/nhk/excerpts/2009_06_01_19_00_3.webm;Yoshihiko Noda.jpg;4045;4045;8457;134;134;0
/net/per920a/export/das14a/satoh-lab/haolin/nhk/excerpts/2009_06_01_19_00_3.webm;Yoshihiko Noda.jpg;4061;4065;8457;135;135;0
/net/per920a/export/das14a/satoh-lab/haolin/nhk/excerpts/2009_06_01_19_00_3.webm;Yoshihiko Noda.jpg;4085;4149;8457;136;138;2
/net/per920a/export/das14a/satoh-lab/haolin/nhk/excerpts/2009_06_01_19_00_3.webm;Yoshihiko Noda.jpg;4165;4165;8457;138;138;0
/net/per920a/export/das14a/satoh-lab/haolin/nhk/excerpts/2009_06_01_19_00_3.webm;Yoshihiko Noda.jpg;4261;4317;8457;142;143;1
/net/per920a/export/das14a/satoh-lab/haolin/nhk/excerpts/2009_06_01_19_00_3.webm;Yoshihiko Noda.jpg;4333;4341;8457;144;144;0
/net/per920a/export/das14a/satoh-lab/haolin/nhk/excerpts/2009_06_01_19_00_3.webm;Yoshihiko Noda.jpg;4357;4385;8457;145;146;1
/net/per920a/export/das14a/satoh-lab/haolin/nhk/excerpts/2009_06_01_19_00_3.webm;Yukio HATOYAMA.jpg;4429;4429;8457;147;147;0
/net/per920a/export/das14a/satoh-lab/haolin/nhk/excerpts/2009_06_01_19_00_3.webm;Yukio HATOYAMA.jpg;4461;4465;8457;148;148;0
/net/per920a/export/das14a/satoh-lab/haolin/nhk/excerpts/2009_06_01_19_00_3.webm;Yukio HATOYAMA.jpg;4477;4537;8457;149;151;2
/net/per920a/export/das14a/satoh-lab/haolin/nhk/excerpts/2009_06_01_19_00_3.webm;Yukio HATOYAMA.jpg;4549;4549;8457;151;151;0
/net/per920a/export/das14a/satoh-lab/haolin/nhk/excerpts/2009_06_01_19_00_3.webm;Yukio HATOYAMA.jpg;4561;4585;8457;152;152;0
/net/per920a/export/das14a/satoh-lab/haolin/nhk/excerpts/2009_06_01_19_00_3.webm;Yukio HATOYAMA.jpg;4605;4605;8457;153;153;0
/net/per920a/export/das14a/satoh-lab/haolin/nhk/excerpts/2009_06_01_19_00_3.webm;Yukio HATOYAMA.jpg;4657;5017;8457;155;167;12
/net/per920a/export/das14a/satoh-lab/haolin/nhk/excerpts/2009_06_04_19_00_3.webm;Taro ASO.jpg;753;761;5341;25;25;0
/net/per920a/export/das14a/satoh-lab/haolin/nhk/excerpts/2009_06_04_19_00_3.webm;Taro ASO.jpg;777;781;5341;25;26;1
/net/per920a/export/das14a/satoh-lab/haolin/nhk/excerpts/2009_06_04_19_00_3.webm;Taro ASO.jpg;801;805;5341;26;26;0
/net/per920a/export/das14a/satoh-lab/haolin/nhk/excerpts/2009_06_04_19_00_3.webm;Taro ASO.jpg;817;817;5341;27;27;0
/net/per920a/export/das14a/satoh-lab/haolin/nhk/excerpts/2009_06_04_19_00_3.webm;Taro ASO.jpg;829;849;5341;27;28;1
/net/per920a/export/das14a/satoh-lab/haolin/nhk/excerpts/2009_06_04_19_00_3.webm;Taro ASO.jpg;865;869;5341;28;28;0
/net/per920a/export/das14a/satoh-lab/haolin/nhk/excerpts/2009_06_04_19_00_3.webm;Taro ASO.jpg;885;885;5341;29;29;0
/net/per920a/export/das14a/satoh-lab/haolin/nhk/excerpts/2009_06_04_19_00_3.webm;Taro ASO.jpg;897;929;5341;29;30;1
/net/per920a/export/das14a/satoh-lab/haolin/nhk/excerpts/2009_06_04_19_00_3.webm;Taro ASO.jpg;1061;1093;5341;35;36;1
/net/per920a/export/das14a/satoh-lab/haolin/nhk/excerpts/2009_06_04_19_00_3.webm;Taro ASO.jpg;1113;1169;5341;37;38;1
/net/per920a/export/das14a/satoh-lab/haolin/nhk/excerpts/2009_06_04_19_00_3.webm;Taro ASO.jpg;1185;1209;5341;39;40;1
/net/per920a/export/das14a/satoh-lab/haolin/nhk/excerpts/2009_06_06_19_00_3.webm;Yukio HATOYAMA.jpg;3433;3537;3541;114;117;3
/net/per920a/export/das14a/satoh-lab/haolin/nhk/excerpts/2009_06_10_19_00_1.webm;Taro ASO.jpg;9;413;1713;0;13;13
/net/per920a/export/das14a/satoh-lab/haolin/nhk/excerpts/2009_06_10_19_00_1.webm;Taro ASO.jpg;573;1401;1713;19;46;27
/net/per920a/export/das14a/satoh-lab/haolin/nhk/excerpts/2009_06_10_19_00_1.webm;Taro ASO.jpg;1437;1709;1713;47;56;9
/net/per920a/export/das14a/satoh-lab/haolin/nhk/excerpts/2009_06_20_19_00_1.webm;Yukio HATOYAMA.jpg;9;665;5765;0;22;22
/net/per920a/export/das14a/satoh-lab/haolin/nhk/excerpts/2009_06_20_19_00_1.webm;Yukio HATOYAMA.jpg;681;845;5765;22;28;6
/net/per920a/export/das14a/satoh-lab/haolin/nhk/excerpts/2009_06_20_19_00_1.webm;Yukio HATOYAMA.jpg;865;901;5765;28;30;2
/net/per920a/export/das14a/satoh-lab/haolin/nhk/excerpts/2009_06_20_19_00_1.webm;Yukio HATOYAMA.jpg;921;977;5765;30;32;2
/net/per920a/export/das14a/satoh-lab/haolin/nhk/excerpts/2009_06_20_19_00_1.webm;Yukio HATOYAMA.jpg;1005;1089;5765;33;36;3
/net/per920a/export/das14a/satoh-lab/haolin/nhk/excerpts/2009_06_20_19_00_1.webm;Yukio HATOYAMA.jpg;1105;1249;5765;36;41;5
/net/per920a/export/das14a/satoh-lab/haolin/nhk/excerpts/2009_06_20_19_00_1.webm;Yukio HATOYAMA.jpg;1265;1265;5765;42;42;0
/net/per920a/export/das14a/satoh-lab/haolin/nhk/excerpts/2009_06_20_19_00_1.webm;Yukio HATOYAMA.jpg;1325;1377;5765;44;45;1
/net/per920a/export/das14a/satoh-lab/haolin/nhk/excerpts/2009_06_20_19_00_1.webm;Yukio HATOYAMA.jpg;1417;1425;5765;47;47;0
/net/per920a/export/das14a/satoh-lab/haolin/nhk/excerpts/2009_06_20_19_00_1.webm;Yukio HATOYAMA.jpg;1445;1481;5765;48;49;1
/net/per920a/export/das14a/satoh-lab/haolin/nhk/excerpts/2009_06_20_19_00_1.webm;Yukio HATOYAMA.jpg;1497;1533;5765;49;51;2
/net/per920a/export/das14a/satoh-lab/haolin/nhk/excerpts/2009_06_20_19_00_1.webm;Yukio HATOYAMA.jpg;1549;1577;5765;51;52;1
/net/per920a/export/das14a/satoh-lab/haolin/nhk/excerpts/2009_06_20_19_00_1.webm;Yukio HATOYAMA.jpg;3465;3465;5765;115;115;0
/net/per920a/export/das14a/satoh-lab/haolin/nhk/excerpts/2009_06_20_19_00_1.webm;Yukio HATOYAMA.jpg;3477;3489;5765;115;116;1
/net/per920a/export/das14a/satoh-lab/haolin/nhk/excerpts/2009_06_20_19_00_1.webm;Yukio HATOYAMA.jpg;3501;3873;5765;116;128;12
/net/per920a/export/das14a/satoh-lab/haolin/nhk/excerpts/2009_06_20_19_00_1.webm;Yukio HATOYAMA.jpg;3889;3901;5765;129;129;0
/net/per920a/export/das14a/satoh-lab/haolin/nhk/excerpts/2009_06_20_19_00_1.webm;Yukio HATOYAMA.jpg;3917;4049;5765;130;134;4
/net/per920a/export/das14a/satoh-lab/haolin/nhk/excerpts/2009_06_20_19_00_1.webm;Yukio HATOYAMA.jpg;4065;4125;5765;135;137;2
/net/per920a/export/das14a/satoh-lab/haolin/nhk/excerpts/2009_06_20_19_00_1.webm;Yukio HATOYAMA.jpg;4157;4421;5765;138;147;9
/net/per920a/export/das14a/satoh-lab/haolin/nhk/excerpts/2009_06_20_19_00_1.webm;Yukio HATOYAMA.jpg;4437;4493;5765;147;149;2
/net/per920a/export/das14a/satoh-lab/haolin/nhk/excerpts/2009_06_20_19_00_1.webm;Yukio HATOYAMA.jpg;4509;4517;5765;150;150;0
/net/per920a/export/das14a/satoh-lab/haolin/nhk/excerpts/2009_06_20_19_00_1.webm;Yukio HATOYAMA.jpg;4605;4673;5765;153;155;2
/net/per920a/export/das14a/satoh-lab/haolin/nhk/excerpts/2009_06_20_19_00_1.webm;Yukio HATOYAMA.jpg;4689;4845;5765;156;161;5
/net/per920a/export/das14a/satoh-lab/haolin/nhk/excerpts/2009_06_20_19_00_1.webm;Taro ASO.jpg;1617;1681;5765;53;55;2
/net/per920a/export/das14a/satoh-lab/haolin/nhk/excerpts/2009_06_20_19_00_1.webm;Taro ASO.jpg;1697;1805;5765;56;60;4
/net/per920a/export/das14a/satoh-lab/haolin/nhk/excerpts/2009_06_20_19_00_1.webm;Taro ASO.jpg;1821;1833;5765;60;61;1
/net/per920a/export/das14a/satoh-lab/haolin/nhk/excerpts/2009_06_20_19_00_1.webm;Taro ASO.jpg;1849;1857;5765;61;61;0
/net/per920a/export/das14a/satoh-lab/haolin/nhk/excerpts/2009_06_20_19_00_1.webm;Taro ASO.jpg;1873;2049;5765;62;68;6
/net/per920a/export/das14a/satoh-lab/haolin/nhk/excerpts/2009_06_20_19_00_1.webm;Taro ASO.jpg;2065;2213;5765;68;73;5
/net/per920a/export/das14a/satoh-lab/haolin/nhk/excerpts/2009_06_20_19_00_1.webm;Taro ASO.jpg;2229;2329;5765;74;77;3
/net/per920a/export/das14a/satoh-lab/haolin/nhk/excerpts/2009_06_20_19_00_1.webm;Taro ASO.jpg;2433;2461;5765;81;81;0
/net/per920a/export/das14a/satoh-lab/haolin/nhk/excerpts/2009_06_20_19_00_1.webm;Taro ASO.jpg;2477;2613;5765;82;87;5
/net/per920a/export/das14a/satoh-lab/haolin/nhk/excerpts/2009_06_20_19_00_1.webm;Katsuya OKADA.jpg;4877;4893;5765;162;162;0
/net/per920a/export/das14a/satoh-lab/haolin/nhk/excerpts/2009_06_20_19_00_1.webm;Katsuya OKADA.jpg;4973;5021;5765;165;167;2
/net/per920a/export/das14a/satoh-lab/haolin/nhk/excerpts/2009_06_20_19_00_1.webm;Katsuya OKADA.jpg;5033;5165;5765;167;172;5
/net/per920a/export/das14a/satoh-lab/haolin/nhk/excerpts/2009_06_20_19_00_1.webm;Katsuya OKADA.jpg;5181;5213;5765;172;173;1
/net/per920a/export/das14a/satoh-lab/haolin/nhk/excerpts/2009_06_20_19_00_1.webm;Katsuya OKADA.jpg;5233;5529;5765;174;184;10
/net/per920a/export/das14a/satoh-lab/haolin/nhk/excerpts/2009_06_20_19_00_1.webm;Katsuya OKADA.jpg;5545;5645;5765;184;188;4
/net/per920a/export/das14a/satoh-lab/haolin/nhk/excerpts/2009_06_20_19_00_1.webm;Katsuya OKADA.jpg;5661;5661;5765;188;188;0
/net/per920a/export/das14a/satoh-lab/haolin/nhk/excerpts/2009_06_20_19_00_1.webm;Katsuya OKADA.jpg;5685;5761;5765;189;191;2
/net/per920a/export/das14a/satoh-lab/haolin/nhk/excerpts/2009_06_27_19_00_1.webm;Taro ASO.jpg;9;25;7953;0;0;0
/net/per920a/export/das14a/satoh-lab/haolin/nhk/excerpts/2009_06_27_19_00_1.webm;Taro ASO.jpg;49;53;7953;1;1;0
/net/per920a/export/das14a/satoh-lab/haolin/nhk/excerpts/2009_06_27_19_00_1.webm;Taro ASO.jpg;65;65;7953;2;2;0
/net/per920a/export/das14a/satoh-lab/haolin/nhk/excerpts/2009_06_27_19_00_1.webm;Taro ASO.jpg;89;701;7953;2;23;21
/net/per920a/export/das14a/satoh-lab/haolin/nhk/excerpts/2009_06_27_19_00_1.webm;Yukio HATOYAMA.jpg;5473;5477;7953;182;182;0
/net/per920a/export/das14a/satoh-lab/haolin/nhk/excerpts/2009_06_27_19_00_1.webm;Yukio HATOYAMA.jpg;5489;5517;7953;182;183;1
/net/per920a/export/das14a/satoh-lab/haolin/nhk/excerpts/2009_06_27_19_00_1.webm;Yukio HATOYAMA.jpg;5533;5929;7953;184;197;13
/net/per920a/export/das14a/satoh-lab/haolin/nhk/excerpts/2009_06_27_19_00_1.webm;Yukio HATOYAMA.jpg;5941;6769;7953;197;225;28
/net/per920a/export/das14a/satoh-lab/haolin/nhk/excerpts/2009_06_27_19_00_1.webm;Yukio HATOYAMA.jpg;6785;6845;7953;226;228;2
/net/per920a/export/das14a/satoh-lab/haolin/nhk/excerpts/2009_06_27_19_00_1.webm;Yukio HATOYAMA.jpg;6861;7417;7953;228;247;19
/net/per920a/export/das14a/satoh-lab/haolin/nhk/excerpts/2009_06_27_19_00_1.webm;Yukio HATOYAMA.jpg;7433;7449;7953;247;248;1
/net/per920a/export/das14a/satoh-lab/haolin/nhk/excerpts/2009_06_27_19_00_1.webm;Yukio HATOYAMA.jpg;7465;7509;7953;248;250;2
/net/per920a/export/das14a/satoh-lab/haolin/nhk/excerpts/2009_06_27_19_00_1.webm;Yukio HATOYAMA.jpg;7525;7581;7953;250;252;2
/net/per920a/export/das14a/satoh-lab/haolin/nhk/excerpts/2009_06_27_19_00_1.webm;Yukio HATOYAMA.jpg;7601;7605;7953;253;253;0
/net/per920a/export/das14a/satoh-lab/haolin/nhk/excerpts/2009_06_27_19_00_1.webm;Yukio HATOYAMA.jpg;7645;7737;7953;254;257;3
/net/per920a/export/das14a/satoh-lab/haolin/nhk/excerpts/2009_06_27_19_00_1.webm;Yukio HATOYAMA.jpg;7753;7801;7953;258;259;1
/net/per920a/export/das14a/satoh-lab/haolin/nhk/excerpts/2009_06_27_19_00_1.webm;Yukio HATOYAMA.jpg;7829;7837;7953;260;261;1
/net/per920a/export/das14a/satoh-lab/haolin/nhk/excerpts/2009_06_27_19_00_1.webm;Yukio HATOYAMA.jpg;7853;7905;7953;261;263;2
/net/per920a/export/das14a/satoh-lab/haolin/nhk/excerpts/2009_07_21_19_00_2.webm;Natsuo YAMAGUCHI.jpg;517;525;3929;17;17;0
/net/per920a/export/das14a/satoh-lab/haolin/nhk/excerpts/2009_07_21_19_00_2.webm;Natsuo YAMAGUCHI.jpg;537;545;3929;17;18;1
/net/per920a/export/das14a/satoh-lab/haolin/nhk/excerpts/2009_07_21_19_00_2.webm;Natsuo YAMAGUCHI.jpg;561;561;3929;18;18;0
/net/per920a/export/das14a/satoh-lab/haolin/nhk/excerpts/2009_07_21_19_00_2.webm;Natsuo YAMAGUCHI.jpg;585;585;3929;19;19;0
/net/per920a/export/das14a/satoh-lab/haolin/nhk/excerpts/2009_07_21_19_00_2.webm;Natsuo YAMAGUCHI.jpg;609;621;3929;20;20;0
/net/per920a/export/das14a/satoh-lab/haolin/nhk/excerpts/2009_07_21_19_00_2.webm;Natsuo YAMAGUCHI.jpg;665;665;3929;22;22;0
/net/per920a/export/das14a/satoh-lab/haolin/nhk/excerpts/2009_07_21_19_00_2.webm;Natsuo YAMAGUCHI.jpg;681;713;3929;22;23;1
/net/per920a/export/das14a/satoh-lab/haolin/nhk/excerpts/2009_07_21_19_00_2.webm;Natsuo YAMAGUCHI.jpg;729;733;3929;24;24;0
/net/per920a/export/das14a/satoh-lab/haolin/nhk/excerpts/2009_07_21_19_00_2.webm;Natsuo YAMAGUCHI.jpg;753;773;3929;25;25;0
/net/per920a/export/das14a/satoh-lab/haolin/nhk/excerpts/2009_07_21_19_00_2.webm;Yukio HATOYAMA.jpg;1145;1317;3929;38;43;5
/net/per920a/export/das14a/satoh-lab/haolin/nhk/excerpts/2009_07_21_19_00_2.webm;Yukio HATOYAMA.jpg;1337;1337;3929;44;44;0
/net/per920a/export/das14a/satoh-lab/haolin/nhk/excerpts/2009_07_21_19_00_2.webm;Yukio HATOYAMA.jpg;1353;1377;3929;45;45;0
/net/per920a/export/das14a/satoh-lab/haolin/nhk/excerpts/2009_07_21_19_00_2.webm;Yukio HATOYAMA.jpg;1405;1413;3929;46;47;1
/net/per920a/export/das14a/satoh-lab/haolin/nhk/excerpts/2009_07_21_19_00_2.webm;Yukio HATOYAMA.jpg;1457;1457;3929;48;48;0
/net/per920a/export/das14a/satoh-lab/haolin/nhk/excerpts/2009_07_21_19_00_2.webm;Yukio HATOYAMA.jpg;1537;1541;3929;51;51;0
/net/per920a/export/das14a/satoh-lab/haolin/nhk/excerpts/2009_07_21_19_00_2.webm;Yukio HATOYAMA.jpg;1553;1561;3929;51;52;1
/net/per920a/export/das14a/satoh-lab/haolin/nhk/excerpts/2009_07_21_19_00_2.webm;Yukio HATOYAMA.jpg;1577;1593;3929;52;53;1
/net/per920a/export/das14a/satoh-lab/haolin/nhk/excerpts/2009_07_21_19_00_2.webm;Yukio HATOYAMA.jpg;1609;1685;3929;53;56;3
/net/per920a/export/das14a/satoh-lab/haolin/nhk/excerpts/2009_07_21_19_00_2.webm;Yukio HATOYAMA.jpg;1733;1737;3929;57;57;0
/net/per920a/export/das14a/satoh-lab/haolin/nhk/excerpts/2009_07_21_19_00_2.webm;Yukio HATOYAMA.jpg;1749;1749;3929;58;58;0
/net/per920a/export/das14a/satoh-lab/haolin/nhk/excerpts/2009_07_21_19_00_2.webm;Yukio HATOYAMA.jpg;1761;1761;3929;58;58;0
/net/per920a/export/das14a/satoh-lab/haolin/nhk/excerpts/2009_07_21_19_00_2.webm;Yukio HATOYAMA.jpg;1793;1793;3929;59;59;0
/net/per920a/export/das14a/satoh-lab/haolin/nhk/excerpts/2009_07_21_19_00_2.webm;Yukio HATOYAMA.jpg;1989;1989;3929;66;66;0
/net/per920a/export/das14a/satoh-lab/haolin/nhk/excerpts/2009_07_21_19_00_2.webm;Yukio HATOYAMA.jpg;2005;2029;3929;66;67;1
/net/per920a/export/das14a/satoh-lab/haolin/nhk/excerpts/2009_07_21_19_00_2.webm;Yukio HATOYAMA.jpg;3741;3769;3929;124;125;1
/net/per920a/export/das14a/satoh-lab/haolin/nhk/excerpts/2009_07_21_19_00_2.webm;Taro ASO.jpg;3473;3565;3929;115;118;3
/net/per920a/export/das14a/satoh-lab/haolin/nhk/excerpts/2009_07_21_19_00_2.webm;Taro ASO.jpg;3581;3653;3929;119;121;2
/net/per920a/export/das14a/satoh-lab/haolin/nhk/excerpts/2009_08_18_19_00_1.webm;Taro ASO.jpg;137;237;5725;4;7;3
/net/per920a/export/das14a/satoh-lab/haolin/nhk/excerpts/2009_08_18_19_00_1.webm;Taro ASO.jpg;253;253;5725;8;8;0
/net/per920a/export/das14a/satoh-lab/haolin/nhk/excerpts/2009_08_18_19_00_1.webm;Taro ASO.jpg;397;409;5725;13;13;0
/net/per920a/export/das14a/satoh-lab/haolin/nhk/excerpts/2009_08_18_19_00_1.webm;Taro ASO.jpg;421;453;5725;14;15;1
/net/per920a/export/das14a/satoh-lab/haolin/nhk/excerpts/2009_08_18_19_00_1.webm;Taro ASO.jpg;649;857;5725;21;28;7
/net/per920a/export/das14a/satoh-lab/haolin/nhk/excerpts/2009_08_18_19_00_1.webm;Taro ASO.jpg;869;905;5725;28;30;2
/net/per920a/export/das14a/satoh-lab/haolin/nhk/excerpts/2009_08_18_19_00_1.webm;Taro ASO.jpg;917;985;5725;30;32;2
/net/per920a/export/das14a/satoh-lab/haolin/nhk/excerpts/2009_08_18_19_00_1.webm;Taro ASO.jpg;1061;1105;5725;35;36;1
/net/per920a/export/das14a/satoh-lab/haolin/nhk/excerpts/2009_08_18_19_00_1.webm;Taro ASO.jpg;1417;1425;5725;47;47;0
/net/per920a/export/das14a/satoh-lab/haolin/nhk/excerpts/2009_08_18_19_00_1.webm;Taro ASO.jpg;1469;1545;5725;49;51;2
/net/per920a/export/das14a/satoh-lab/haolin/nhk/excerpts/2009_08_18_19_00_1.webm;Taro ASO.jpg;1785;1785;5725;59;59;0
/net/per920a/export/das14a/satoh-lab/haolin/nhk/excerpts/2009_08_18_19_00_1.webm;Taro ASO.jpg;1797;1821;5725;59;60;1
/net/per920a/export/das14a/satoh-lab/haolin/nhk/excerpts/2009_08_18_19_00_1.webm;Taro ASO.jpg;1865;1885;5725;62;62;0
/net/per920a/export/das14a/satoh-lab/haolin/nhk/excerpts/2009_08_18_19_00_1.webm;Taro ASO.jpg;1945;1953;5725;64;65;1
/net/per920a/export/das14a/satoh-lab/haolin/nhk/excerpts/2009_08_18_19_00_1.webm;Yukio HATOYAMA.jpg;2369;2565;5725;79;85;6
/net/per920a/export/das14a/satoh-lab/haolin/nhk/excerpts/2009_08_18_19_00_1.webm;Yukio HATOYAMA.jpg;2829;2833;5725;94;94;0
/net/per920a/export/das14a/satoh-lab/haolin/nhk/excerpts/2009_08_18_19_00_1.webm;Yukio HATOYAMA.jpg;2853;2853;5725;95;95;0
/net/per920a/export/das14a/satoh-lab/haolin/nhk/excerpts/2009_08_18_19_00_1.webm;Yukio HATOYAMA.jpg;2869;2877;5725;95;95;0
/net/per920a/export/das14a/satoh-lab/haolin/nhk/excerpts/2009_08_18_19_00_1.webm;Yukio HATOYAMA.jpg;3149;3177;5725;105;105;0
/net/per920a/export/das14a/satoh-lab/haolin/nhk/excerpts/2009_08_18_19_00_1.webm;Yukio HATOYAMA.jpg;3325;3325;5725;110;110;0
/net/per920a/export/das14a/satoh-lab/haolin/nhk/excerpts/2009_08_18_19_00_1.webm;Yukio HATOYAMA.jpg;3337;3529;5725;111;117;6
/net/per920a/export/das14a/satoh-lab/haolin/nhk/excerpts/2009_08_18_19_00_1.webm;Kazuo SHII.jpg;5677;5721;5725;189;190;1
/net/per920a/export/das14a/satoh-lab/haolin/nhk/excerpts/2009_09_01_19_00_1.webm;Yukio HATOYAMA.jpg;781;897;16941;26;29;3
/net/per920a/export/das14a/satoh-lab/haolin/nhk/excerpts/2009_09_01_19_00_1.webm;Yukio HATOYAMA.jpg;1281;1313;16941;42;43;1
/net/per920a/export/das14a/satoh-lab/haolin/nhk/excerpts/2009_09_01_19_00_1.webm;Yukio HATOYAMA.jpg;1329;1341;16941;44;44;0
/net/per920a/export/das14a/satoh-lab/haolin/nhk/excerpts/2009_09_01_19_00_1.webm;Yukio HATOYAMA.jpg;7877;8065;16941;262;268;6
/net/per920a/export/das14a/satoh-lab/haolin/nhk/excerpts/2009_09_01_19_00_1.webm;Yukio HATOYAMA.jpg;8081;8129;16941;269;271;2
/net/per920a/export/das14a/satoh-lab/haolin/nhk/excerpts/2009_09_01_19_00_1.webm;Yukio HATOYAMA.jpg;8145;8181;16941;271;272;1
/net/per920a/export/das14a/satoh-lab/haolin/nhk/excerpts/2009_09_01_19_00_1.webm;Yukio HATOYAMA.jpg;8201;8261;16941;273;275;2
/net/per920a/export/das14a/satoh-lab/haolin/nhk/excerpts/2009_09_01_19_00_1.webm;Yukio HATOYAMA.jpg;8285;8325;16941;276;277;1
/net/per920a/export/das14a/satoh-lab/haolin/nhk/excerpts/2009_09_01_19_00_1.webm;Yukio HATOYAMA.jpg;8353;8365;16941;278;278;0
/net/per920a/export/das14a/satoh-lab/haolin/nhk/excerpts/2009_09_01_19_00_1.webm;Yukio HATOYAMA.jpg;8377;8397;16941;279;280;1
/net/per920a/export/das14a/satoh-lab/haolin/nhk/excerpts/2009_09_01_19_00_1.webm;Yukio HATOYAMA.jpg;8473;8569;16941;282;285;3
/net/per920a/export/das14a/satoh-lab/haolin/nhk/excerpts/2009_09_01_19_00_1.webm;Yukio HATOYAMA.jpg;8581;8645;16941;286;288;2
/net/per920a/export/das14a/satoh-lab/haolin/nhk/excerpts/2009_09_01_19_00_1.webm;Yukio HATOYAMA.jpg;8661;8665;16941;288;288;0
/net/per920a/export/das14a/satoh-lab/haolin/nhk/excerpts/2009_09_01_19_00_1.webm;Yukio HATOYAMA.jpg;8681;8681;16941;289;289;0
/net/per920a/export/das14a/satoh-lab/haolin/nhk/excerpts/2009_09_01_19_00_1.webm;Yukio HATOYAMA.jpg;8701;8745;16941;290;291;1
/net/per920a/export/das14a/satoh-lab/haolin/nhk/excerpts/2009_09_01_19_00_1.webm;Yukio HATOYAMA.jpg;8761;8769;16941;292;292;0
/net/per920a/export/das14a/satoh-lab/haolin/nhk/excerpts/2009_09_01_19_00_1.webm;Yukio HATOYAMA.jpg;8781;8781;16941;292;292;0
/net/per920a/export/das14a/satoh-lab/haolin/nhk/excerpts/2009_09_01_19_00_1.webm;Yukio HATOYAMA.jpg;8805;8841;16941;293;294;1
/net/per920a/export/das14a/satoh-lab/haolin/nhk/excerpts/2009_09_01_19_00_1.webm;Yukio HATOYAMA.jpg;8857;9013;16941;295;300;5
/net/per920a/export/das14a/satoh-lab/haolin/nhk/excerpts/2009_09_01_19_00_1.webm;Yukio HATOYAMA.jpg;9045;9097;16941;301;303;2
/net/per920a/export/das14a/satoh-lab/haolin/nhk/excerpts/2009_09_01_19_00_1.webm;Yukio HATOYAMA.jpg;9133;9241;16941;304;308;4
/net/per920a/export/das14a/satoh-lab/haolin/nhk/excerpts/2009_09_01_19_00_1.webm;Yukio HATOYAMA.jpg;9257;9297;16941;308;310;2
/net/per920a/export/das14a/satoh-lab/haolin/nhk/excerpts/2009_09_01_19_00_1.webm;Yukio HATOYAMA.jpg;9313;9365;16941;310;312;2
/net/per920a/export/das14a/satoh-lab/haolin/nhk/excerpts/2009_09_01_19_00_1.webm;Yukio HATOYAMA.jpg;9405;9413;16941;313;313;0
/net/per920a/export/das14a/satoh-lab/haolin/nhk/excerpts/2009_09_01_19_00_1.webm;Yukio HATOYAMA.jpg;9429;9485;16941;314;316;2
/net/per920a/export/das14a/satoh-lab/haolin/nhk/excerpts/2009_09_01_19_00_1.webm;Yukio HATOYAMA.jpg;10877;10881;16941;362;362;0
/net/per920a/export/das14a/satoh-lab/haolin/nhk/excerpts/2009_09_01_19_00_1.webm;Yukio HATOYAMA.jpg;10905;10905;16941;363;363;0
/net/per920a/export/das14a/satoh-lab/haolin/nhk/excerpts/2009_09_01_19_00_1.webm;Yukio HATOYAMA.jpg;10917;10921;16941;364;364;0
/net/per920a/export/das14a/satoh-lab/haolin/nhk/excerpts/2009_09_01_19_00_1.webm;Yukio HATOYAMA.jpg;10949;10953;16941;365;365;0
/net/per920a/export/das14a/satoh-lab/haolin/nhk/excerpts/2009_09_01_19_00_1.webm;Shizuka KAMEI.jpg;1353;1381;16941;45;46;1
/net/per920a/export/das14a/satoh-lab/haolin/nhk/excerpts/2009_09_01_19_00_1.webm;Shizuka KAMEI.jpg;1413;1441;16941;47;48;1
/net/per920a/export/das14a/satoh-lab/haolin/nhk/excerpts/2009_09_01_19_00_1.webm;Shizuka KAMEI.jpg;1713;1749;16941;57;58;1
/net/per920a/export/das14a/satoh-lab/haolin/nhk/excerpts/2009_09_01_19_00_1.webm;Shizuka KAMEI.jpg;1769;1817;16941;58;60;2
/net/per920a/export/das14a/satoh-lab/haolin/nhk/excerpts/2009_09_01_19_00_1.webm;Shizuka KAMEI.jpg;1833;1961;16941;61;65;4
/net/per920a/export/das14a/satoh-lab/haolin/nhk/excerpts/2009_09_01_19_00_1.webm;Shizuka KAMEI.jpg;2241;2253;16941;74;75;1
/net/per920a/export/das14a/satoh-lab/haolin/nhk/excerpts/2009_09_01_19_00_1.webm;Shizuka KAMEI.jpg;2269;2329;16941;75;77;2
/net/per920a/export/das14a/satoh-lab/haolin/nhk/excerpts/2009_09_01_19_00_1.webm;Shizuka KAMEI.jpg;2345;2357;16941;78;78;0
/net/per920a/export/das14a/satoh-lab/haolin/nhk/excerpts/2009_09_01_19_00_1.webm;Shizuka KAMEI.jpg;2373;2385;16941;79;79;0
/net/per920a/export/das14a/satoh-lab/haolin/nhk/excerpts/2009_09_01_19_00_1.webm;Shizuka KAMEI.jpg;2797;2797;16941;93;93;0
/net/per920a/export/das14a/satoh-lab/haolin/nhk/excerpts/2009_09_01_19_00_1.webm;Shizuka KAMEI.jpg;3233;3261;16941;107;108;1
/net/per920a/export/das14a/satoh-lab/haolin/nhk/excerpts/2009_09_01_19_00_1.webm;Shizuka KAMEI.jpg;3653;3657;16941;121;121;0
/net/per920a/export/das14a/satoh-lab/haolin/nhk/excerpts/2009_09_01_19_00_1.webm;Shizuka KAMEI.jpg;3677;3681;16941;122;122;0
/net/per920a/export/das14a/satoh-lab/haolin/nhk/excerpts/2009_09_01_19_00_1.webm;Shizuka KAMEI.jpg;3717;3773;16941;123;125;2
/net/per920a/export/das14a/satoh-lab/haolin/nhk/excerpts/2009_09_01_19_00_1.webm;Shizuka KAMEI.jpg;3925;3949;16941;130;131;1
/net/per920a/export/das14a/satoh-lab/haolin/nhk/excerpts/2009_09_01_19_00_1.webm;Shizuka KAMEI.jpg;3981;3985;16941;132;132;0
/net/per920a/export/das14a/satoh-lab/haolin/nhk/excerpts/2009_09_01_19_00_1.webm;Shizuka KAMEI.jpg;4001;4021;16941;133;134;1
/net/per920a/export/das14a/satoh-lab/haolin/nhk/excerpts/2009_09_01_19_00_1.webm;Shizuka KAMEI.jpg;4037;4037;16941;134;134;0
/net/per920a/export/das14a/satoh-lab/haolin/nhk/excerpts/2009_09_01_19_00_1.webm;Shizuka KAMEI.jpg;4109;4109;16941;137;137;0
/net/per920a/export/das14a/satoh-lab/haolin/nhk/excerpts/2009_09_01_19_00_1.webm;Shizuka KAMEI.jpg;15425;15429;16941;514;514;0
/net/per920a/export/das14a/satoh-lab/haolin/nhk/excerpts/2009_09_01_19_00_1.webm;Shizuka KAMEI.jpg;15449;15497;16941;515;516;1
/net/per920a/export/das14a/satoh-lab/haolin/nhk/excerpts/2009_09_01_19_00_1.webm;Shizuka KAMEI.jpg;15513;15565;16941;517;519;2
/net/per920a/export/das14a/satoh-lab/haolin/nhk/excerpts/2009_09_01_19_00_1.webm;Shizuka KAMEI.jpg;15601;15609;16941;520;520;0
/net/per920a/export/das14a/satoh-lab/haolin/nhk/excerpts/2009_09_01_19_00_1.webm;Shizuka KAMEI.jpg;15625;15649;16941;521;521;0
/net/per920a/export/das14a/satoh-lab/haolin/nhk/excerpts/2009_09_01_19_00_1.webm;Shizuka KAMEI.jpg;15661;15681;16941;522;522;0
/net/per920a/export/das14a/satoh-lab/haolin/nhk/excerpts/2009_09_01_19_00_1.webm;Shizuka KAMEI.jpg;15697;15765;16941;523;525;2
/net/per920a/export/das14a/satoh-lab/haolin/nhk/excerpts/2009_09_01_19_00_1.webm;Shizuka KAMEI.jpg;15785;15821;16941;526;527;1
/net/per920a/export/das14a/satoh-lab/haolin/nhk/excerpts/2009_09_01_19_00_1.webm;Mizuho FUKUSHIMA.jpg;4429;4721;16941;147;157;10
/net/per920a/export/das14a/satoh-lab/haolin/nhk/excerpts/2009_09_01_19_00_1.webm;Yoshihiko Noda.jpg;5857;5861;16941;195;195;0
/net/per920a/export/das14a/satoh-lab/haolin/nhk/excerpts/2009_09_01_19_00_1.webm;Yoshihiko Noda.jpg;5885;5885;16941;196;196;0
/net/per920a/export/das14a/satoh-lab/haolin/nhk/excerpts/2009_09_01_19_00_1.webm;Yoshihiko Noda.jpg;5989;6013;16941;199;200;1
/net/per920a/export/das14a/satoh-lab/haolin/nhk/excerpts/2009_09_01_19_00_1.webm;Yoshihiko Noda.jpg;6029;6733;16941;201;224;23
/net/per920a/export/das14a/satoh-lab/haolin/nhk/excerpts/2009_09_01_19_00_1.webm;Yoshihiko Noda.jpg;13725;13729;16941;457;457;0
/net/per920a/export/das14a/satoh-lab/haolin/nhk/excerpts/2009_09_01_19_00_1.webm;Yoshihiko Noda.jpg;13741;13745;16941;458;458;0
/net/per920a/export/das14a/satoh-lab/haolin/nhk/excerpts/2009_09_01_19_00_1.webm;Yoshihiko Noda.jpg;13837;13849;16941;461;461;0
/net/per920a/export/das14a/satoh-lab/haolin/nhk/excerpts/2009_09_01_19_00_1.webm;Taro ASO.jpg;10965;11049;16941;365;368;3
/net/per920a/export/das14a/satoh-lab/haolin/nhk/excerpts/2009_09_01_19_00_1.webm;Taro ASO.jpg;11065;11421;16941;369;380;11
/net/per920a/export/das14a/satoh-lab/haolin/nhk/excerpts/2009_09_01_19_00_1.webm;Taro ASO.jpg;11437;11693;16941;381;389;8
/net/per920a/export/das14a/satoh-lab/haolin/nhk/excerpts/2009_09_06_19_00_1.webm;Yukio HATOYAMA.jpg;9;765;10825;0;25;25
/net/per920a/export/das14a/satoh-lab/haolin/nhk/excerpts/2009_09_06_19_00_1.webm;Yukio HATOYAMA.jpg;2289;2289;10825;76;76;0
/net/per920a/export/das14a/satoh-lab/haolin/nhk/excerpts/2009_09_06_19_00_1.webm;Yukio HATOYAMA.jpg;2313;2313;10825;77;77;0
/net/per920a/export/das14a/satoh-lab/haolin/nhk/excerpts/2009_09_06_19_00_1.webm;Yukio HATOYAMA.jpg;2325;2325;10825;77;77;0
/net/per920a/export/das14a/satoh-lab/haolin/nhk/excerpts/2009_09_06_19_00_1.webm;Yukio HATOYAMA.jpg;2349;2349;10825;78;78;0
/net/per920a/export/das14a/satoh-lab/haolin/nhk/excerpts/2009_09_06_19_00_1.webm;Yukio HATOYAMA.jpg;2369;2369;10825;79;79;0
/net/per920a/export/das14a/satoh-lab/haolin/nhk/excerpts/2009_09_06_19_00_1.webm;Yukio HATOYAMA.jpg;2781;2781;10825;92;92;0
/net/per920a/export/das14a/satoh-lab/haolin/nhk/excerpts/2009_09_06_19_00_1.webm;Yukio HATOYAMA.jpg;2797;2805;10825;93;93;0
/net/per920a/export/das14a/satoh-lab/haolin/nhk/excerpts/2009_09_06_19_00_1.webm;Yukio HATOYAMA.jpg;2877;2877;10825;95;95;0
/net/per920a/export/das14a/satoh-lab/haolin/nhk/excerpts/2009_09_06_19_00_1.webm;Yukio HATOYAMA.jpg;2901;2929;10825;96;97;1
/net/per920a/export/das14a/satoh-lab/haolin/nhk/excerpts/2009_09_06_19_00_1.webm;Yukio HATOYAMA.jpg;3057;3077;10825;101;102;1
/net/per920a/export/das14a/satoh-lab/haolin/nhk/excerpts/2009_09_06_19_00_1.webm;Yukio HATOYAMA.jpg;3109;3109;10825;103;103;0
/net/per920a/export/das14a/satoh-lab/haolin/nhk/excerpts/2009_09_06_19_00_1.webm;Yukio HATOYAMA.jpg;3121;3125;10825;104;104;0
/net/per920a/export/das14a/satoh-lab/haolin/nhk/excerpts/2009_09_06_19_00_1.webm;Yukio HATOYAMA.jpg;3145;3145;10825;104;104;0
/net/per920a/export/das14a/satoh-lab/haolin/nhk/excerpts/2009_09_06_19_00_1.webm;Yukio HATOYAMA.jpg;3169;3169;10825;105;105;0
/net/per920a/export/das14a/satoh-lab/haolin/nhk/excerpts/2009_09_06_19_00_1.webm;Yukio HATOYAMA.jpg;3201;3201;10825;106;106;0
/net/per920a/export/das14a/satoh-lab/haolin/nhk/excerpts/2009_09_06_19_00_1.webm;Yukio HATOYAMA.jpg;3221;3221;10825;107;107;0
/net/per920a/export/das14a/satoh-lab/haolin/nhk/excerpts/2009_09_06_19_00_1.webm;Yukio HATOYAMA.jpg;3257;3277;10825;108;109;1
/net/per920a/export/das14a/satoh-lab/haolin/nhk/excerpts/2009_09_06_19_00_1.webm;Yukio HATOYAMA.jpg;3449;3449;10825;115;115;0
/net/per920a/export/das14a/satoh-lab/haolin/nhk/excerpts/2009_09_06_19_00_1.webm;Yukio HATOYAMA.jpg;3477;3481;10825;115;116;1
/net/per920a/export/das14a/satoh-lab/haolin/nhk/excerpts/2009_09_06_19_00_1.webm;Yukio HATOYAMA.jpg;3501;3509;10825;116;117;1
/net/per920a/export/das14a/satoh-lab/haolin/nhk/excerpts/2009_09_06_19_00_1.webm;Yukio HATOYAMA.jpg;3573;3585;10825;119;119;0
/net/per920a/export/das14a/satoh-lab/haolin/nhk/excerpts/2009_09_06_19_00_1.webm;Yukio HATOYAMA.jpg;3641;3677;10825;121;122;1
/net/per920a/export/das14a/satoh-lab/haolin/nhk/excerpts/2009_09_06_19_00_1.webm;Yukio HATOYAMA.jpg;3721;3721;10825;124;124;0
/net/per920a/export/das14a/satoh-lab/haolin/nhk/excerpts/2009_09_06_19_00_1.webm;Yukio HATOYAMA.jpg;3733;3741;10825;124;124;0
/net/per920a/export/das14a/satoh-lab/haolin/nhk/excerpts/2009_09_06_19_00_1.webm;Yukio HATOYAMA.jpg;3793;3801;10825;126;126;0
/net/per920a/export/das14a/satoh-lab/haolin/nhk/excerpts/2009_09_06_19_00_1.webm;Yukio HATOYAMA.jpg;3841;3841;10825;128;128;0
/net/per920a/export/das14a/satoh-lab/haolin/nhk/excerpts/2009_09_06_19_00_1.webm;Yukio HATOYAMA.jpg;3853;3865;10825;128;128;0
/net/per920a/export/das14a/satoh-lab/haolin/nhk/excerpts/2009_09_06_19_00_1.webm;Yukio HATOYAMA.jpg;3893;3893;10825;129;129;0
/net/per920a/export/das14a/satoh-lab/haolin/nhk/excerpts/2009_09_06_19_00_1.webm;Yukio HATOYAMA.jpg;3933;3937;10825;131;131;0
/net/per920a/export/das14a/satoh-lab/haolin/nhk/excerpts/2009_09_06_19_00_1.webm;Yukio HATOYAMA.jpg;6417;6417;10825;213;213;0
/net/per920a/export/das14a/satoh-lab/haolin/nhk/excerpts/2009_09_06_19_00_1.webm;Yukio HATOYAMA.jpg;6573;6585;10825;219;219;0
/net/per920a/export/das14a/satoh-lab/haolin/nhk/excerpts/2009_09_06_19_00_1.webm;Yukio HATOYAMA.jpg;6597;6641;10825;220;221;1
/net/per920a/export/das14a/satoh-lab/haolin/nhk/excerpts/2009_09_06_19_00_1.webm;Yukio HATOYAMA.jpg;6701;6721;10825;223;224;1
/net/per920a/export/das14a/satoh-lab/haolin/nhk/excerpts/2009_09_06_19_00_1.webm;Yukio HATOYAMA.jpg;6825;6853;10825;227;228;1
/net/per920a/export/das14a/satoh-lab/haolin/nhk/excerpts/2009_09_06_19_00_1.webm;Yukio HATOYAMA.jpg;6961;6977;10825;232;232;0
/net/per920a/export/das14a/satoh-lab/haolin/nhk/excerpts/2009_09_06_19_00_1.webm;Yukio HATOYAMA.jpg;9257;9281;10825;308;309;1
/net/per920a/export/das14a/satoh-lab/haolin/nhk/excerpts/2009_09_06_19_00_1.webm;Yukio HATOYAMA.jpg;9297;9337;10825;310;311;1
/net/per920a/export/das14a/satoh-lab/haolin/nhk/excerpts/2009_09_06_19_00_1.webm;Naoto KAN.jpg;7285;7285;10825;242;242;0
/net/per920a/export/das14a/satoh-lab/haolin/nhk/excerpts/2009_09_06_19_00_1.webm;Naoto KAN.jpg;7317;7393;10825;244;246;2
/net/per920a/export/das14a/satoh-lab/haolin/nhk/excerpts/2009_09_06_19_00_1.webm;Naoto KAN.jpg;7409;7457;10825;247;248;1
/net/per920a/export/das14a/satoh-lab/haolin/nhk/excerpts/2009_09_06_19_00_1.webm;Naoto KAN.jpg;7497;7505;10825;250;250;0
/net/per920a/export/das14a/satoh-lab/haolin/nhk/excerpts/2009_09_06_19_00_1.webm;Naoto KAN.jpg;7605;7793;10825;253;259;6
/net/per920a/export/das14a/satoh-lab/haolin/nhk/excerpts/2009_09_06_19_00_1.webm;Ichiro OZAWA.jpg;7917;8205;10825;264;273;9
/net/per920a/export/das14a/satoh-lab/haolin/nhk/excerpts/2009_09_06_19_00_1.webm;Mizuho FUKUSHIMA.jpg;9713;9741;10825;323;324;1
/net/per920a/export/das14a/satoh-lab/haolin/nhk/excerpts/2009_09_06_19_00_1.webm;Mizuho FUKUSHIMA.jpg;9757;9817;10825;325;327;2
/net/per920a/export/das14a/satoh-lab/haolin/nhk/excerpts/2009_09_06_19_00_1.webm;Mizuho FUKUSHIMA.jpg;9833;9841;10825;327;328;1
/net/per920a/export/das14a/satoh-lab/haolin/nhk/excerpts/2009_09_06_19_00_1.webm;Shizuka KAMEI.jpg;10293;10301;10825;343;343;0
/net/per920a/export/das14a/satoh-lab/haolin/nhk/excerpts/2009_09_06_19_00_1.webm;Shizuka KAMEI.jpg;10333;10361;10825;344;345;1
/net/per920a/export/das14a/satoh-lab/haolin/nhk/excerpts/2009_09_06_19_00_1.webm;Shizuka KAMEI.jpg;10373;10393;10825;345;346;1
/net/per920a/export/das14a/satoh-lab/haolin/nhk/excerpts/2009_09_15_19_00_3.webm;Naoto KAN.jpg;9;21;9481;0;0;0
/net/per920a/export/das14a/satoh-lab/haolin/nhk/excerpts/2009_09_15_19_00_3.webm;Naoto KAN.jpg;7669;7721;9481;255;257;2
/net/per920a/export/das14a/satoh-lab/haolin/nhk/excerpts/2009_09_15_19_00_3.webm;Naoto KAN.jpg;7761;7877;9481;258;262;4
/net/per920a/export/das14a/satoh-lab/haolin/nhk/excerpts/2009_09_15_19_00_3.webm;Naoto KAN.jpg;7893;7993;9481;263;266;3
/net/per920a/export/das14a/satoh-lab/haolin/nhk/excerpts/2009_09_15_19_00_3.webm;Naoto KAN.jpg;8237;8321;9481;274;277;3
/net/per920a/export/das14a/satoh-lab/haolin/nhk/excerpts/2009_09_15_19_00_3.webm;Katsuya OKADA.jpg;9;21;9481;0;0;0
/net/per920a/export/das14a/satoh-lab/haolin/nhk/excerpts/2009_09_15_19_00_3.webm;Katsuya OKADA.jpg;33;97;9481;1;3;2
/net/per920a/export/das14a/satoh-lab/haolin/nhk/excerpts/2009_09_15_19_00_3.webm;Katsuya OKADA.jpg;109;129;9481;3;4;1
/net/per920a/export/das14a/satoh-lab/haolin/nhk/excerpts/2009_09_15_19_00_3.webm;Shizuka KAMEI.jpg;249;281;9481;8;9;1
/net/per920a/export/das14a/satoh-lab/haolin/nhk/excerpts/2009_09_15_19_00_3.webm;Shizuka KAMEI.jpg;297;305;9481;9;10;1
/net/per920a/export/das14a/satoh-lab/haolin/nhk/excerpts/2009_09_15_19_00_3.webm;Shizuka KAMEI.jpg;333;349;9481;11;11;0
/net/per920a/export/das14a/satoh-lab/haolin/nhk/excerpts/2009_09_15_19_00_3.webm;Shizuka KAMEI.jpg;365;489;9481;12;16;4
/net/per920a/export/das14a/satoh-lab/haolin/nhk/excerpts/2009_09_15_19_00_3.webm;Shizuka KAMEI.jpg;501;881;9481;16;29;13
/net/per920a/export/das14a/satoh-lab/haolin/nhk/excerpts/2009_09_15_19_00_3.webm;Shizuka KAMEI.jpg;5913;5917;9481;197;197;0
/net/per920a/export/das14a/satoh-lab/haolin/nhk/excerpts/2009_09_15_19_00_3.webm;Shizuka KAMEI.jpg;6065;6077;9481;202;202;0
/net/per920a/export/das14a/satoh-lab/haolin/nhk/excerpts/2009_09_15_19_00_3.webm;Shizuka KAMEI.jpg;6105;6117;9481;203;203;0
/net/per920a/export/das14a/satoh-lab/haolin/nhk/excerpts/2009_09_15_19_00_3.webm;Shizuka KAMEI.jpg;6141;6913;9481;204;230;26
/net/per920a/export/das14a/satoh-lab/haolin/nhk/excerpts/2009_09_15_19_00_3.webm;Yukio HATOYAMA.jpg;1153;1293;9481;38;43;5
/net/per920a/export/das14a/satoh-lab/haolin/nhk/excerpts/2009_09_15_19_00_3.webm;Yukio HATOYAMA.jpg;1313;1325;9481;43;44;1
/net/per920a/export/das14a/satoh-lab/haolin/nhk/excerpts/2009_09_15_19_00_3.webm;Yukio HATOYAMA.jpg;1341;1357;9481;44;45;1
/net/per920a/export/das14a/satoh-lab/haolin/nhk/excerpts/2009_09_15_19_00_3.webm;Yukio HATOYAMA.jpg;1601;1601;9481;53;53;0
/net/per920a/export/das14a/satoh-lab/haolin/nhk/excerpts/2009_09_15_19_00_3.webm;Yukio HATOYAMA.jpg;1629;1629;9481;54;54;0
/net/per920a/export/das14a/satoh-lab/haolin/nhk/excerpts/2009_09_15_19_00_3.webm;Yukio HATOYAMA.jpg;1653;1693;9481;55;56;1
/net/per920a/export/das14a/satoh-lab/haolin/nhk/excerpts/2009_09_15_19_00_3.webm;Yukio HATOYAMA.jpg;1709;1709;9481;56;56;0
/net/per920a/export/das14a/satoh-lab/haolin/nhk/excerpts/2009_09_15_19_00_3.webm;Yukio HATOYAMA.jpg;1729;1745;9481;57;58;1
/net/per920a/export/das14a/satoh-lab/haolin/nhk/excerpts/2009_09_15_19_00_3.webm;Yukio HATOYAMA.jpg;1773;1773;9481;59;59;0
/net/per920a/export/das14a/satoh-lab/haolin/nhk/excerpts/2009_09_15_19_00_3.webm;Yukio HATOYAMA.jpg;1809;1829;9481;60;60;0
/net/per920a/export/das14a/satoh-lab/haolin/nhk/excerpts/2009_09_15_19_00_3.webm;Yukio HATOYAMA.jpg;1869;1873;9481;62;62;0
/net/per920a/export/das14a/satoh-lab/haolin/nhk/excerpts/2009_09_15_19_00_3.webm;Yukio HATOYAMA.jpg;1905;1913;9481;63;63;0
/net/per920a/export/das14a/satoh-lab/haolin/nhk/excerpts/2009_09_15_19_00_3.webm;Yukio HATOYAMA.jpg;1929;1941;9481;64;64;0
/net/per920a/export/das14a/satoh-lab/haolin/nhk/excerpts/2009_09_15_19_00_3.webm;Yukio HATOYAMA.jpg;1957;2001;9481;65;66;1
/net/per920a/export/das14a/satoh-lab/haolin/nhk/excerpts/2009_09_15_19_00_3.webm;Yukio HATOYAMA.jpg;2049;2053;9481;68;68;0
/net/per920a/export/das14a/satoh-lab/haolin/nhk/excerpts/2009_09_15_19_00_3.webm;Yukio HATOYAMA.jpg;2069;2069;9481;68;68;0
/net/per920a/export/das14a/satoh-lab/haolin/nhk/excerpts/2009_09_15_19_00_3.webm;Yukio HATOYAMA.jpg;2085;2085;9481;69;69;0
/net/per920a/export/das14a/satoh-lab/haolin/nhk/excerpts/2009_09_15_19_00_3.webm;Yukio HATOYAMA.jpg;2097;2161;9481;69;72;3
/net/per920a/export/das14a/satoh-lab/haolin/nhk/excerpts/2009_09_15_19_00_3.webm;Yukio HATOYAMA.jpg;2177;2193;9481;72;73;1
/net/per920a/export/das14a/satoh-lab/haolin/nhk/excerpts/2009_09_15_19_00_3.webm;Yukio HATOYAMA.jpg;2209;2321;9481;73;77;4
/net/per920a/export/das14a/satoh-lab/haolin/nhk/excerpts/2009_09_15_19_00_3.webm;Yukio HATOYAMA.jpg;2573;2593;9481;85;86;1
/net/per920a/export/das14a/satoh-lab/haolin/nhk/excerpts/2009_09_15_19_00_3.webm;Yukio HATOYAMA.jpg;2913;3301;9481;97;110;13
/net/per920a/export/das14a/satoh-lab/haolin/nhk/excerpts/2009_09_15_19_00_3.webm;Yukio HATOYAMA.jpg;8957;9037;9481;298;301;3
/net/per920a/export/das14a/satoh-lab/haolin/nhk/excerpts/2009_09_15_19_00_3.webm;Yukio HATOYAMA.jpg;9061;9073;9481;302;302;0
/net/per920a/export/das14a/satoh-lab/haolin/nhk/excerpts/2009_09_15_19_00_3.webm;Yukio HATOYAMA.jpg;9341;9341;9481;311;311;0
/net/per920a/export/das14a/satoh-lab/haolin/nhk/excerpts/2009_09_15_19_00_3.webm;Yukio HATOYAMA.jpg;9357;9357;9481;311;311;0
/net/per920a/export/das14a/satoh-lab/haolin/nhk/excerpts/2009_09_15_19_00_3.webm;Yukio HATOYAMA.jpg;9373;9477;9481;312;315;3
/net/per920a/export/das14a/satoh-lab/haolin/nhk/excerpts/2009_09_15_19_00_3.webm;Ichiro OZAWA.jpg;3337;3517;9481;111;117;6
/net/per920a/export/das14a/satoh-lab/haolin/nhk/excerpts/2009_09_15_19_00_3.webm;Mizuho FUKUSHIMA.jpg;5561;5625;9481;185;187;2
/net/per920a/export/das14a/satoh-lab/haolin/nhk/excerpts/2009_09_15_19_00_3.webm;Mizuho FUKUSHIMA.jpg;5641;5825;9481;188;194;6
/net/per920a/export/das14a/satoh-lab/haolin/nhk/excerpts/2009_09_15_19_00_3.webm;Mizuho FUKUSHIMA.jpg;5841;5901;9481;194;196;2
/net/per920a/export/das14a/satoh-lab/haolin/nhk/excerpts/2009_09_18_19_00_2.webm;Yukio HATOYAMA.jpg;569;573;633;18;19;1
/net/per920a/export/das14a/satoh-lab/haolin/nhk/excerpts/2009_09_20_19_00_2.webm;Yukio HATOYAMA.jpg;165;209;3637;5;6;1
/net/per920a/export/das14a/satoh-lab/haolin/nhk/excerpts/2009_09_20_19_00_2.webm;Yukio HATOYAMA.jpg;229;425;3637;7;14;7
/net/per920a/export/das14a/satoh-lab/haolin/nhk/excerpts/2009_09_20_19_00_2.webm;Yukio HATOYAMA.jpg;3173;3201;3637;105;106;1
/net/per920a/export/das14a/satoh-lab/haolin/nhk/excerpts/2009_09_20_19_00_2.webm;Yukio HATOYAMA.jpg;3213;3217;3637;106;107;1
/net/per920a/export/das14a/satoh-lab/haolin/nhk/excerpts/2009_09_20_19_00_2.webm;Yukio HATOYAMA.jpg;3229;3553;3637;107;118;11
/net/per920a/export/das14a/satoh-lab/haolin/nhk/excerpts/2009_09_23_19_00_1.webm;Seiji MAEHARA.jpg;149;225;9089;4;7;3
/net/per920a/export/das14a/satoh-lab/haolin/nhk/excerpts/2009_09_23_19_00_1.webm;Seiji MAEHARA.jpg;617;621;9089;20;20;0
/net/per920a/export/das14a/satoh-lab/haolin/nhk/excerpts/2009_09_23_19_00_1.webm;Seiji MAEHARA.jpg;641;641;9089;21;21;0
/net/per920a/export/das14a/satoh-lab/haolin/nhk/excerpts/2009_09_23_19_00_1.webm;Seiji MAEHARA.jpg;661;661;9089;22;22;0
/net/per920a/export/das14a/satoh-lab/haolin/nhk/excerpts/2009_09_23_19_00_1.webm;Seiji MAEHARA.jpg;677;677;9089;22;22;0
/net/per920a/export/das14a/satoh-lab/haolin/nhk/excerpts/2009_09_23_19_00_1.webm;Seiji MAEHARA.jpg;5929;6089;9089;197;202;5
/net/per920a/export/das14a/satoh-lab/haolin/nhk/excerpts/2009_09_23_19_00_1.webm;Seiji MAEHARA.jpg;6241;6729;9089;208;224;16
/net/per920a/export/das14a/satoh-lab/haolin/nhk/excerpts/2009_09_23_19_00_1.webm;Seiji MAEHARA.jpg;7841;8701;9089;261;290;29
/net/per920a/export/das14a/satoh-lab/haolin/nhk/excerpts/2009_09_23_19_00_3.webm;Yukio HATOYAMA.jpg;9;257;14517;0;8;8
/net/per920a/export/das14a/satoh-lab/haolin/nhk/excerpts/2009_09_23_19_00_3.webm;Yukio HATOYAMA.jpg;557;557;14517;18;18;0
/net/per920a/export/das14a/satoh-lab/haolin/nhk/excerpts/2009_09_23_19_00_3.webm;Yukio HATOYAMA.jpg;645;657;14517;21;21;0
/net/per920a/export/das14a/satoh-lab/haolin/nhk/excerpts/2009_09_23_19_00_3.webm;Yukio HATOYAMA.jpg;669;757;14517;22;25;3
/net/per920a/export/das14a/satoh-lab/haolin/nhk/excerpts/2009_09_23_19_00_3.webm;Yukio HATOYAMA.jpg;769;805;14517;25;26;1
/net/per920a/export/das14a/satoh-lab/haolin/nhk/excerpts/2009_09_23_19_00_3.webm;Yukio HATOYAMA.jpg;817;817;14517;27;27;0
/net/per920a/export/das14a/satoh-lab/haolin/nhk/excerpts/2009_09_23_19_00_3.webm;Yukio HATOYAMA.jpg;829;873;14517;27;29;2
/net/per920a/export/das14a/satoh-lab/haolin/nhk/excerpts/2009_09_23_19_00_3.webm;Yukio HATOYAMA.jpg;885;889;14517;29;29;0
/net/per920a/export/das14a/satoh-lab/haolin/nhk/excerpts/2009_09_23_19_00_3.webm;Yukio HATOYAMA.jpg;905;977;14517;30;32;2
/net/per920a/export/das14a/satoh-lab/haolin/nhk/excerpts/2009_09_23_19_00_3.webm;Yukio HATOYAMA.jpg;1005;1105;14517;33;36;3
/net/per920a/export/das14a/satoh-lab/haolin/nhk/excerpts/2009_09_23_19_00_3.webm;Yukio HATOYAMA.jpg;1241;1281;14517;41;42;1
/net/per920a/export/das14a/satoh-lab/haolin/nhk/excerpts/2009_09_23_19_00_3.webm;Yukio HATOYAMA.jpg;1301;1301;14517;43;43;0
/net/per920a/export/das14a/satoh-lab/haolin/nhk/excerpts/2009_09_23_19_00_3.webm;Yukio HATOYAMA.jpg;1313;1313;14517;43;43;0
/net/per920a/export/das14a/satoh-lab/haolin/nhk/excerpts/2009_09_23_19_00_3.webm;Yukio HATOYAMA.jpg;2413;2433;14517;80;81;1
/net/per920a/export/das14a/satoh-lab/haolin/nhk/excerpts/2009_09_23_19_00_3.webm;Yukio HATOYAMA.jpg;2445;2473;14517;81;82;1
/net/per920a/export/das14a/satoh-lab/haolin/nhk/excerpts/2009_09_23_19_00_3.webm;Yukio HATOYAMA.jpg;2493;2541;14517;83;84;1
/net/per920a/export/das14a/satoh-lab/haolin/nhk/excerpts/2009_09_23_19_00_3.webm;Yukio HATOYAMA.jpg;2565;2569;14517;85;85;0
/net/per920a/export/das14a/satoh-lab/haolin/nhk/excerpts/2009_09_23_19_00_3.webm;Yukio HATOYAMA.jpg;2593;2601;14517;86;86;0
/net/per920a/export/das14a/satoh-lab/haolin/nhk/excerpts/2009_09_23_19_00_3.webm;Yukio HATOYAMA.jpg;2617;2617;14517;87;87;0
/net/per920a/export/das14a/satoh-lab/haolin/nhk/excerpts/2009_09_23_19_00_3.webm;Yukio HATOYAMA.jpg;2629;2645;14517;87;88;1
/net/per920a/export/das14a/satoh-lab/haolin/nhk/excerpts/2009_09_23_19_00_3.webm;Yukio HATOYAMA.jpg;2661;2673;14517;88;89;1
/net/per920a/export/das14a/satoh-lab/haolin/nhk/excerpts/2009_09_23_19_00_3.webm;Yukio HATOYAMA.jpg;2689;2709;14517;89;90;1
/net/per920a/export/das14a/satoh-lab/haolin/nhk/excerpts/2009_09_23_19_00_3.webm;Yukio HATOYAMA.jpg;2721;2781;14517;90;92;2
/net/per920a/export/das14a/satoh-lab/haolin/nhk/excerpts/2009_09_23_19_00_3.webm;Yukio HATOYAMA.jpg;2793;2865;14517;93;95;2
/net/per920a/export/das14a/satoh-lab/haolin/nhk/excerpts/2009_09_23_19_00_3.webm;Yukio HATOYAMA.jpg;2889;3081;14517;96;102;6
/net/per920a/export/das14a/satoh-lab/haolin/nhk/excerpts/2009_09_23_19_00_3.webm;Yukio HATOYAMA.jpg;3105;3117;14517;103;103;0
/net/per920a/export/das14a/satoh-lab/haolin/nhk/excerpts/2009_09_23_19_00_3.webm;Yukio HATOYAMA.jpg;8717;8721;14517;290;290;0
/net/per920a/export/das14a/satoh-lab/haolin/nhk/excerpts/2009_09_23_19_00_3.webm;Yukio HATOYAMA.jpg;8733;8753;14517;291;291;0
/net/per920a/export/das14a/satoh-lab/haolin/nhk/excerpts/2009_09_23_19_00_3.webm;Yukio HATOYAMA.jpg;8769;8773;14517;292;292;0
/net/per920a/export/das14a/satoh-lab/haolin/nhk/excerpts/2009_09_23_19_00_3.webm;Yukio HATOYAMA.jpg;8789;8793;14517;293;293;0
/net/per920a/export/das14a/satoh-lab/haolin/nhk/excerpts/2009_09_23_19_00_3.webm;Yukio HATOYAMA.jpg;8809;8825;14517;293;294;1
/net/per920a/export/das14a/satoh-lab/haolin/nhk/excerpts/2009_09_23_19_00_3.webm;Yukio HATOYAMA.jpg;8845;9017;14517;294;300;6
/net/per920a/export/das14a/satoh-lab/haolin/nhk/excerpts/2009_09_23_19_00_3.webm;Yukio HATOYAMA.jpg;9033;9061;14517;301;302;1
/net/per920a/export/das14a/satoh-lab/haolin/nhk/excerpts/2009_09_23_19_00_3.webm;Yukio HATOYAMA.jpg;9077;9081;14517;302;302;0
/net/per920a/export/das14a/satoh-lab/haolin/nhk/excerpts/2009_09_23_19_00_3.webm;Yukio HATOYAMA.jpg;9097;9097;14517;303;303;0
/net/per920a/export/das14a/satoh-lab/haolin/nhk/excerpts/2009_09_23_19_00_3.webm;Yukio HATOYAMA.jpg;9369;9373;14517;312;312;0
/net/per920a/export/das14a/satoh-lab/haolin/nhk/excerpts/2009_09_23_19_00_3.webm;Yukio HATOYAMA.jpg;9385;9393;14517;312;313;1
/net/per920a/export/das14a/satoh-lab/haolin/nhk/excerpts/2009_09_23_19_00_3.webm;Yukio HATOYAMA.jpg;9413;9413;14517;313;313;0
/net/per920a/export/das14a/satoh-lab/haolin/nhk/excerpts/2009_09_23_19_00_3.webm;Yukio HATOYAMA.jpg;9501;9501;14517;316;316;0
/net/per920a/export/das14a/satoh-lab/haolin/nhk/excerpts/2009_09_23_19_00_3.webm;Yukio HATOYAMA.jpg;9541;9541;14517;318;318;0
/net/per920a/export/das14a/satoh-lab/haolin/nhk/excerpts/2009_09_23_19_00_3.webm;Yukio HATOYAMA.jpg;9601;9601;14517;320;320;0
/net/per920a/export/das14a/satoh-lab/haolin/nhk/excerpts/2009_09_23_19_00_3.webm;Yukio HATOYAMA.jpg;9613;9617;14517;320;320;0
/net/per920a/export/das14a/satoh-lab/haolin/nhk/excerpts/2009_09_23_19_00_3.webm;Yukio HATOYAMA.jpg;9633;10041;14517;321;334;13
/net/per920a/export/das14a/satoh-lab/haolin/nhk/excerpts/2009_09_23_19_00_3.webm;Yukio HATOYAMA.jpg;10165;10185;14517;338;339;1
/net/per920a/export/das14a/satoh-lab/haolin/nhk/excerpts/2009_09_23_19_00_3.webm;Yukio HATOYAMA.jpg;10261;10261;14517;342;342;0
/net/per920a/export/das14a/satoh-lab/haolin/nhk/excerpts/2009_09_23_19_00_3.webm;Yukio HATOYAMA.jpg;10277;10277;14517;342;342;0
/net/per920a/export/das14a/satoh-lab/haolin/nhk/excerpts/2009_09_23_19_00_3.webm;Yukio HATOYAMA.jpg;10293;10293;14517;343;343;0
/net/per920a/export/das14a/satoh-lab/haolin/nhk/excerpts/2009_09_23_19_00_3.webm;Yukio HATOYAMA.jpg;10305;10309;14517;343;343;0
/net/per920a/export/das14a/satoh-lab/haolin/nhk/excerpts/2009_09_23_19_00_3.webm;Yukio HATOYAMA.jpg;10321;10321;14517;344;344;0
/net/per920a/export/das14a/satoh-lab/haolin/nhk/excerpts/2009_09_23_19_00_3.webm;Yukio HATOYAMA.jpg;10349;10349;14517;345;345;0
/net/per920a/export/das14a/satoh-lab/haolin/nhk/excerpts/2009_09_23_19_00_3.webm;Yukio HATOYAMA.jpg;10365;10369;14517;345;345;0
/net/per920a/export/das14a/satoh-lab/haolin/nhk/excerpts/2009_09_23_19_00_3.webm;Yukio HATOYAMA.jpg;10465;10465;14517;348;348;0
/net/per920a/export/das14a/satoh-lab/haolin/nhk/excerpts/2009_09_23_19_00_3.webm;Yukio HATOYAMA.jpg;10517;10693;14517;350;356;6
/net/per920a/export/das14a/satoh-lab/haolin/nhk/excerpts/2009_09_23_19_00_3.webm;Yukio HATOYAMA.jpg;10953;11013;14517;365;367;2
/net/per920a/export/das14a/satoh-lab/haolin/nhk/excerpts/2009_09_23_19_00_3.webm;Yukio HATOYAMA.jpg;11189;11201;14517;373;373;0
/net/per920a/export/das14a/satoh-lab/haolin/nhk/excerpts/2009_09_24_19_00_1.webm;Shizuka KAMEI.jpg;689;701;6305;22;23;1
/net/per920a/export/das14a/satoh-lab/haolin/nhk/excerpts/2009_09_24_19_00_1.webm;Shizuka KAMEI.jpg;717;1117;6305;23;37;14
/net/per920a/export/das14a/satoh-lab/haolin/nhk/excerpts/2009_09_24_19_00_1.webm;Shizuka KAMEI.jpg;1137;1177;6305;37;39;2
/net/per920a/export/das14a/satoh-lab/haolin/nhk/excerpts/2009_09_24_19_00_1.webm;Shizuka KAMEI.jpg;1193;1201;6305;39;40;1
/net/per920a/export/das14a/satoh-lab/haolin/nhk/excerpts/2009_09_24_19_00_1.webm;Shizuka KAMEI.jpg;1517;1517;6305;50;50;0
/net/per920a/export/das14a/satoh-lab/haolin/nhk/excerpts/2009_09_24_19_00_1.webm;Shizuka KAMEI.jpg;1533;1541;6305;51;51;0
/net/per920a/export/das14a/satoh-lab/haolin/nhk/excerpts/2009_09_24_19_00_1.webm;Shizuka KAMEI.jpg;1557;1585;6305;51;52;1
/net/per920a/export/das14a/satoh-lab/haolin/nhk/excerpts/2009_09_24_19_00_1.webm;Shizuka KAMEI.jpg;1601;1613;6305;53;53;0
/net/per920a/export/das14a/satoh-lab/haolin/nhk/excerpts/2009_09_24_19_00_1.webm;Shizuka KAMEI.jpg;1629;1637;6305;54;54;0
/net/per920a/export/das14a/satoh-lab/haolin/nhk/excerpts/2009_09_24_19_00_1.webm;Shizuka KAMEI.jpg;1653;1657;6305;55;55;0
/net/per920a/export/das14a/satoh-lab/haolin/nhk/excerpts/2009_09_24_19_00_1.webm;Shizuka KAMEI.jpg;1689;1801;6305;56;59;3
/net/per920a/export/das14a/satoh-lab/haolin/nhk/excerpts/2009_09_24_19_00_1.webm;Shizuka KAMEI.jpg;1829;1853;6305;60;61;1
/net/per920a/export/das14a/satoh-lab/haolin/nhk/excerpts/2009_09_24_19_00_1.webm;Shizuka KAMEI.jpg;1877;1877;6305;62;62;0
/net/per920a/export/das14a/satoh-lab/haolin/nhk/excerpts/2009_09_24_19_00_1.webm;Shizuka KAMEI.jpg;1889;1889;6305;62;62;0
/net/per920a/export/das14a/satoh-lab/haolin/nhk/excerpts/2009_09_24_19_00_1.webm;Shizuka KAMEI.jpg;1909;1993;6305;63;66;3
/net/per920a/export/das14a/satoh-lab/haolin/nhk/excerpts/2009_09_24_19_00_1.webm;Shizuka KAMEI.jpg;2029;2197;6305;67;73;6
/net/per920a/export/das14a/satoh-lab/haolin/nhk/excerpts/2009_09_24_19_00_1.webm;Shizuka KAMEI.jpg;2213;2213;6305;73;73;0
/net/per920a/export/das14a/satoh-lab/haolin/nhk/excerpts/2009_09_24_19_00_1.webm;Shizuka KAMEI.jpg;2229;2293;6305;74;76;2
/net/per920a/export/das14a/satoh-lab/haolin/nhk/excerpts/2009_09_24_19_00_1.webm;Shizuka KAMEI.jpg;2309;2341;6305;76;77;1
/net/per920a/export/das14a/satoh-lab/haolin/nhk/excerpts/2009_09_24_19_00_1.webm;Shizuka KAMEI.jpg;2357;2437;6305;78;81;3
/net/per920a/export/das14a/satoh-lab/haolin/nhk/excerpts/2009_09_24_19_00_1.webm;Shizuka KAMEI.jpg;2453;2477;6305;81;82;1
/net/per920a/export/das14a/satoh-lab/haolin/nhk/excerpts/2009_09_24_19_00_1.webm;Shizuka KAMEI.jpg;2493;2501;6305;83;83;0
/net/per920a/export/das14a/satoh-lab/haolin/nhk/excerpts/2009_09_27_19_00_2.webm;Naoto KAN.jpg;9;449;4109;0;14;14
/net/per920a/export/das14a/satoh-lab/haolin/nhk/excerpts/2009_09_27_19_00_2.webm;Naoto KAN.jpg;1389;1417;4109;46;47;1
/net/per920a/export/das14a/satoh-lab/haolin/nhk/excerpts/2009_09_27_19_00_2.webm;Naoto KAN.jpg;1565;1565;4109;52;52;0
/net/per920a/export/das14a/satoh-lab/haolin/nhk/excerpts/2009_09_27_19_00_2.webm;Naoto KAN.jpg;1585;1637;4109;52;54;2
/net/per920a/export/das14a/satoh-lab/haolin/nhk/excerpts/2009_09_27_19_00_2.webm;Naoto KAN.jpg;1665;1677;4109;55;55;0
/net/per920a/export/das14a/satoh-lab/haolin/nhk/excerpts/2009_09_27_19_00_2.webm;Naoto KAN.jpg;1693;1705;4109;56;56;0
/net/per920a/export/das14a/satoh-lab/haolin/nhk/excerpts/2009_09_27_19_00_2.webm;Naoto KAN.jpg;1721;1721;4109;57;57;0
/net/per920a/export/das14a/satoh-lab/haolin/nhk/excerpts/2009_09_27_19_00_2.webm;Naoto KAN.jpg;1741;1757;4109;58;58;0
/net/per920a/export/das14a/satoh-lab/haolin/nhk/excerpts/2009_09_27_19_00_2.webm;Naoto KAN.jpg;1801;1801;4109;60;60;0
/net/per920a/export/das14a/satoh-lab/haolin/nhk/excerpts/2009_09_27_19_00_2.webm;Naoto KAN.jpg;1813;1813;4109;60;60;0
/net/per920a/export/das14a/satoh-lab/haolin/nhk/excerpts/2009_09_27_19_00_2.webm;Naoto KAN.jpg;1829;1833;4109;60;61;1
/net/per920a/export/das14a/satoh-lab/haolin/nhk/excerpts/2009_09_27_19_00_2.webm;Naoto KAN.jpg;1849;1849;4109;61;61;0
/net/per920a/export/das14a/satoh-lab/haolin/nhk/excerpts/2009_09_27_19_00_2.webm;Naoto KAN.jpg;1865;1873;4109;62;62;0
/net/per920a/export/das14a/satoh-lab/haolin/nhk/excerpts/2009_09_27_19_00_2.webm;Yukio HATOYAMA.jpg;9;449;4109;0;14;14
/net/per920a/export/das14a/satoh-lab/haolin/nhk/excerpts/2009_09_27_19_00_2.webm;Yukio HATOYAMA.jpg;461;513;4109;15;17;2
/net/per920a/export/das14a/satoh-lab/haolin/nhk/excerpts/2009_09_27_19_00_2.webm;Yukio HATOYAMA.jpg;785;793;4109;26;26;0
/net/per920a/export/das14a/satoh-lab/haolin/nhk/excerpts/2009_09_27_19_00_2.webm;Yukio HATOYAMA.jpg;821;841;4109;27;28;1
/net/per920a/export/das14a/satoh-lab/haolin/nhk/excerpts/2009_09_27_19_00_2.webm;Yukio HATOYAMA.jpg;857;861;4109;28;28;0
/net/per920a/export/das14a/satoh-lab/haolin/nhk/excerpts/2009_09_27_19_00_2.webm;Yukio HATOYAMA.jpg;877;877;4109;29;29;0
/net/per920a/export/das14a/satoh-lab/haolin/nhk/excerpts/2009_09_27_19_00_2.webm;Yukio HATOYAMA.jpg;893;893;4109;29;29;0
/net/per920a/export/das14a/satoh-lab/haolin/nhk/excerpts/2009_09_27_19_00_2.webm;Yukio HATOYAMA.jpg;909;1093;4109;30;36;6
/net/per920a/export/das14a/satoh-lab/haolin/nhk/excerpts/2009_09_27_19_00_2.webm;Yukio HATOYAMA.jpg;1233;1249;4109;41;41;0
/net/per920a/export/das14a/satoh-lab/haolin/nhk/excerpts/2009_09_27_19_00_2.webm;Yukio HATOYAMA.jpg;1269;1273;4109;42;42;0
/net/per920a/export/das14a/satoh-lab/haolin/nhk/excerpts/2009_09_27_19_00_2.webm;Yukio HATOYAMA.jpg;1285;1325;4109;42;44;2
/net/per920a/export/das14a/satoh-lab/haolin/nhk/excerpts/2009_09_27_19_00_2.webm;Yukio HATOYAMA.jpg;1341;1341;4109;44;44;0
/net/per920a/export/das14a/satoh-lab/haolin/nhk/excerpts/2009_09_27_19_00_2.webm;Yukio HATOYAMA.jpg;1353;1353;4109;45;45;0
/net/per920a/export/das14a/satoh-lab/haolin/nhk/excerpts/2009_09_27_19_00_2.webm;Yukio HATOYAMA.jpg;2069;2077;4109;68;69;1
/net/per920a/export/das14a/satoh-lab/haolin/nhk/excerpts/2009_09_27_19_00_2.webm;Yukio HATOYAMA.jpg;2105;2109;4109;70;70;0
/net/per920a/export/das14a/satoh-lab/haolin/nhk/excerpts/2009_09_27_19_00_2.webm;Yukio HATOYAMA.jpg;2129;2153;4109;70;71;1
/net/per920a/export/das14a/satoh-lab/haolin/nhk/excerpts/2009_09_27_19_00_2.webm;Yukio HATOYAMA.jpg;2177;2177;4109;72;72;0
/net/per920a/export/das14a/satoh-lab/haolin/nhk/excerpts/2009_09_27_19_00_2.webm;Yukio HATOYAMA.jpg;2189;2229;4109;72;74;2
/net/per920a/export/das14a/satoh-lab/haolin/nhk/excerpts/2009_09_27_19_00_2.webm;Yukio HATOYAMA.jpg;2453;2457;4109;81;81;0
/net/per920a/export/das14a/satoh-lab/haolin/nhk/excerpts/2009_09_27_19_00_2.webm;Yukio HATOYAMA.jpg;2469;2473;4109;82;82;0
/net/per920a/export/das14a/satoh-lab/haolin/nhk/excerpts/2009_09_27_19_00_2.webm;Seiji MAEHARA.jpg;2677;2765;4109;89;92;3
/net/per920a/export/das14a/satoh-lab/haolin/nhk/excerpts/2009_09_27_19_00_2.webm;Seiji MAEHARA.jpg;2781;2901;4109;92;96;4
/net/per920a/export/das14a/satoh-lab/haolin/nhk/excerpts/2009_09_27_19_00_2.webm;Seiji MAEHARA.jpg;2925;2993;4109;97;99;2
/net/per920a/export/das14a/satoh-lab/haolin/nhk/excerpts/2009_09_27_19_00_2.webm;Seiji MAEHARA.jpg;3009;3017;4109;100;100;0
/net/per920a/export/das14a/satoh-lab/haolin/nhk/excerpts/2009_09_27_19_00_2.webm;Seiji MAEHARA.jpg;3033;3385;4109;101;112;11
/net/per920a/export/das14a/satoh-lab/haolin/nhk/excerpts/2009_09_27_19_00_2.webm;Seiji MAEHARA.jpg;3413;4065;4109;113;135;22
/net/per920a/export/das14a/satoh-lab/haolin/nhk/excerpts/2009_10_02_19_00_1.webm;Yukio HATOYAMA.jpg;9;197;7865;0;6;6
/net/per920a/export/das14a/satoh-lab/haolin/nhk/excerpts/2009_10_02_19_00_1.webm;Yukio HATOYAMA.jpg;1141;1153;7865;38;38;0
/net/per920a/export/das14a/satoh-lab/haolin/nhk/excerpts/2009_10_02_19_00_1.webm;Yukio HATOYAMA.jpg;3533;3533;7865;117;117;0
/net/per920a/export/das14a/satoh-lab/haolin/nhk/excerpts/2009_10_02_19_00_1.webm;Yukio HATOYAMA.jpg;3545;3561;7865;118;118;0
/net/per920a/export/das14a/satoh-lab/haolin/nhk/excerpts/2009_10_02_19_00_1.webm;Yukio HATOYAMA.jpg;4309;4773;7865;143;158;15
/net/per920a/export/das14a/satoh-lab/haolin/nhk/excerpts/2009_10_03_19_00_1.webm;Shintaro ISHIHARA.jpg;7181;7225;8761;239;240;1
/net/per920a/export/das14a/satoh-lab/haolin/nhk/excerpts/2009_10_03_19_00_1.webm;Shintaro ISHIHARA.jpg;7241;7261;8761;241;242;1
/net/per920a/export/das14a/satoh-lab/haolin/nhk/excerpts/2009_10_03_19_00_1.webm;Shintaro ISHIHARA.jpg;7277;7293;8761;242;243;1
/net/per920a/export/das14a/satoh-lab/haolin/nhk/excerpts/2009_10_03_19_00_1.webm;Shintaro ISHIHARA.jpg;7309;7349;8761;243;244;1
/net/per920a/export/das14a/satoh-lab/haolin/nhk/excerpts/2009_10_03_19_00_1.webm;Shintaro ISHIHARA.jpg;7365;7369;8761;245;245;0
/net/per920a/export/das14a/satoh-lab/haolin/nhk/excerpts/2009_10_03_19_00_1.webm;Shintaro ISHIHARA.jpg;7385;7473;8761;246;249;3
/net/per920a/export/das14a/satoh-lab/haolin/nhk/excerpts/2009_10_03_19_00_1.webm;Shintaro ISHIHARA.jpg;7489;7853;8761;249;261;12
/net/per920a/export/das14a/satoh-lab/haolin/nhk/excerpts/2009_10_15_19_00_1.webm;Yukio HATOYAMA.jpg;49;349;9649;1;11;10
/net/per920a/export/das14a/satoh-lab/haolin/nhk/excerpts/2009_10_15_19_00_1.webm;Yukio HATOYAMA.jpg;365;725;9649;12;24;12
/net/per920a/export/das14a/satoh-lab/haolin/nhk/excerpts/2009_10_15_19_00_1.webm;Yukio HATOYAMA.jpg;737;757;9649;24;25;1
/net/per920a/export/das14a/satoh-lab/haolin/nhk/excerpts/2009_10_15_19_00_1.webm;Yukio HATOYAMA.jpg;777;917;9649;25;30;5
/net/per920a/export/das14a/satoh-lab/haolin/nhk/excerpts/2009_10_15_19_00_1.webm;Yukio HATOYAMA.jpg;965;1365;9649;32;45;13
/net/per920a/export/das14a/satoh-lab/haolin/nhk/excerpts/2009_10_15_19_00_1.webm;Yukio HATOYAMA.jpg;2373;3689;9649;79;123;44
/net/per920a/export/das14a/satoh-lab/haolin/nhk/excerpts/2009_10_15_19_00_1.webm;Yukio HATOYAMA.jpg;6185;7205;9649;206;240;34
/net/per920a/export/das14a/satoh-lab/haolin/nhk/excerpts/2009_10_15_19_00_1.webm;Yukio HATOYAMA.jpg;8825;8825;9649;294;294;0
/net/per920a/export/das14a/satoh-lab/haolin/nhk/excerpts/2009_10_15_19_00_1.webm;Yukio HATOYAMA.jpg;8841;9065;9649;295;302;7
/net/per920a/export/das14a/satoh-lab/haolin/nhk/excerpts/2009_10_15_19_00_1.webm;Taro ASO.jpg;2141;2361;9649;71;78;7
/net/per920a/export/das14a/satoh-lab/haolin/nhk/excerpts/2009_10_15_19_00_1.webm;Taro ASO.jpg;2373;2969;9649;79;99;20
/net/per920a/export/das14a/satoh-lab/haolin/nhk/excerpts/2009_10_15_19_00_1.webm;Ichiro OZAWA.jpg;4317;4361;9649;144;145;1
/net/per920a/export/das14a/satoh-lab/haolin/nhk/excerpts/2009_10_15_19_00_1.webm;Ichiro OZAWA.jpg;4377;4389;9649;146;146;0
/net/per920a/export/das14a/satoh-lab/haolin/nhk/excerpts/2009_10_15_19_00_1.webm;Ichiro OZAWA.jpg;4405;4457;9649;147;148;1
/net/per920a/export/das14a/satoh-lab/haolin/nhk/excerpts/2009_10_15_19_00_1.webm;Ichiro OZAWA.jpg;4473;4477;9649;149;149;0
/net/per920a/export/das14a/satoh-lab/haolin/nhk/excerpts/2009_10_15_19_00_1.webm;Ichiro OZAWA.jpg;4497;4521;9649;150;150;0
/net/per920a/export/das14a/satoh-lab/haolin/nhk/excerpts/2009_10_15_19_00_1.webm;Ichiro OZAWA.jpg;4541;4569;9649;151;152;1
/net/per920a/export/das14a/satoh-lab/haolin/nhk/excerpts/2009_10_15_19_00_1.webm;Ichiro OZAWA.jpg;4585;4609;9649;153;153;0
/net/per920a/export/das14a/satoh-lab/haolin/nhk/excerpts/2009_10_15_19_00_1.webm;Ichiro OZAWA.jpg;4629;4741;9649;154;158;4
/net/per920a/export/das14a/satoh-lab/haolin/nhk/excerpts/2009_10_15_19_00_1.webm;Ichiro OZAWA.jpg;4765;4841;9649;159;161;2
/net/per920a/export/das14a/satoh-lab/haolin/nhk/excerpts/2009_10_15_19_00_1.webm;Ichiro OZAWA.jpg;4861;4869;9649;162;162;0
/net/per920a/export/das14a/satoh-lab/haolin/nhk/excerpts/2009_10_15_19_00_1.webm;Ichiro OZAWA.jpg;4885;4945;9649;163;165;2
/net/per920a/export/das14a/satoh-lab/haolin/nhk/excerpts/2009_10_15_19_00_1.webm;Ichiro OZAWA.jpg;4961;6073;9649;165;202;37
/net/per920a/export/das14a/satoh-lab/haolin/nhk/excerpts/2009_10_22_19_00_1.webm;Yukio HATOYAMA.jpg;389;409;2553;12;13;1
/net/per920a/export/das14a/satoh-lab/haolin/nhk/excerpts/2009_10_22_19_00_1.webm;Yukio HATOYAMA.jpg;437;453;2553;14;15;1
/net/per920a/export/das14a/satoh-lab/haolin/nhk/excerpts/2009_10_22_19_00_1.webm;Yukio HATOYAMA.jpg;561;761;2553;18;25;7
/net/per920a/export/das14a/satoh-lab/haolin/nhk/excerpts/2009_10_22_19_00_1.webm;Yukio HATOYAMA.jpg;809;853;2553;26;28;2
/net/per920a/export/das14a/satoh-lab/haolin/nhk/excerpts/2009_10_22_19_00_1.webm;Yukio HATOYAMA.jpg;1117;1145;2553;37;38;1
/net/per920a/export/das14a/satoh-lab/haolin/nhk/excerpts/2009_10_22_19_00_1.webm;Yukio HATOYAMA.jpg;1673;1849;2553;55;61;6
/net/per920a/export/das14a/satoh-lab/haolin/nhk/excerpts/2009_10_22_19_00_1.webm;Yukio HATOYAMA.jpg;1865;2441;2553;62;81;19
/net/per920a/export/das14a/satoh-lab/haolin/nhk/excerpts/2009_10_22_19_00_1.webm;Yukio HATOYAMA.jpg;2457;2517;2553;81;83;2
/net/per920a/export/das14a/satoh-lab/haolin/nhk/excerpts/2009_10_24_19_00_1.webm;Yukio HATOYAMA.jpg;617;669;16545;20;22;2
/net/per920a/export/das14a/satoh-lab/haolin/nhk/excerpts/2009_10_24_19_00_1.webm;Yukio HATOYAMA.jpg;1045;1141;16545;34;38;4
/net/per920a/export/das14a/satoh-lab/haolin/nhk/excerpts/2009_10_24_19_00_1.webm;Yukio HATOYAMA.jpg;2081;2521;16545;69;84;15
/net/per920a/export/das14a/satoh-lab/haolin/nhk/excerpts/2009_10_24_19_00_1.webm;Yukio HATOYAMA.jpg;2709;2761;16545;90;92;2
/net/per920a/export/das14a/satoh-lab/haolin/nhk/excerpts/2009_10_24_19_00_1.webm;Yukio HATOYAMA.jpg;3093;3129;16545;103;104;1
/net/per920a/export/das14a/satoh-lab/haolin/nhk/excerpts/2009_10_24_19_00_1.webm;Yukio HATOYAMA.jpg;4265;4353;16545;142;145;3
/net/per920a/export/das14a/satoh-lab/haolin/nhk/excerpts/2009_10_24_19_00_1.webm;Yukio HATOYAMA.jpg;4417;4421;16545;147;147;0
/net/per920a/export/das14a/satoh-lab/haolin/nhk/excerpts/2009_10_24_19_00_1.webm;Yukio HATOYAMA.jpg;4437;4473;16545;148;149;1
/net/per920a/export/das14a/satoh-lab/haolin/nhk/excerpts/2009_10_24_19_00_1.webm;Yukio HATOYAMA.jpg;4485;4497;16545;149;150;1
/net/per920a/export/das14a/satoh-lab/haolin/nhk/excerpts/2009_10_24_19_00_1.webm;Yukio HATOYAMA.jpg;4517;4537;16545;150;151;1
/net/per920a/export/das14a/satoh-lab/haolin/nhk/excerpts/2009_10_24_19_00_1.webm;Yukio HATOYAMA.jpg;5461;5469;16545;182;182;0
/net/per920a/export/das14a/satoh-lab/haolin/nhk/excerpts/2009_10_24_19_00_1.webm;Yukio HATOYAMA.jpg;5513;5537;16545;183;184;1
/net/per920a/export/das14a/satoh-lab/haolin/nhk/excerpts/2009_10_24_19_00_1.webm;Yukio HATOYAMA.jpg;5549;5565;16545;185;185;0
/net/per920a/export/das14a/satoh-lab/haolin/nhk/excerpts/2009_10_24_19_00_1.webm;Yukio HATOYAMA.jpg;5589;5589;16545;186;186;0
/net/per920a/export/das14a/satoh-lab/haolin/nhk/excerpts/2009_10_24_19_00_1.webm;Yukio HATOYAMA.jpg;5717;5725;16545;190;191;1
/net/per920a/export/das14a/satoh-lab/haolin/nhk/excerpts/2009_10_24_19_00_1.webm;Yukio HATOYAMA.jpg;5737;5741;16545;191;191;0
/net/per920a/export/das14a/satoh-lab/haolin/nhk/excerpts/2009_10_24_19_00_1.webm;Yukio HATOYAMA.jpg;5753;5825;16545;191;194;3
/net/per920a/export/das14a/satoh-lab/haolin/nhk/excerpts/2009_10_24_19_00_1.webm;Yukio HATOYAMA.jpg;5837;5837;16545;194;194;0
/net/per920a/export/das14a/satoh-lab/haolin/nhk/excerpts/2009_10_24_19_00_1.webm;Yukio HATOYAMA.jpg;5849;5869;16545;195;195;0
/net/per920a/export/das14a/satoh-lab/haolin/nhk/excerpts/2009_10_24_19_00_1.webm;Yukio HATOYAMA.jpg;5897;5897;16545;196;196;0
/net/per920a/export/das14a/satoh-lab/haolin/nhk/excerpts/2009_10_24_19_00_1.webm;Yukio HATOYAMA.jpg;5909;5917;16545;197;197;0
/net/per920a/export/das14a/satoh-lab/haolin/nhk/excerpts/2009_10_24_19_00_1.webm;Yukio HATOYAMA.jpg;5961;5965;16545;198;199;1
/net/per920a/export/das14a/satoh-lab/haolin/nhk/excerpts/2009_10_24_19_00_1.webm;Yukio HATOYAMA.jpg;5977;5985;16545;199;199;0
/net/per920a/export/das14a/satoh-lab/haolin/nhk/excerpts/2009_10_24_19_00_1.webm;Yukio HATOYAMA.jpg;5997;6001;16545;200;200;0
/net/per920a/export/das14a/satoh-lab/haolin/nhk/excerpts/2009_10_24_19_00_1.webm;Yukio HATOYAMA.jpg;6017;6017;16545;200;200;0
/net/per920a/export/das14a/satoh-lab/haolin/nhk/excerpts/2009_10_24_19_00_1.webm;Yukio HATOYAMA.jpg;6029;6029;16545;201;201;0
/net/per920a/export/das14a/satoh-lab/haolin/nhk/excerpts/2009_10_24_19_00_1.webm;Yukio HATOYAMA.jpg;6077;6165;16545;202;205;3
/net/per920a/export/das14a/satoh-lab/haolin/nhk/excerpts/2009_10_24_19_00_1.webm;Yukio HATOYAMA.jpg;14185;14233;16545;473;474;1
/net/per920a/export/das14a/satoh-lab/haolin/nhk/excerpts/2009_10_24_19_00_1.webm;Katsuya OKADA.jpg;7329;7361;16545;244;245;1
/net/per920a/export/das14a/satoh-lab/haolin/nhk/excerpts/2009_10_24_19_00_1.webm;Katsuya OKADA.jpg;7401;7405;16545;246;247;1
/net/per920a/export/das14a/satoh-lab/haolin/nhk/excerpts/2009_10_24_19_00_1.webm;Katsuya OKADA.jpg;7421;7433;16545;247;247;0
/net/per920a/export/das14a/satoh-lab/haolin/nhk/excerpts/2009_10_24_19_00_1.webm;Katsuya OKADA.jpg;7445;7445;16545;248;248;0
/net/per920a/export/das14a/satoh-lab/haolin/nhk/excerpts/2009_10_24_19_00_1.webm;Katsuya OKADA.jpg;7457;7457;16545;248;248;0
/net/per920a/export/das14a/satoh-lab/haolin/nhk/excerpts/2009_10_24_19_00_1.webm;Katsuya OKADA.jpg;7473;7485;16545;249;249;0
/net/per920a/export/das14a/satoh-lab/haolin/nhk/excerpts/2009_10_24_19_00_1.webm;Katsuya OKADA.jpg;7501;7585;16545;250;253;3
/net/per920a/export/das14a/satoh-lab/haolin/nhk/excerpts/2009_10_24_19_00_1.webm;Katsuya OKADA.jpg;7597;7605;16545;253;253;0
/net/per920a/export/das14a/satoh-lab/haolin/nhk/excerpts/2009_10_24_19_00_1.webm;Katsuya OKADA.jpg;7629;7629;16545;254;254;0
/net/per920a/export/das14a/satoh-lab/haolin/nhk/excerpts/2009_10_24_19_00_1.webm;Katsuya OKADA.jpg;7649;7649;16545;255;255;0
/net/per920a/export/das14a/satoh-lab/haolin/nhk/excerpts/2009_10_24_19_00_1.webm;Katsuya OKADA.jpg;7673;7849;16545;255;261;6
/net/per920a/export/das14a/satoh-lab/haolin/nhk/excerpts/2009_10_24_19_00_1.webm;Katsuya OKADA.jpg;10393;10441;16545;346;348;2
/net/per920a/export/das14a/satoh-lab/haolin/nhk/excerpts/2009_10_24_19_00_1.webm;Katsuya OKADA.jpg;10457;10549;16545;348;351;3
/net/per920a/export/das14a/satoh-lab/haolin/nhk/excerpts/2009_10_24_19_00_1.webm;Katsuya OKADA.jpg;10569;10593;16545;352;353;1
/net/per920a/export/das14a/satoh-lab/haolin/nhk/excerpts/2009_10_24_19_00_1.webm;Katsuya OKADA.jpg;10609;10905;16545;353;363;10
/net/per920a/export/das14a/satoh-lab/haolin/nhk/excerpts/2009_10_24_19_00_1.webm;Katsuya OKADA.jpg;10921;11305;16545;364;377;13
/net/per920a/export/das14a/satoh-lab/haolin/nhk/excerpts/2009_10_29_19_00_2.webm;Seiji MAEHARA.jpg;253;253;11301;8;8;0
/net/per920a/export/das14a/satoh-lab/haolin/nhk/excerpts/2009_10_29_19_00_2.webm;Seiji MAEHARA.jpg;269;269;11301;8;8;0
/net/per920a/export/das14a/satoh-lab/haolin/nhk/excerpts/2009_10_29_19_00_2.webm;Seiji MAEHARA.jpg;2633;2905;11301;87;96;9
/net/per920a/export/das14a/satoh-lab/haolin/nhk/excerpts/2009_10_29_19_00_2.webm;Seiji MAEHARA.jpg;2921;3449;11301;97;115;18
/net/per920a/export/das14a/satoh-lab/haolin/nhk/excerpts/2009_10_29_19_00_2.webm;Seiji MAEHARA.jpg;3465;3465;11301;115;115;0
/net/per920a/export/das14a/satoh-lab/haolin/nhk/excerpts/2009_10_29_19_00_2.webm;Seiji MAEHARA.jpg;3481;3577;11301;116;119;3
/net/per920a/export/das14a/satoh-lab/haolin/nhk/excerpts/2009_10_29_19_00_2.webm;Seiji MAEHARA.jpg;8609;8657;11301;287;288;1
/net/per920a/export/das14a/satoh-lab/haolin/nhk/excerpts/2009_10_29_19_00_2.webm;Seiji MAEHARA.jpg;8673;8757;11301;289;292;3
/net/per920a/export/das14a/satoh-lab/haolin/nhk/excerpts/2009_10_29_19_00_2.webm;Seiji MAEHARA.jpg;8773;8833;11301;292;294;2
/net/per920a/export/das14a/satoh-lab/haolin/nhk/excerpts/2009_10_29_19_00_2.webm;Seiji MAEHARA.jpg;8849;8889;11301;295;296;1
/net/per920a/export/das14a/satoh-lab/haolin/nhk/excerpts/2009_10_29_19_00_2.webm;Seiji MAEHARA.jpg;8905;8933;11301;297;298;1
/net/per920a/export/das14a/satoh-lab/haolin/nhk/excerpts/2009_10_29_19_00_2.webm;Seiji MAEHARA.jpg;8949;8973;11301;298;299;1
/net/per920a/export/das14a/satoh-lab/haolin/nhk/excerpts/2009_10_29_19_00_2.webm;Seiji MAEHARA.jpg;8989;9013;11301;299;300;1
/net/per920a/export/das14a/satoh-lab/haolin/nhk/excerpts/2009_10_29_19_00_2.webm;Seiji MAEHARA.jpg;9037;9041;11301;301;301;0
/net/per920a/export/das14a/satoh-lab/haolin/nhk/excerpts/2009_10_29_19_00_2.webm;Seiji MAEHARA.jpg;9057;9213;11301;302;307;5
/net/per920a/export/das14a/satoh-lab/haolin/nhk/excerpts/2009_10_29_19_00_2.webm;Seiji MAEHARA.jpg;10521;10569;11301;350;352;2
/net/per920a/export/das14a/satoh-lab/haolin/nhk/excerpts/2009_10_29_19_00_2.webm;Seiji MAEHARA.jpg;10797;10833;11301;360;361;1
/net/per920a/export/das14a/satoh-lab/haolin/nhk/excerpts/2009_10_29_19_00_2.webm;Seiji MAEHARA.jpg;10849;10857;11301;361;362;1
/net/per920a/export/das14a/satoh-lab/haolin/nhk/excerpts/2009_10_29_19_00_2.webm;Seiji MAEHARA.jpg;10913;10937;11301;364;364;0
/net/per920a/export/das14a/satoh-lab/haolin/nhk/excerpts/2009_10_29_19_00_2.webm;Seiji MAEHARA.jpg;11165;11193;11301;372;373;1
/net/per920a/export/das14a/satoh-lab/haolin/nhk/excerpts/2009_11_08_19_00_3.webm;Yukio HATOYAMA.jpg;697;713;2017;23;23;0
/net/per920a/export/das14a/satoh-lab/haolin/nhk/excerpts/2009_11_08_19_00_3.webm;Yukio HATOYAMA.jpg;725;745;2017;24;24;0
/net/per920a/export/das14a/satoh-lab/haolin/nhk/excerpts/2009_11_08_19_00_3.webm;Yukio HATOYAMA.jpg;761;769;2017;25;25;0
/net/per920a/export/das14a/satoh-lab/haolin/nhk/excerpts/2009_11_08_19_00_3.webm;Yukio HATOYAMA.jpg;809;813;2017;26;27;1
/net/per920a/export/das14a/satoh-lab/haolin/nhk/excerpts/2009_11_08_19_00_3.webm;Yukio HATOYAMA.jpg;845;845;2017;28;28;0
/net/per920a/export/das14a/satoh-lab/haolin/nhk/excerpts/2009_11_08_19_00_3.webm;Yukio HATOYAMA.jpg;861;893;2017;28;29;1
/net/per920a/export/das14a/satoh-lab/haolin/nhk/excerpts/2009_11_08_19_00_3.webm;Yukio HATOYAMA.jpg;905;905;2017;30;30;0
/net/per920a/export/das14a/satoh-lab/haolin/nhk/excerpts/2009_11_08_19_00_3.webm;Yukio HATOYAMA.jpg;917;921;2017;30;30;0
/net/per920a/export/das14a/satoh-lab/haolin/nhk/excerpts/2009_11_08_19_00_3.webm;Yukio HATOYAMA.jpg;945;961;2017;31;31;0
/net/per920a/export/das14a/satoh-lab/haolin/nhk/excerpts/2009_11_08_19_00_3.webm;Yukio HATOYAMA.jpg;1025;1029;2017;34;34;0
/net/per920a/export/das14a/satoh-lab/haolin/nhk/excerpts/2009_11_08_19_00_3.webm;Yukio HATOYAMA.jpg;1041;1041;2017;34;34;0
/net/per920a/export/das14a/satoh-lab/haolin/nhk/excerpts/2009_11_08_19_00_3.webm;Yukio HATOYAMA.jpg;1069;1085;2017;35;36;1
/net/per920a/export/das14a/satoh-lab/haolin/nhk/excerpts/2009_11_08_19_00_3.webm;Yukio HATOYAMA.jpg;1125;1125;2017;37;37;0
/net/per920a/export/das14a/satoh-lab/haolin/nhk/excerpts/2009_11_08_19_00_3.webm;Yukio HATOYAMA.jpg;1141;1145;2017;37;38;1
/net/per920a/export/das14a/satoh-lab/haolin/nhk/excerpts/2009_11_20_19_00_3.webm;Yukio HATOYAMA.jpg;501;653;1953;16;21;5
/net/per920a/export/das14a/satoh-lab/haolin/nhk/excerpts/2009_11_20_19_00_3.webm;Seiji MAEHARA.jpg;785;801;1953;26;26;0
/net/per920a/export/das14a/satoh-lab/haolin/nhk/excerpts/2009_11_20_19_00_3.webm;Naoto KAN.jpg;857;865;1953;28;28;0
/net/per920a/export/das14a/satoh-lab/haolin/nhk/excerpts/2009_11_20_19_00_3.webm;Naoto KAN.jpg;877;889;1953;29;29;0
/net/per920a/export/das14a/satoh-lab/haolin/nhk/excerpts/2009_11_20_19_00_3.webm;Naoto KAN.jpg;1089;1577;1953;36;52;16
/net/per920a/export/das14a/satoh-lab/haolin/nhk/excerpts/2009_11_21_19_00_1.webm;Katsuya OKADA.jpg;9;697;6661;0;23;23
/net/per920a/export/das14a/satoh-lab/haolin/nhk/excerpts/2009_11_21_19_00_1.webm;Katsuya OKADA.jpg;4413;4505;6661;147;150;3
/net/per920a/export/das14a/satoh-lab/haolin/nhk/excerpts/2009_11_24_19_00_1.webm;Yukio HATOYAMA.jpg;537;997;1533;17;33;16
/net/per920a/export/das14a/satoh-lab/haolin/nhk/excerpts/2009_11_24_19_00_1.webm;Yukio HATOYAMA.jpg;1017;1225;1533;33;40;7
/net/per920a/export/das14a/satoh-lab/haolin/nhk/excerpts/2009_11_30_19_00_1.webm;Yukio HATOYAMA.jpg;857;869;8609;28;28;0
/net/per920a/export/das14a/satoh-lab/haolin/nhk/excerpts/2009_11_30_19_00_1.webm;Yukio HATOYAMA.jpg;893;893;8609;29;29;0
/net/per920a/export/das14a/satoh-lab/haolin/nhk/excerpts/2009_11_30_19_00_1.webm;Yukio HATOYAMA.jpg;905;909;8609;30;30;0
/net/per920a/export/das14a/satoh-lab/haolin/nhk/excerpts/2009_11_30_19_00_1.webm;Sadakazu TANIGAKI.jpg;945;969;8609;31;32;1
/net/per920a/export/das14a/satoh-lab/haolin/nhk/excerpts/2009_11_30_19_00_1.webm;Sadakazu TANIGAKI.jpg;2817;2817;8609;93;93;0
/net/per920a/export/das14a/satoh-lab/haolin/nhk/excerpts/2009_11_30_19_00_1.webm;Sadakazu TANIGAKI.jpg;2833;2861;8609;94;95;1
/net/per920a/export/das14a/satoh-lab/haolin/nhk/excerpts/2009_11_30_19_00_1.webm;Sadakazu TANIGAKI.jpg;2873;2881;8609;95;96;1
/net/per920a/export/das14a/satoh-lab/haolin/nhk/excerpts/2009_11_30_19_00_1.webm;Sadakazu TANIGAKI.jpg;2897;2945;8609;96;98;2
/net/per920a/export/das14a/satoh-lab/haolin/nhk/excerpts/2009_11_30_19_00_1.webm;Sadakazu TANIGAKI.jpg;2957;2993;8609;98;99;1
/net/per920a/export/das14a/satoh-lab/haolin/nhk/excerpts/2009_11_30_19_00_1.webm;Sadakazu TANIGAKI.jpg;3005;3029;8609;100;100;0
/net/per920a/export/das14a/satoh-lab/haolin/nhk/excerpts/2009_11_30_19_00_1.webm;Sadakazu TANIGAKI.jpg;3041;3133;8609;101;104;3
/net/per920a/export/das14a/satoh-lab/haolin/nhk/excerpts/2009_11_30_19_00_1.webm;Sadakazu TANIGAKI.jpg;4269;4517;8609;142;150;8
/net/per920a/export/das14a/satoh-lab/haolin/nhk/excerpts/2009_11_30_19_00_1.webm;Sadakazu TANIGAKI.jpg;4533;4569;8609;151;152;1
/net/per920a/export/das14a/satoh-lab/haolin/nhk/excerpts/2009_11_30_19_00_1.webm;Sadakazu TANIGAKI.jpg;4585;4725;8609;152;157;5
/net/per920a/export/das14a/satoh-lab/haolin/nhk/excerpts/2009_11_30_19_00_1.webm;Takenori KANZAKI.jpg;2045;2069;8609;68;68;0
/net/per920a/export/das14a/satoh-lab/haolin/nhk/excerpts/2009_11_30_19_00_1.webm;Takenori KANZAKI.jpg;2097;2097;8609;69;69;0
/net/per920a/export/das14a/satoh-lab/haolin/nhk/excerpts/2009_11_30_19_00_1.webm;Takenori KANZAKI.jpg;2113;2181;8609;70;72;2
/net/per920a/export/das14a/satoh-lab/haolin/nhk/excerpts/2009_11_30_19_00_1.webm;Takenori KANZAKI.jpg;2197;2257;8609;73;75;2
/net/per920a/export/das14a/satoh-lab/haolin/nhk/excerpts/2009_11_30_19_00_1.webm;Takenori KANZAKI.jpg;2273;2329;8609;75;77;2
/net/per920a/export/das14a/satoh-lab/haolin/nhk/excerpts/2009_11_30_19_00_1.webm;Takenori KANZAKI.jpg;2353;2353;8609;78;78;0
/net/per920a/export/das14a/satoh-lab/haolin/nhk/excerpts/2009_11_30_19_00_1.webm;Takenori KANZAKI.jpg;2369;2389;8609;78;79;1
/net/per920a/export/das14a/satoh-lab/haolin/nhk/excerpts/2009_11_30_19_00_1.webm;Takenori KANZAKI.jpg;4885;4913;8609;162;163;1
/net/per920a/export/das14a/satoh-lab/haolin/nhk/excerpts/2009_11_30_19_00_1.webm;Takenori KANZAKI.jpg;4937;5061;8609;164;168;4
/net/per920a/export/das14a/satoh-lab/haolin/nhk/excerpts/2009_11_30_19_00_1.webm;Takenori KANZAKI.jpg;5077;5137;8609;169;171;2
/net/per920a/export/das14a/satoh-lab/haolin/nhk/excerpts/2009_11_30_19_00_1.webm;Takenori KANZAKI.jpg;5153;5201;8609;171;173;2
/net/per920a/export/das14a/satoh-lab/haolin/nhk/excerpts/2009_12_04_19_00_3.webm;Yukio HATOYAMA.jpg;9045;9109;9121;301;303;2
/net/per920a/export/das14a/satoh-lab/haolin/nhk/excerpts/2009_12_20_19_00_1.webm;Yoshihiko Noda.jpg;729;793;7253;24;26;2
/net/per920a/export/das14a/satoh-lab/haolin/nhk/excerpts/2009_12_20_19_00_1.webm;Yoshihiko Noda.jpg;805;825;7253;26;27;1
/net/per920a/export/das14a/satoh-lab/haolin/nhk/excerpts/2009_12_20_19_00_1.webm;Yoshihiko Noda.jpg;841;881;7253;28;29;1
/net/per920a/export/das14a/satoh-lab/haolin/nhk/excerpts/2009_12_20_19_00_1.webm;Ichiro OZAWA.jpg;3805;3897;7253;126;130;4
/net/per920a/export/das14a/satoh-lab/haolin/nhk/excerpts/2009_12_20_19_00_1.webm;Ichiro OZAWA.jpg;3913;3921;7253;130;130;0
/net/per920a/export/das14a/satoh-lab/haolin/nhk/excerpts/2009_12_20_19_00_1.webm;Ichiro OZAWA.jpg;3937;4257;7253;131;142;11
/net/per920a/export/das14a/satoh-lab/haolin/nhk/excerpts/2009_12_20_19_00_1.webm;Ichiro OZAWA.jpg;4273;4397;7253;142;146;4
/net/per920a/export/das14a/satoh-lab/haolin/nhk/excerpts/2009_12_20_19_00_1.webm;Ichiro OZAWA.jpg;4413;5077;7253;147;169;22
/net/per920a/export/das14a/satoh-lab/haolin/nhk/excerpts/2009_12_20_19_00_1.webm;Ichiro OZAWA.jpg;5093;5445;7253;169;181;12
/net/per920a/export/das14a/satoh-lab/haolin/nhk/excerpts/2009_12_20_19_00_1.webm;Ichiro OZAWA.jpg;5461;5473;7253;182;182;0
/net/per920a/export/das14a/satoh-lab/haolin/nhk/excerpts/2009_12_26_19_00_1.webm;Yukio HATOYAMA.jpg;17;633;4945;0;21;21
/net/per920a/export/das14a/satoh-lab/haolin/nhk/excerpts/2009_12_26_19_00_1.webm;Yukio HATOYAMA.jpg;3213;3309;4945;107;110;3
/net/per920a/export/das14a/satoh-lab/haolin/nhk/excerpts/2009_12_26_19_00_1.webm;Yukio HATOYAMA.jpg;3321;3333;4945;110;111;1
/net/per920a/export/das14a/satoh-lab/haolin/nhk/excerpts/2009_12_26_19_00_1.webm;Yukio HATOYAMA.jpg;3345;3361;4945;111;112;1
/net/per920a/export/das14a/satoh-lab/haolin/nhk/excerpts/2009_12_26_19_00_1.webm;Yukio HATOYAMA.jpg;3877;4349;4945;129;145;16
/net/per920a/export/das14a/satoh-lab/haolin/nhk/excerpts/2009_12_26_19_00_1.webm;Katsuya OKADA.jpg;4365;4457;4945;145;148;3
/net/per920a/export/das14a/satoh-lab/haolin/nhk/excerpts/2009_12_26_19_00_1.webm;Katsuya OKADA.jpg;4469;4585;4945;149;152;3
/net/per920a/export/das14a/satoh-lab/haolin/nhk/excerpts/2009_12_26_19_00_1.webm;Katsuya OKADA.jpg;4601;4601;4945;153;153;0
/net/per920a/export/das14a/satoh-lab/haolin/nhk/excerpts/2009_12_26_19_00_1.webm;Katsuya OKADA.jpg;4621;4645;4945;154;154;0
/net/per920a/export/das14a/satoh-lab/haolin/nhk/excerpts/2009_12_26_19_00_1.webm;Katsuya OKADA.jpg;4681;4777;4945;156;159;3
/net/per920a/export/das14a/satoh-lab/haolin/nhk/excerpts/2009_12_26_19_00_1.webm;Katsuya OKADA.jpg;4837;4869;4945;161;162;1
/net/per920a/export/das14a/satoh-lab/haolin/nhk/excerpts/2009_12_28_19_00_1.webm;Yukio HATOYAMA.jpg;889;913;8093;29;30;1
/net/per920a/export/das14a/satoh-lab/haolin/nhk/excerpts/2009_12_28_19_00_1.webm;Yukio HATOYAMA.jpg;929;1009;8093;30;33;3
/net/per920a/export/das14a/satoh-lab/haolin/nhk/excerpts/2009_12_28_19_00_1.webm;Ichiro OZAWA.jpg;4769;4817;8093;159;160;1
/net/per920a/export/das14a/satoh-lab/haolin/nhk/excerpts/2009_12_28_19_00_1.webm;Ichiro OZAWA.jpg;4829;4865;8093;161;162;1
/net/per920a/export/das14a/satoh-lab/haolin/nhk/excerpts/2009_12_28_19_00_1.webm;Ichiro OZAWA.jpg;4881;4957;8093;162;165;3
/net/per920a/export/das14a/satoh-lab/haolin/nhk/excerpts/2009_12_28_19_00_1.webm;Ichiro OZAWA.jpg;4969;4985;8093;165;166;1
/net/per920a/export/das14a/satoh-lab/haolin/nhk/excerpts/2009_12_28_19_00_1.webm;Ichiro OZAWA.jpg;5021;5065;8093;167;168;1
/net/per920a/export/das14a/satoh-lab/haolin/nhk/excerpts/2009_12_28_19_00_1.webm;Ichiro OZAWA.jpg;5077;5077;8093;169;169;0
/net/per920a/export/das14a/satoh-lab/haolin/nhk/excerpts/2009_12_28_19_00_1.webm;Ichiro OZAWA.jpg;5093;5113;8093;169;170;1
/net/per920a/export/das14a/satoh-lab/haolin/nhk/excerpts/2009_12_29_19_00_3.webm;Katsuya OKADA.jpg;597;721;725;19;23;4
/net/per920a/export/das14a/satoh-lab/haolin/nhk/excerpts/2010_01_08_19_00_1.webm;Yukio HATOYAMA.jpg;721;853;10889;24;28;4
/net/per920a/export/das14a/satoh-lab/haolin/nhk/excerpts/2010_01_08_19_00_1.webm;Yukio HATOYAMA.jpg;869;1069;10889;28;35;7
/net/per920a/export/das14a/satoh-lab/haolin/nhk/excerpts/2010_01_08_19_00_1.webm;Yukio HATOYAMA.jpg;5081;5085;10889;169;169;0
/net/per920a/export/das14a/satoh-lab/haolin/nhk/excerpts/2010_01_08_19_00_1.webm;Yukio HATOYAMA.jpg;5149;5149;10889;171;171;0
/net/per920a/export/das14a/satoh-lab/haolin/nhk/excerpts/2010_01_08_19_00_1.webm;Yukio HATOYAMA.jpg;5173;5173;10889;172;172;0
/net/per920a/export/das14a/satoh-lab/haolin/nhk/excerpts/2010_01_08_19_00_1.webm;Yukio HATOYAMA.jpg;5201;5209;10889;173;173;0
/net/per920a/export/das14a/satoh-lab/haolin/nhk/excerpts/2010_01_08_19_00_1.webm;Yukio HATOYAMA.jpg;5261;5269;10889;175;175;0
/net/per920a/export/das14a/satoh-lab/haolin/nhk/excerpts/2010_01_08_19_00_1.webm;Yukio HATOYAMA.jpg;5297;5337;10889;176;177;1
/net/per920a/export/das14a/satoh-lab/haolin/nhk/excerpts/2010_01_08_19_00_1.webm;Yukio HATOYAMA.jpg;5349;5349;10889;178;178;0
/net/per920a/export/das14a/satoh-lab/haolin/nhk/excerpts/2010_01_08_19_00_1.webm;Yukio HATOYAMA.jpg;5361;5389;10889;178;179;1
/net/per920a/export/das14a/satoh-lab/haolin/nhk/excerpts/2010_01_08_19_00_1.webm;Yukio HATOYAMA.jpg;5401;5401;10889;180;180;0
/net/per920a/export/das14a/satoh-lab/haolin/nhk/excerpts/2010_01_08_19_00_1.webm;Yukio HATOYAMA.jpg;5413;5445;10889;180;181;1
/net/per920a/export/das14a/satoh-lab/haolin/nhk/excerpts/2010_01_08_19_00_1.webm;Yukio HATOYAMA.jpg;5461;5465;10889;182;182;0
/net/per920a/export/das14a/satoh-lab/haolin/nhk/excerpts/2010_01_08_19_00_1.webm;Yukio HATOYAMA.jpg;10821;10885;10889;360;362;2
/net/per920a/export/das14a/satoh-lab/haolin/nhk/excerpts/2010_01_08_19_00_1.webm;Seiji MAEHARA.jpg;4341;4409;10889;144;146;2
/net/per920a/export/das14a/satoh-lab/haolin/nhk/excerpts/2010_01_08_19_00_1.webm;Seiji MAEHARA.jpg;4425;4425;10889;147;147;0
/net/per920a/export/das14a/satoh-lab/haolin/nhk/excerpts/2010_01_08_19_00_1.webm;Seiji MAEHARA.jpg;4441;4445;10889;148;148;0
/net/per920a/export/das14a/satoh-lab/haolin/nhk/excerpts/2010_01_08_19_00_1.webm;Seiji MAEHARA.jpg;4477;4481;10889;149;149;0
/net/per920a/export/das14a/satoh-lab/haolin/nhk/excerpts/2010_01_08_19_00_1.webm;Seiji MAEHARA.jpg;4493;4501;10889;149;150;1
/net/per920a/export/das14a/satoh-lab/haolin/nhk/excerpts/2010_01_08_19_00_1.webm;Seiji MAEHARA.jpg;4513;4521;10889;150;150;0
/net/per920a/export/das14a/satoh-lab/haolin/nhk/excerpts/2010_01_08_19_00_1.webm;Seiji MAEHARA.jpg;4537;4553;10889;151;151;0
/net/per920a/export/das14a/satoh-lab/haolin/nhk/excerpts/2010_01_08_19_00_1.webm;Seiji MAEHARA.jpg;4581;4581;10889;152;152;0
/net/per920a/export/das14a/satoh-lab/haolin/nhk/excerpts/2010_01_08_19_00_1.webm;Seiji MAEHARA.jpg;4657;4661;10889;155;155;0
/net/per920a/export/das14a/satoh-lab/haolin/nhk/excerpts/2010_01_08_19_00_1.webm;Seiji MAEHARA.jpg;4709;4717;10889;156;157;1
/net/per920a/export/das14a/satoh-lab/haolin/nhk/excerpts/2010_01_08_19_00_1.webm;Seiji MAEHARA.jpg;4741;4741;10889;158;158;0
/net/per920a/export/das14a/satoh-lab/haolin/nhk/excerpts/2010_01_08_19_00_1.webm;Seiji MAEHARA.jpg;4809;4809;10889;160;160;0
/net/per920a/export/das14a/satoh-lab/haolin/nhk/excerpts/2010_01_08_19_00_1.webm;Seiji MAEHARA.jpg;4841;4841;10889;161;161;0
/net/per920a/export/das14a/satoh-lab/haolin/nhk/excerpts/2010_01_08_19_00_1.webm;Seiji MAEHARA.jpg;4889;4889;10889;162;162;0
/net/per920a/export/das14a/satoh-lab/haolin/nhk/excerpts/2010_01_08_19_00_1.webm;Seiji MAEHARA.jpg;5021;5025;10889;167;167;0
/net/per920a/export/das14a/satoh-lab/haolin/nhk/excerpts/2010_01_08_19_00_1.webm;Seiji MAEHARA.jpg;5053;5053;10889;168;168;0
/net/per920a/export/das14a/satoh-lab/haolin/nhk/excerpts/2010_01_08_19_00_1.webm;Seiji MAEHARA.jpg;5081;5085;10889;169;169;0
/net/per920a/export/das14a/satoh-lab/haolin/nhk/excerpts/2010_01_08_19_00_1.webm;Seiji MAEHARA.jpg;5149;5149;10889;171;171;0
/net/per920a/export/das14a/satoh-lab/haolin/nhk/excerpts/2010_01_08_19_00_1.webm;Seiji MAEHARA.jpg;5173;5173;10889;172;172;0
/net/per920a/export/das14a/satoh-lab/haolin/nhk/excerpts/2010_01_08_19_00_1.webm;Seiji MAEHARA.jpg;5209;5209;10889;173;173;0
/net/per920a/export/das14a/satoh-lab/haolin/nhk/excerpts/2010_01_08_19_00_1.webm;Seiji MAEHARA.jpg;5261;5269;10889;175;175;0
/net/per920a/export/das14a/satoh-lab/haolin/nhk/excerpts/2010_01_08_19_00_1.webm;Seiji MAEHARA.jpg;5297;5337;10889;176;177;1
/net/per920a/export/das14a/satoh-lab/haolin/nhk/excerpts/2010_01_08_19_00_1.webm;Seiji MAEHARA.jpg;5349;5349;10889;178;178;0
/net/per920a/export/das14a/satoh-lab/haolin/nhk/excerpts/2010_01_08_19_00_1.webm;Seiji MAEHARA.jpg;5361;5389;10889;178;179;1
/net/per920a/export/das14a/satoh-lab/haolin/nhk/excerpts/2010_01_08_19_00_1.webm;Seiji MAEHARA.jpg;5401;5401;10889;180;180;0
/net/per920a/export/das14a/satoh-lab/haolin/nhk/excerpts/2010_01_08_19_00_1.webm;Seiji MAEHARA.jpg;5413;5445;10889;180;181;1
/net/per920a/export/das14a/satoh-lab/haolin/nhk/excerpts/2010_01_08_19_00_1.webm;Seiji MAEHARA.jpg;5461;5465;10889;182;182;0
/net/per920a/export/das14a/satoh-lab/haolin/nhk/excerpts/2010_01_11_19_00_1.webm;Yukio HATOYAMA.jpg;33;33;4377;1;1;0
/net/per920a/export/das14a/satoh-lab/haolin/nhk/excerpts/2010_01_11_19_00_1.webm;Yukio HATOYAMA.jpg;45;49;4377;1;1;0
/net/per920a/export/das14a/satoh-lab/haolin/nhk/excerpts/2010_01_11_19_00_1.webm;Yukio HATOYAMA.jpg;61;105;4377;2;3;1
/net/per920a/export/das14a/satoh-lab/haolin/nhk/excerpts/2010_01_11_19_00_1.webm;Yukio HATOYAMA.jpg;121;177;4377;4;5;1
/net/per920a/export/das14a/satoh-lab/haolin/nhk/excerpts/2010_01_11_19_00_1.webm;Yukio HATOYAMA.jpg;193;489;4377;6;16;10
/net/per920a/export/das14a/satoh-lab/haolin/nhk/excerpts/2010_01_11_19_00_1.webm;Yukio HATOYAMA.jpg;505;557;4377;16;18;2
/net/per920a/export/das14a/satoh-lab/haolin/nhk/excerpts/2010_01_11_19_00_1.webm;Yukio HATOYAMA.jpg;573;589;4377;19;19;0
/net/per920a/export/das14a/satoh-lab/haolin/nhk/excerpts/2010_01_11_19_00_1.webm;Yukio HATOYAMA.jpg;809;813;4377;26;27;1
/net/per920a/export/das14a/satoh-lab/haolin/nhk/excerpts/2010_01_11_19_00_1.webm;Yukio HATOYAMA.jpg;825;825;4377;27;27;0
/net/per920a/export/das14a/satoh-lab/haolin/nhk/excerpts/2010_01_11_19_00_1.webm;Yukio HATOYAMA.jpg;841;893;4377;28;29;1
/net/per920a/export/das14a/satoh-lab/haolin/nhk/excerpts/2010_01_11_19_00_1.webm;Yukio HATOYAMA.jpg;945;957;4377;31;31;0
/net/per920a/export/das14a/satoh-lab/haolin/nhk/excerpts/2010_01_11_19_00_1.webm;Yukio HATOYAMA.jpg;969;1041;4377;32;34;2
/net/per920a/export/das14a/satoh-lab/haolin/nhk/excerpts/2010_01_11_19_00_1.webm;Yukio HATOYAMA.jpg;1057;1069;4377;35;35;0
/net/per920a/export/das14a/satoh-lab/haolin/nhk/excerpts/2010_01_11_19_00_1.webm;Yukio HATOYAMA.jpg;1085;1121;4377;36;37;1
/net/per920a/export/das14a/satoh-lab/haolin/nhk/excerpts/2010_01_11_19_00_1.webm;Yukio HATOYAMA.jpg;1729;1753;4377;57;58;1
/net/per920a/export/das14a/satoh-lab/haolin/nhk/excerpts/2010_01_11_19_00_1.webm;Yukio HATOYAMA.jpg;1769;1865;4377;59;62;3
/net/per920a/export/das14a/satoh-lab/haolin/nhk/excerpts/2010_01_11_19_00_1.webm;Ichiro OZAWA.jpg;45;49;4377;1;1;0
/net/per920a/export/das14a/satoh-lab/haolin/nhk/excerpts/2010_01_11_19_00_1.webm;Ichiro OZAWA.jpg;61;105;4377;2;3;1
/net/per920a/export/das14a/satoh-lab/haolin/nhk/excerpts/2010_01_11_19_00_1.webm;Ichiro OZAWA.jpg;121;177;4377;4;5;1
/net/per920a/export/das14a/satoh-lab/haolin/nhk/excerpts/2010_01_11_19_00_1.webm;Ichiro OZAWA.jpg;193;489;4377;6;16;10
/net/per920a/export/das14a/satoh-lab/haolin/nhk/excerpts/2010_01_11_19_00_1.webm;Ichiro OZAWA.jpg;505;557;4377;16;18;2
/net/per920a/export/das14a/satoh-lab/haolin/nhk/excerpts/2010_01_11_19_00_1.webm;Ichiro OZAWA.jpg;573;589;4377;19;19;0
/net/per920a/export/das14a/satoh-lab/haolin/nhk/excerpts/2010_01_11_19_00_1.webm;Ichiro OZAWA.jpg;1229;1241;4377;40;41;1
/net/per920a/export/das14a/satoh-lab/haolin/nhk/excerpts/2010_01_11_19_00_1.webm;Ichiro OZAWA.jpg;1253;1389;4377;41;46;5
/net/per920a/export/das14a/satoh-lab/haolin/nhk/excerpts/2010_01_11_19_00_1.webm;Ichiro OZAWA.jpg;1917;1933;4377;63;64;1
/net/per920a/export/das14a/satoh-lab/haolin/nhk/excerpts/2010_01_11_19_00_1.webm;Naoto KAN.jpg;909;925;4377;30;30;0
/net/per920a/export/das14a/satoh-lab/haolin/nhk/excerpts/2010_01_11_19_00_1.webm;Naoto KAN.jpg;2213;2249;4377;73;75;2
/net/per920a/export/das14a/satoh-lab/haolin/nhk/excerpts/2010_01_11_19_00_1.webm;Naoto KAN.jpg;2265;2281;4377;75;76;1
/net/per920a/export/das14a/satoh-lab/haolin/nhk/excerpts/2010_01_11_19_00_1.webm;Naoto KAN.jpg;2373;2433;4377;79;81;2
/net/per920a/export/das14a/satoh-lab/haolin/nhk/excerpts/2010_01_11_19_00_1.webm;Shintaro ISHIHARA.jpg;2145;2157;4377;71;71;0
/net/per920a/export/das14a/satoh-lab/haolin/nhk/excerpts/2010_01_11_19_00_1.webm;Shintaro ISHIHARA.jpg;2169;2181;4377;72;72;0
/net/per920a/export/das14a/satoh-lab/haolin/nhk/excerpts/2010_01_24_19_00_3.webm;Seiji MAEHARA.jpg;1341;1373;5345;44;45;1
/net/per920a/export/das14a/satoh-lab/haolin/nhk/excerpts/2010_01_24_19_00_3.webm;Seiji MAEHARA.jpg;1389;1409;5345;46;46;0
/net/per920a/export/das14a/satoh-lab/haolin/nhk/excerpts/2010_01_24_19_00_3.webm;Seiji MAEHARA.jpg;1425;1425;5345;47;47;0
/net/per920a/export/das14a/satoh-lab/haolin/nhk/excerpts/2010_01_24_19_00_3.webm;Seiji MAEHARA.jpg;1461;1513;5345;48;50;2
/net/per920a/export/das14a/satoh-lab/haolin/nhk/excerpts/2010_01_24_19_00_3.webm;Seiji MAEHARA.jpg;1529;1621;5345;50;53;3
/net/per920a/export/das14a/satoh-lab/haolin/nhk/excerpts/2010_01_24_19_00_3.webm;Seiji MAEHARA.jpg;1637;1649;5345;54;54;0
/net/per920a/export/das14a/satoh-lab/haolin/nhk/excerpts/2010_01_24_19_00_3.webm;Seiji MAEHARA.jpg;1665;1681;5345;55;55;0
/net/per920a/export/das14a/satoh-lab/haolin/nhk/excerpts/2010_01_24_19_00_3.webm;Seiji MAEHARA.jpg;1697;1817;5345;56;60;4
/net/per920a/export/das14a/satoh-lab/haolin/nhk/excerpts/2010_01_24_19_00_3.webm;Seiji MAEHARA.jpg;1841;1849;5345;61;61;0
/net/per920a/export/das14a/satoh-lab/haolin/nhk/excerpts/2010_01_24_19_00_3.webm;Seiji MAEHARA.jpg;1865;1929;5345;62;64;2
/net/per920a/export/das14a/satoh-lab/haolin/nhk/excerpts/2010_01_24_19_00_3.webm;Seiji MAEHARA.jpg;1949;2041;5345;64;67;3
/net/per920a/export/das14a/satoh-lab/haolin/nhk/excerpts/2010_01_24_19_00_3.webm;Seiji MAEHARA.jpg;2077;2109;5345;69;70;1
/net/per920a/export/das14a/satoh-lab/haolin/nhk/excerpts/2010_01_24_19_00_3.webm;Seiji MAEHARA.jpg;2141;2185;5345;71;72;1
/net/per920a/export/das14a/satoh-lab/haolin/nhk/excerpts/2010_01_24_19_00_3.webm;Seiji MAEHARA.jpg;2845;2849;5345;94;94;0
/net/per920a/export/das14a/satoh-lab/haolin/nhk/excerpts/2010_01_24_19_00_3.webm;Seiji MAEHARA.jpg;2885;2897;5345;96;96;0
/net/per920a/export/das14a/satoh-lab/haolin/nhk/excerpts/2010_01_24_19_00_3.webm;Seiji MAEHARA.jpg;2993;2993;5345;99;99;0
/net/per920a/export/das14a/satoh-lab/haolin/nhk/excerpts/2010_01_24_19_00_3.webm;Seiji MAEHARA.jpg;3009;3009;5345;100;100;0
/net/per920a/export/das14a/satoh-lab/haolin/nhk/excerpts/2010_01_24_19_00_3.webm;Seiji MAEHARA.jpg;3021;3049;5345;100;101;1
/net/per920a/export/das14a/satoh-lab/haolin/nhk/excerpts/2010_01_24_19_00_3.webm;Seiji MAEHARA.jpg;3061;3061;5345;101;101;0
/net/per920a/export/das14a/satoh-lab/haolin/nhk/excerpts/2010_01_24_19_00_3.webm;Seiji MAEHARA.jpg;3085;3085;5345;102;102;0
/net/per920a/export/das14a/satoh-lab/haolin/nhk/excerpts/2010_01_24_19_00_3.webm;Seiji MAEHARA.jpg;3113;3141;5345;103;104;1
/net/per920a/export/das14a/satoh-lab/haolin/nhk/excerpts/2010_01_31_19_00_1.webm;Ichiro OZAWA.jpg;9;641;3605;0;21;21
/net/per920a/export/das14a/satoh-lab/haolin/nhk/excerpts/2010_01_31_19_00_1.webm;Ichiro OZAWA.jpg;2349;2433;3605;78;80;2
/net/per920a/export/das14a/satoh-lab/haolin/nhk/excerpts/2010_01_31_19_00_1.webm;Ichiro OZAWA.jpg;2857;2905;3605;95;96;1
/net/per920a/export/das14a/satoh-lab/haolin/nhk/excerpts/2010_01_31_19_00_1.webm;Ichiro OZAWA.jpg;3057;3121;3605;101;103;2
/net/per920a/export/das14a/satoh-lab/haolin/nhk/excerpts/2010_01_31_19_00_1.webm;Ichiro OZAWA.jpg;3513;3597;3605;116;119;3
/net/per920a/export/das14a/satoh-lab/haolin/nhk/excerpts/2010_01_31_19_00_1.webm;Seiji MAEHARA.jpg;9;641;3605;0;21;21
/net/per920a/export/das14a/satoh-lab/haolin/nhk/excerpts/2010_01_31_19_00_1.webm;Seiji MAEHARA.jpg;653;1205;3605;21;40;19
/net/per920a/export/das14a/satoh-lab/haolin/nhk/excerpts/2010_01_31_19_00_1.webm;Seiji MAEHARA.jpg;1221;1225;3605;40;40;0
/net/per920a/export/das14a/satoh-lab/haolin/nhk/excerpts/2010_01_31_19_00_1.webm;Seiji MAEHARA.jpg;1285;1317;3605;42;43;1
/net/per920a/export/das14a/satoh-lab/haolin/nhk/excerpts/2010_01_31_19_00_1.webm;Seiji MAEHARA.jpg;1329;1329;3605;44;44;0
/net/per920a/export/das14a/satoh-lab/haolin/nhk/excerpts/2010_01_31_19_00_1.webm;Seiji MAEHARA.jpg;1361;1865;3605;45;62;17
/net/per920a/export/das14a/satoh-lab/haolin/nhk/excerpts/2010_01_31_19_00_1.webm;Seiji MAEHARA.jpg;1877;1901;3605;62;63;1
/net/per920a/export/das14a/satoh-lab/haolin/nhk/excerpts/2010_01_31_19_00_1.webm;Seiji MAEHARA.jpg;1913;2321;3605;63;77;14
/net/per920a/export/das14a/satoh-lab/haolin/nhk/excerpts/2010_01_31_19_00_1.webm;Yoshihiko Noda.jpg;2349;2433;3605;78;80;2
/net/per920a/export/das14a/satoh-lab/haolin/nhk/excerpts/2010_01_31_19_00_1.webm;Yoshihiko Noda.jpg;2445;2845;3605;81;94;13
/net/per920a/export/das14a/satoh-lab/haolin/nhk/excerpts/2010_01_31_19_00_1.webm;Yoshihiko Noda.jpg;2917;3045;3605;97;101;4
/net/per920a/export/das14a/satoh-lab/haolin/nhk/excerpts/2010_01_31_19_00_1.webm;Yoshihiko Noda.jpg;3133;3345;3605;104;111;7
/net/per920a/export/das14a/satoh-lab/haolin/nhk/excerpts/2010_01_31_19_00_1.webm;Yoshihiko Noda.jpg;3389;3501;3605;112;116;4
/net/per920a/export/das14a/satoh-lab/haolin/nhk/excerpts/2010_01_31_19_00_1.webm;Yoshihiko Noda.jpg;3513;3597;3605;116;119;3
/net/per920a/export/das14a/satoh-lab/haolin/nhk/excerpts/2010_01_31_19_00_1.webm;Yukio HATOYAMA.jpg;2349;2433;3605;78;80;2
/net/per920a/export/das14a/satoh-lab/haolin/nhk/excerpts/2010_01_31_19_00_1.webm;Yukio HATOYAMA.jpg;3513;3597;3605;116;119;3
/net/per920a/export/das14a/satoh-lab/haolin/nhk/excerpts/2010_02_08_19_00_2.webm;Ichiro OZAWA.jpg;9;393;15953;0;13;13
/net/per920a/export/das14a/satoh-lab/haolin/nhk/excerpts/2010_02_08_19_00_2.webm;Ichiro OZAWA.jpg;613;613;15953;20;20;0
/net/per920a/export/das14a/satoh-lab/haolin/nhk/excerpts/2010_02_08_19_00_2.webm;Ichiro OZAWA.jpg;629;665;15953;20;22;2
/net/per920a/export/das14a/satoh-lab/haolin/nhk/excerpts/2010_02_08_19_00_2.webm;Ichiro OZAWA.jpg;865;869;15953;28;28;0
/net/per920a/export/das14a/satoh-lab/haolin/nhk/excerpts/2010_02_08_19_00_2.webm;Ichiro OZAWA.jpg;4697;4729;15953;156;157;1
/net/per920a/export/das14a/satoh-lab/haolin/nhk/excerpts/2010_02_08_19_00_2.webm;Ichiro OZAWA.jpg;4745;4873;15953;158;162;4
/net/per920a/export/das14a/satoh-lab/haolin/nhk/excerpts/2010_02_08_19_00_2.webm;Ichiro OZAWA.jpg;5049;5621;15953;168;187;19
/net/per920a/export/das14a/satoh-lab/haolin/nhk/excerpts/2010_02_08_19_00_2.webm;Ichiro OZAWA.jpg;5637;5733;15953;187;191;4
/net/per920a/export/das14a/satoh-lab/haolin/nhk/excerpts/2010_02_08_19_00_2.webm;Ichiro OZAWA.jpg;5749;5877;15953;191;195;4
/net/per920a/export/das14a/satoh-lab/haolin/nhk/excerpts/2010_02_08_19_00_2.webm;Ichiro OZAWA.jpg;5897;5901;15953;196;196;0
/net/per920a/export/das14a/satoh-lab/haolin/nhk/excerpts/2010_02_08_19_00_2.webm;Ichiro OZAWA.jpg;5937;5953;15953;197;198;1
/net/per920a/export/das14a/satoh-lab/haolin/nhk/excerpts/2010_02_08_19_00_2.webm;Ichiro OZAWA.jpg;5969;5985;15953;199;199;0
/net/per920a/export/das14a/satoh-lab/haolin/nhk/excerpts/2010_02_08_19_00_2.webm;Ichiro OZAWA.jpg;6005;6013;15953;200;200;0
/net/per920a/export/das14a/satoh-lab/haolin/nhk/excerpts/2010_02_08_19_00_2.webm;Ichiro OZAWA.jpg;6029;6089;15953;201;203;2
/net/per920a/export/das14a/satoh-lab/haolin/nhk/excerpts/2010_02_08_19_00_2.webm;Ichiro OZAWA.jpg;7349;7349;15953;245;245;0
/net/per920a/export/das14a/satoh-lab/haolin/nhk/excerpts/2010_02_08_19_00_2.webm;Ichiro OZAWA.jpg;7361;7389;15953;245;246;1
/net/per920a/export/das14a/satoh-lab/haolin/nhk/excerpts/2010_02_08_19_00_2.webm;Ichiro OZAWA.jpg;7405;7469;15953;246;249;3
/net/per920a/export/das14a/satoh-lab/haolin/nhk/excerpts/2010_02_08_19_00_2.webm;Ichiro OZAWA.jpg;7489;7597;15953;249;253;4
/net/per920a/export/das14a/satoh-lab/haolin/nhk/excerpts/2010_02_08_19_00_2.webm;Ichiro OZAWA.jpg;7613;7621;15953;253;254;1
/net/per920a/export/das14a/satoh-lab/haolin/nhk/excerpts/2010_02_08_19_00_2.webm;Ichiro OZAWA.jpg;7645;7685;15953;254;256;2
/net/per920a/export/das14a/satoh-lab/haolin/nhk/excerpts/2010_02_08_19_00_2.webm;Ichiro OZAWA.jpg;7701;7717;15953;256;257;1
/net/per920a/export/das14a/satoh-lab/haolin/nhk/excerpts/2010_02_08_19_00_2.webm;Ichiro OZAWA.jpg;7737;7765;15953;258;258;0
/net/per920a/export/das14a/satoh-lab/haolin/nhk/excerpts/2010_02_08_19_00_2.webm;Ichiro OZAWA.jpg;7781;7849;15953;259;261;2
/net/per920a/export/das14a/satoh-lab/haolin/nhk/excerpts/2010_02_08_19_00_2.webm;Ichiro OZAWA.jpg;7865;7929;15953;262;264;2
/net/per920a/export/das14a/satoh-lab/haolin/nhk/excerpts/2010_02_08_19_00_2.webm;Ichiro OZAWA.jpg;7945;7953;15953;264;265;1
/net/per920a/export/das14a/satoh-lab/haolin/nhk/excerpts/2010_02_08_19_00_2.webm;Ichiro OZAWA.jpg;7981;7993;15953;266;266;0
/net/per920a/export/das14a/satoh-lab/haolin/nhk/excerpts/2010_02_08_19_00_2.webm;Ichiro OZAWA.jpg;8017;8053;15953;267;268;1
/net/per920a/export/das14a/satoh-lab/haolin/nhk/excerpts/2010_02_08_19_00_2.webm;Ichiro OZAWA.jpg;8069;8101;15953;269;270;1
/net/per920a/export/das14a/satoh-lab/haolin/nhk/excerpts/2010_02_08_19_00_2.webm;Ichiro OZAWA.jpg;8117;8133;15953;270;271;1
/net/per920a/export/das14a/satoh-lab/haolin/nhk/excerpts/2010_02_08_19_00_2.webm;Ichiro OZAWA.jpg;8149;8161;15953;271;272;1
/net/per920a/export/das14a/satoh-lab/haolin/nhk/excerpts/2010_02_08_19_00_2.webm;Ichiro OZAWA.jpg;8177;8261;15953;272;275;3
/net/per920a/export/das14a/satoh-lab/haolin/nhk/excerpts/2010_02_08_19_00_2.webm;Ichiro OZAWA.jpg;8277;8293;15953;276;276;0
/net/per920a/export/das14a/satoh-lab/haolin/nhk/excerpts/2010_02_08_19_00_2.webm;Ichiro OZAWA.jpg;8317;8345;15953;277;278;1
/net/per920a/export/das14a/satoh-lab/haolin/nhk/excerpts/2010_02_08_19_00_2.webm;Ichiro OZAWA.jpg;8361;8389;15953;278;279;1
/net/per920a/export/das14a/satoh-lab/haolin/nhk/excerpts/2010_02_08_19_00_2.webm;Ichiro OZAWA.jpg;8421;8441;15953;280;281;1
/net/per920a/export/das14a/satoh-lab/haolin/nhk/excerpts/2010_02_08_19_00_2.webm;Ichiro OZAWA.jpg;8457;8473;15953;282;282;0
/net/per920a/export/das14a/satoh-lab/haolin/nhk/excerpts/2010_02_08_19_00_2.webm;Ichiro OZAWA.jpg;8489;8525;15953;283;284;1
/net/per920a/export/das14a/satoh-lab/haolin/nhk/excerpts/2010_02_08_19_00_2.webm;Ichiro OZAWA.jpg;8553;8585;15953;285;286;1
/net/per920a/export/das14a/satoh-lab/haolin/nhk/excerpts/2010_02_08_19_00_2.webm;Ichiro OZAWA.jpg;8605;8841;15953;286;294;8
/net/per920a/export/das14a/satoh-lab/haolin/nhk/excerpts/2010_02_08_19_00_2.webm;Ichiro OZAWA.jpg;8857;8957;15953;295;298;3
/net/per920a/export/das14a/satoh-lab/haolin/nhk/excerpts/2010_02_08_19_00_2.webm;Ichiro OZAWA.jpg;8973;8993;15953;299;299;0
/net/per920a/export/das14a/satoh-lab/haolin/nhk/excerpts/2010_02_08_19_00_2.webm;Ichiro OZAWA.jpg;9009;9013;15953;300;300;0
/net/per920a/export/das14a/satoh-lab/haolin/nhk/excerpts/2010_02_08_19_00_2.webm;Yukio HATOYAMA.jpg;497;497;15953;16;16;0
/net/per920a/export/das14a/satoh-lab/haolin/nhk/excerpts/2010_02_08_19_00_2.webm;Yukio HATOYAMA.jpg;1033;1033;15953;34;34;0
/net/per920a/export/das14a/satoh-lab/haolin/nhk/excerpts/2010_02_08_19_00_2.webm;Yukio HATOYAMA.jpg;1045;1049;15953;34;34;0
/net/per920a/export/das14a/satoh-lab/haolin/nhk/excerpts/2010_02_08_19_00_2.webm;Yukio HATOYAMA.jpg;1061;1081;15953;35;36;1
/net/per920a/export/das14a/satoh-lab/haolin/nhk/excerpts/2010_02_08_19_00_2.webm;Yukio HATOYAMA.jpg;1109;1109;15953;36;36;0
/net/per920a/export/das14a/satoh-lab/haolin/nhk/excerpts/2010_02_08_19_00_2.webm;Yukio HATOYAMA.jpg;1129;1145;15953;37;38;1
/net/per920a/export/das14a/satoh-lab/haolin/nhk/excerpts/2010_02_08_19_00_2.webm;Yukio HATOYAMA.jpg;1157;1217;15953;38;40;2
/net/per920a/export/das14a/satoh-lab/haolin/nhk/excerpts/2010_02_08_19_00_2.webm;Yukio HATOYAMA.jpg;4197;4209;15953;139;140;1
/net/per920a/export/das14a/satoh-lab/haolin/nhk/excerpts/2010_02_08_19_00_2.webm;Yukio HATOYAMA.jpg;4225;4237;15953;140;141;1
/net/per920a/export/das14a/satoh-lab/haolin/nhk/excerpts/2010_02_08_19_00_2.webm;Yukio HATOYAMA.jpg;4253;4273;15953;141;142;1
/net/per920a/export/das14a/satoh-lab/haolin/nhk/excerpts/2010_02_08_19_00_2.webm;Yukio HATOYAMA.jpg;4289;4497;15953;143;149;6
/net/per920a/export/das14a/satoh-lab/haolin/nhk/excerpts/2010_02_08_19_00_2.webm;Yukio HATOYAMA.jpg;4513;4573;15953;150;152;2
/net/per920a/export/das14a/satoh-lab/haolin/nhk/excerpts/2010_02_08_19_00_2.webm;Yukio HATOYAMA.jpg;9057;9081;15953;302;302;0
/net/per920a/export/das14a/satoh-lab/haolin/nhk/excerpts/2010_02_08_19_00_2.webm;Yukio HATOYAMA.jpg;9109;9261;15953;303;308;5
/net/per920a/export/das14a/satoh-lab/haolin/nhk/excerpts/2010_02_08_19_00_2.webm;Yukio HATOYAMA.jpg;9277;9277;15953;309;309;0
/net/per920a/export/das14a/satoh-lab/haolin/nhk/excerpts/2010_02_08_19_00_2.webm;Yukio HATOYAMA.jpg;9661;9853;15953;322;328;6
/net/per920a/export/das14a/satoh-lab/haolin/nhk/excerpts/2010_02_08_19_00_2.webm;Yukio HATOYAMA.jpg;9869;10453;15953;329;348;19
/net/per920a/export/das14a/satoh-lab/haolin/nhk/excerpts/2010_02_08_19_00_2.webm;Yukio HATOYAMA.jpg;11169;11177;15953;372;372;0
/net/per920a/export/das14a/satoh-lab/haolin/nhk/excerpts/2010_02_08_19_00_2.webm;Yukio HATOYAMA.jpg;11193;11477;15953;373;382;9
/net/per920a/export/das14a/satoh-lab/haolin/nhk/excerpts/2010_02_08_19_00_2.webm;Yukio HATOYAMA.jpg;11493;11673;15953;383;389;6
/net/per920a/export/das14a/satoh-lab/haolin/nhk/excerpts/2010_02_08_19_00_2.webm;Yukio HATOYAMA.jpg;11689;12093;15953;389;403;14
/net/per920a/export/das14a/satoh-lab/haolin/nhk/excerpts/2010_02_08_19_00_2.webm;Yukio HATOYAMA.jpg;12109;12225;15953;403;407;4
/net/per920a/export/das14a/satoh-lab/haolin/nhk/excerpts/2010_02_08_19_00_2.webm;Yukio HATOYAMA.jpg;12237;12237;15953;408;408;0
/net/per920a/export/das14a/satoh-lab/haolin/nhk/excerpts/2010_02_08_19_00_2.webm;Yukio HATOYAMA.jpg;12249;12257;15953;408;408;0
/net/per920a/export/das14a/satoh-lab/haolin/nhk/excerpts/2010_02_08_19_00_2.webm;Yukio HATOYAMA.jpg;12277;12297;15953;409;410;1
/net/per920a/export/das14a/satoh-lab/haolin/nhk/excerpts/2010_02_08_19_00_2.webm;Yukio HATOYAMA.jpg;12309;12333;15953;410;411;1
/net/per920a/export/das14a/satoh-lab/haolin/nhk/excerpts/2010_02_08_19_00_2.webm;Yukio HATOYAMA.jpg;12353;12385;15953;411;413;2
/net/per920a/export/das14a/satoh-lab/haolin/nhk/excerpts/2010_02_08_19_00_2.webm;Yukio HATOYAMA.jpg;12425;12425;15953;414;414;0
/net/per920a/export/das14a/satoh-lab/haolin/nhk/excerpts/2010_02_08_19_00_2.webm;Yukio HATOYAMA.jpg;12445;12517;15953;415;417;2
/net/per920a/export/das14a/satoh-lab/haolin/nhk/excerpts/2010_02_08_19_00_2.webm;Yukio HATOYAMA.jpg;12541;12565;15953;418;419;1
/net/per920a/export/das14a/satoh-lab/haolin/nhk/excerpts/2010_02_08_19_00_2.webm;Yukio HATOYAMA.jpg;12585;12717;15953;419;424;5
/net/per920a/export/das14a/satoh-lab/haolin/nhk/excerpts/2010_02_08_19_00_2.webm;Yukio HATOYAMA.jpg;12773;12777;15953;425;426;1
/net/per920a/export/das14a/satoh-lab/haolin/nhk/excerpts/2010_02_08_19_00_2.webm;Yukio HATOYAMA.jpg;12789;12985;15953;426;433;7
/net/per920a/export/das14a/satoh-lab/haolin/nhk/excerpts/2010_02_08_19_00_2.webm;Yukio HATOYAMA.jpg;13001;13017;15953;433;434;1
/net/per920a/export/das14a/satoh-lab/haolin/nhk/excerpts/2010_02_08_19_00_2.webm;Yukio HATOYAMA.jpg;13033;13053;15953;434;435;1
/net/per920a/export/das14a/satoh-lab/haolin/nhk/excerpts/2010_02_08_19_00_2.webm;Yukio HATOYAMA.jpg;13833;14189;15953;461;473;12
/net/per920a/export/das14a/satoh-lab/haolin/nhk/excerpts/2010_02_08_19_00_2.webm;Yukio HATOYAMA.jpg;14345;14349;15953;478;478;0
/net/per920a/export/das14a/satoh-lab/haolin/nhk/excerpts/2010_02_08_19_00_2.webm;Yukio HATOYAMA.jpg;14361;14517;15953;478;484;6
/net/per920a/export/das14a/satoh-lab/haolin/nhk/excerpts/2010_02_08_19_00_2.webm;Yukio HATOYAMA.jpg;15325;15325;15953;511;511;0
/net/per920a/export/das14a/satoh-lab/haolin/nhk/excerpts/2010_02_08_19_00_2.webm;Yukio HATOYAMA.jpg;15337;15337;15953;511;511;0
/net/per920a/export/das14a/satoh-lab/haolin/nhk/excerpts/2010_02_08_19_00_2.webm;Yukio HATOYAMA.jpg;15349;15389;15953;511;513;2
/net/per920a/export/das14a/satoh-lab/haolin/nhk/excerpts/2010_02_08_19_00_2.webm;Yukio HATOYAMA.jpg;15401;15497;15953;513;516;3
/net/per920a/export/das14a/satoh-lab/haolin/nhk/excerpts/2010_02_08_19_00_2.webm;Yukio HATOYAMA.jpg;15509;15841;15953;517;528;11
/net/per920a/export/das14a/satoh-lab/haolin/nhk/excerpts/2010_02_08_19_00_2.webm;Yukio HATOYAMA.jpg;15873;15881;15953;529;529;0
/net/per920a/export/das14a/satoh-lab/haolin/nhk/excerpts/2010_02_08_19_00_2.webm;Yukio HATOYAMA.jpg;15893;15949;15953;529;531;2
/net/per920a/export/das14a/satoh-lab/haolin/nhk/excerpts/2010_02_08_19_00_2.webm;Natsuo YAMAGUCHI.jpg;1961;2097;15953;65;69;4
/net/per920a/export/das14a/satoh-lab/haolin/nhk/excerpts/2010_02_08_19_00_2.webm;Mizuho FUKUSHIMA.jpg;6493;6553;15953;216;218;2
/net/per920a/export/das14a/satoh-lab/haolin/nhk/excerpts/2010_02_08_19_00_2.webm;Mizuho FUKUSHIMA.jpg;6569;6613;15953;219;220;1
/net/per920a/export/das14a/satoh-lab/haolin/nhk/excerpts/2010_02_08_19_00_2.webm;Mizuho FUKUSHIMA.jpg;6653;6689;15953;221;223;2
/net/per920a/export/das14a/satoh-lab/haolin/nhk/excerpts/2010_02_08_19_00_2.webm;Mizuho FUKUSHIMA.jpg;6713;6713;15953;223;223;0
/net/per920a/export/das14a/satoh-lab/haolin/nhk/excerpts/2010_02_08_19_00_2.webm;Mizuho FUKUSHIMA.jpg;6733;6745;15953;224;224;0
/net/per920a/export/das14a/satoh-lab/haolin/nhk/excerpts/2010_02_08_19_00_2.webm;Kazuo SHII.jpg;13609;13613;15953;453;453;0
/net/per920a/export/das14a/satoh-lab/haolin/nhk/excerpts/2010_02_22_19_00_2.webm;Yukio HATOYAMA.jpg;597;609;13945;19;20;1
/net/per920a/export/das14a/satoh-lab/haolin/nhk/excerpts/2010_02_22_19_00_2.webm;Yukio HATOYAMA.jpg;653;693;13945;21;23;2
/net/per920a/export/das14a/satoh-lab/haolin/nhk/excerpts/2010_02_22_19_00_2.webm;Yukio HATOYAMA.jpg;705;713;13945;23;23;0
/net/per920a/export/das14a/satoh-lab/haolin/nhk/excerpts/2010_02_22_19_00_2.webm;Yukio HATOYAMA.jpg;729;1245;13945;24;41;17
/net/per920a/export/das14a/satoh-lab/haolin/nhk/excerpts/2010_02_22_19_00_2.webm;Yukio HATOYAMA.jpg;6965;7109;13945;232;237;5
/net/per920a/export/das14a/satoh-lab/haolin/nhk/excerpts/2010_02_22_19_00_2.webm;Yukio HATOYAMA.jpg;7469;7473;13945;249;249;0
/net/per920a/export/das14a/satoh-lab/haolin/nhk/excerpts/2010_02_22_19_00_2.webm;Yukio HATOYAMA.jpg;7501;7517;13945;250;250;0
/net/per920a/export/das14a/satoh-lab/haolin/nhk/excerpts/2010_02_22_19_00_2.webm;Yukio HATOYAMA.jpg;7533;7533;13945;251;251;0
/net/per920a/export/das14a/satoh-lab/haolin/nhk/excerpts/2010_02_22_19_00_2.webm;Yukio HATOYAMA.jpg;7909;7921;13945;263;264;1
/net/per920a/export/das14a/satoh-lab/haolin/nhk/excerpts/2010_02_22_19_00_2.webm;Yukio HATOYAMA.jpg;7937;7941;13945;264;264;0
/net/per920a/export/das14a/satoh-lab/haolin/nhk/excerpts/2010_02_22_19_00_2.webm;Yukio HATOYAMA.jpg;7961;7961;13945;265;265;0
/net/per920a/export/das14a/satoh-lab/haolin/nhk/excerpts/2010_02_22_19_00_2.webm;Yukio HATOYAMA.jpg;7973;7977;13945;265;265;0
/net/per920a/export/das14a/satoh-lab/haolin/nhk/excerpts/2010_02_22_19_00_2.webm;Yukio HATOYAMA.jpg;7997;8001;13945;266;266;0
/net/per920a/export/das14a/satoh-lab/haolin/nhk/excerpts/2010_02_22_19_00_2.webm;Yukio HATOYAMA.jpg;8017;8017;13945;267;267;0
/net/per920a/export/das14a/satoh-lab/haolin/nhk/excerpts/2010_02_22_19_00_2.webm;Yukio HATOYAMA.jpg;8029;8033;13945;267;267;0
/net/per920a/export/das14a/satoh-lab/haolin/nhk/excerpts/2010_02_22_19_00_2.webm;Yukio HATOYAMA.jpg;8049;8049;13945;268;268;0
/net/per920a/export/das14a/satoh-lab/haolin/nhk/excerpts/2010_02_22_19_00_2.webm;Yukio HATOYAMA.jpg;8129;8145;13945;271;271;0
/net/per920a/export/das14a/satoh-lab/haolin/nhk/excerpts/2010_02_22_19_00_2.webm;Yukio HATOYAMA.jpg;8181;8209;13945;272;273;1
/net/per920a/export/das14a/satoh-lab/haolin/nhk/excerpts/2010_02_22_19_00_2.webm;Yukio HATOYAMA.jpg;8777;9101;13945;292;303;11
/net/per920a/export/das14a/satoh-lab/haolin/nhk/excerpts/2010_02_22_19_00_2.webm;Yukio HATOYAMA.jpg;9121;9129;13945;304;304;0
/net/per920a/export/das14a/satoh-lab/haolin/nhk/excerpts/2010_02_22_19_00_2.webm;Yukio HATOYAMA.jpg;9145;9673;13945;304;322;18
/net/per920a/export/das14a/satoh-lab/haolin/nhk/excerpts/2010_02_22_19_00_2.webm;Yukio HATOYAMA.jpg;10065;10081;13945;335;336;1
/net/per920a/export/das14a/satoh-lab/haolin/nhk/excerpts/2010_02_22_19_00_2.webm;Yukio HATOYAMA.jpg;10093;10093;13945;336;336;0
/net/per920a/export/das14a/satoh-lab/haolin/nhk/excerpts/2010_02_22_19_00_2.webm;Yukio HATOYAMA.jpg;10105;10217;13945;336;340;4
/net/per920a/export/das14a/satoh-lab/haolin/nhk/excerpts/2010_02_22_19_00_2.webm;Yukio HATOYAMA.jpg;12225;12237;13945;407;408;1
/net/per920a/export/das14a/satoh-lab/haolin/nhk/excerpts/2010_02_22_19_00_2.webm;Yukio HATOYAMA.jpg;12261;12269;13945;408;409;1
/net/per920a/export/das14a/satoh-lab/haolin/nhk/excerpts/2010_02_22_19_00_2.webm;Yukio HATOYAMA.jpg;12289;12293;13945;409;409;0
/net/per920a/export/das14a/satoh-lab/haolin/nhk/excerpts/2010_02_22_19_00_2.webm;Yukio HATOYAMA.jpg;12313;12349;13945;410;411;1
/net/per920a/export/das14a/satoh-lab/haolin/nhk/excerpts/2010_02_22_19_00_2.webm;Yukio HATOYAMA.jpg;12365;12497;13945;412;416;4
/net/per920a/export/das14a/satoh-lab/haolin/nhk/excerpts/2010_02_22_19_00_2.webm;Yukio HATOYAMA.jpg;12513;12533;13945;417;417;0
/net/per920a/export/das14a/satoh-lab/haolin/nhk/excerpts/2010_02_22_19_00_2.webm;Ichiro OZAWA.jpg;3773;3829;13945;125;127;2
/net/per920a/export/das14a/satoh-lab/haolin/nhk/excerpts/2010_02_22_19_00_2.webm;Ichiro OZAWA.jpg;3845;4289;13945;128;143;15
/net/per920a/export/das14a/satoh-lab/haolin/nhk/excerpts/2010_02_22_19_00_2.webm;Ichiro OZAWA.jpg;4305;4521;13945;143;150;7
/net/per920a/export/das14a/satoh-lab/haolin/nhk/excerpts/2010_02_22_19_00_2.webm;Ichiro OZAWA.jpg;4537;4597;13945;151;153;2
/net/per920a/export/das14a/satoh-lab/haolin/nhk/excerpts/2010_02_22_19_00_2.webm;Ichiro OZAWA.jpg;4613;4641;13945;153;154;1
/net/per920a/export/das14a/satoh-lab/haolin/nhk/excerpts/2010_02_22_19_00_2.webm;Ichiro OZAWA.jpg;4657;4721;13945;155;157;2
/net/per920a/export/das14a/satoh-lab/haolin/nhk/excerpts/2010_02_22_19_00_2.webm;Ichiro OZAWA.jpg;10253;10273;13945;341;342;1
/net/per920a/export/das14a/satoh-lab/haolin/nhk/excerpts/2010_02_22_19_00_2.webm;Ichiro OZAWA.jpg;10365;10369;13945;345;345;0
/net/per920a/export/das14a/satoh-lab/haolin/nhk/excerpts/2010_02_22_19_00_2.webm;Sadakazu TANIGAKI.jpg;5345;5345;13945;178;178;0
/net/per920a/export/das14a/satoh-lab/haolin/nhk/excerpts/2010_02_22_19_00_2.webm;Sadakazu TANIGAKI.jpg;5357;5357;13945;178;178;0
/net/per920a/export/das14a/satoh-lab/haolin/nhk/excerpts/2010_02_22_19_00_2.webm;Sadakazu TANIGAKI.jpg;5369;5385;13945;179;179;0
/net/per920a/export/das14a/satoh-lab/haolin/nhk/excerpts/2010_02_22_19_00_2.webm;Sadakazu TANIGAKI.jpg;5969;6021;13945;199;200;1
/net/per920a/export/das14a/satoh-lab/haolin/nhk/excerpts/2010_02_22_19_00_2.webm;Sadakazu TANIGAKI.jpg;6037;6261;13945;201;208;7
/net/per920a/export/das14a/satoh-lab/haolin/nhk/excerpts/2010_02_22_19_00_2.webm;Sadakazu TANIGAKI.jpg;6277;6293;13945;209;209;0
/net/per920a/export/das14a/satoh-lab/haolin/nhk/excerpts/2010_02_22_19_00_2.webm;Sadakazu TANIGAKI.jpg;6309;6321;13945;210;210;0
/net/per920a/export/das14a/satoh-lab/haolin/nhk/excerpts/2010_02_22_19_00_2.webm;Sadakazu TANIGAKI.jpg;6337;6453;13945;211;215;4
/net/per920a/export/das14a/satoh-lab/haolin/nhk/excerpts/2010_02_22_19_00_2.webm;Sadakazu TANIGAKI.jpg;10409;10449;13945;347;348;1
/net/per920a/export/das14a/satoh-lab/haolin/nhk/excerpts/2010_02_22_19_00_2.webm;Sadakazu TANIGAKI.jpg;10465;10549;13945;348;351;3
/net/per920a/export/das14a/satoh-lab/haolin/nhk/excerpts/2010_02_22_19_00_2.webm;Sadakazu TANIGAKI.jpg;10581;10581;13945;352;352;0
/net/per920a/export/das14a/satoh-lab/haolin/nhk/excerpts/2010_02_22_19_00_2.webm;Sadakazu TANIGAKI.jpg;10593;10597;13945;353;353;0
/net/per920a/export/das14a/satoh-lab/haolin/nhk/excerpts/2010_02_22_19_00_2.webm;Sadakazu TANIGAKI.jpg;10609;10641;13945;353;354;1
/net/per920a/export/das14a/satoh-lab/haolin/nhk/excerpts/2010_02_22_19_00_2.webm;Sadakazu TANIGAKI.jpg;10697;10801;13945;356;360;4
/net/per920a/export/das14a/satoh-lab/haolin/nhk/excerpts/2010_02_22_19_00_2.webm;Sadakazu TANIGAKI.jpg;10813;10821;13945;360;360;0
/net/per920a/export/das14a/satoh-lab/haolin/nhk/excerpts/2010_02_22_19_00_2.webm;Sadakazu TANIGAKI.jpg;10833;10965;13945;361;365;4
/net/per920a/export/das14a/satoh-lab/haolin/nhk/excerpts/2010_02_22_19_00_2.webm;Takenori KANZAKI.jpg;7617;7669;13945;253;255;2
/net/per920a/export/das14a/satoh-lab/haolin/nhk/excerpts/2010_02_22_19_00_2.webm;Takenori KANZAKI.jpg;8221;8641;13945;274;288;14
/net/per920a/export/das14a/satoh-lab/haolin/nhk/excerpts/2010_02_22_19_00_2.webm;Natsuo YAMAGUCHI.jpg;11313;11393;13945;377;379;2
/net/per920a/export/das14a/satoh-lab/haolin/nhk/excerpts/2010_02_22_19_00_2.webm;Natsuo YAMAGUCHI.jpg;11409;11589;13945;380;386;6
/net/per920a/export/das14a/satoh-lab/haolin/nhk/excerpts/2010_03_02_19_00_1.webm;Yukio HATOYAMA.jpg;9;541;7317;0;18;18
/net/per920a/export/das14a/satoh-lab/haolin/nhk/excerpts/2010_03_02_19_00_1.webm;Yukio HATOYAMA.jpg;557;573;7317;18;19;1
/net/per920a/export/das14a/satoh-lab/haolin/nhk/excerpts/2010_03_02_19_00_1.webm;Yukio HATOYAMA.jpg;585;589;7317;19;19;0
/net/per920a/export/das14a/satoh-lab/haolin/nhk/excerpts/2010_03_02_19_00_1.webm;Yukio HATOYAMA.jpg;601;625;7317;20;20;0
/net/per920a/export/das14a/satoh-lab/haolin/nhk/excerpts/2010_03_02_19_00_1.webm;Yukio HATOYAMA.jpg;645;645;7317;21;21;0
/net/per920a/export/das14a/satoh-lab/haolin/nhk/excerpts/2010_03_02_19_00_1.webm;Yukio HATOYAMA.jpg;657;661;7317;21;22;1
/net/per920a/export/das14a/satoh-lab/haolin/nhk/excerpts/2010_03_02_19_00_1.webm;Yukio HATOYAMA.jpg;681;693;7317;22;23;1
/net/per920a/export/das14a/satoh-lab/haolin/nhk/excerpts/2010_03_02_19_00_1.webm;Yukio HATOYAMA.jpg;717;849;7317;23;28;5
/net/per920a/export/das14a/satoh-lab/haolin/nhk/excerpts/2010_03_02_19_00_1.webm;Yukio HATOYAMA.jpg;865;865;7317;28;28;0
/net/per920a/export/das14a/satoh-lab/haolin/nhk/excerpts/2010_03_02_19_00_1.webm;Yukio HATOYAMA.jpg;881;1021;7317;29;34;5
/net/per920a/export/das14a/satoh-lab/haolin/nhk/excerpts/2010_03_02_19_00_1.webm;Yukio HATOYAMA.jpg;1181;1289;7317;39;42;3
/net/per920a/export/das14a/satoh-lab/haolin/nhk/excerpts/2010_03_02_19_00_1.webm;Yukio HATOYAMA.jpg;1501;1501;7317;50;50;0
/net/per920a/export/das14a/satoh-lab/haolin/nhk/excerpts/2010_03_02_19_00_1.webm;Yukio HATOYAMA.jpg;3365;3833;7317;112;127;15
/net/per920a/export/das14a/satoh-lab/haolin/nhk/excerpts/2010_03_02_19_00_1.webm;Yukio HATOYAMA.jpg;7153;7177;7317;238;239;1
/net/per920a/export/das14a/satoh-lab/haolin/nhk/excerpts/2010_03_02_19_00_1.webm;Yukio HATOYAMA.jpg;7217;7217;7317;240;240;0
/net/per920a/export/das14a/satoh-lab/haolin/nhk/excerpts/2010_03_02_19_00_1.webm;Yukio HATOYAMA.jpg;7229;7233;7317;241;241;0
/net/per920a/export/das14a/satoh-lab/haolin/nhk/excerpts/2010_03_02_19_00_1.webm;Yukio HATOYAMA.jpg;7261;7273;7317;242;242;0
/net/per920a/export/das14a/satoh-lab/haolin/nhk/excerpts/2010_03_02_19_00_1.webm;Yukio HATOYAMA.jpg;7293;7313;7317;243;243;0
/net/per920a/export/das14a/satoh-lab/haolin/nhk/excerpts/2010_03_02_19_00_1.webm;Takenori KANZAKI.jpg;1725;1749;7317;57;58;1
/net/per920a/export/das14a/satoh-lab/haolin/nhk/excerpts/2010_03_02_19_00_1.webm;Takenori KANZAKI.jpg;1765;1989;7317;58;66;8
/net/per920a/export/das14a/satoh-lab/haolin/nhk/excerpts/2010_03_02_19_00_1.webm;Takenori KANZAKI.jpg;2005;2353;7317;66;78;12
/net/per920a/export/das14a/satoh-lab/haolin/nhk/excerpts/2010_03_12_19_00_1.webm;Naoto KAN.jpg;11817;12317;17929;394;410;16
/net/per920a/export/das14a/satoh-lab/haolin/nhk/excerpts/2010_03_16_19_00_3.webm;Katsuya OKADA.jpg;593;649;6277;19;21;2
/net/per920a/export/das14a/satoh-lab/haolin/nhk/excerpts/2010_03_16_19_00_3.webm;Katsuya OKADA.jpg;669;685;6277;22;22;0
/net/per920a/export/das14a/satoh-lab/haolin/nhk/excerpts/2010_03_16_19_00_3.webm;Katsuya OKADA.jpg;705;725;6277;23;24;1
/net/per920a/export/das14a/satoh-lab/haolin/nhk/excerpts/2010_03_16_19_00_3.webm;Katsuya OKADA.jpg;737;749;6277;24;24;0
/net/per920a/export/das14a/satoh-lab/haolin/nhk/excerpts/2010_03_16_19_00_3.webm;Katsuya OKADA.jpg;765;769;6277;25;25;0
/net/per920a/export/das14a/satoh-lab/haolin/nhk/excerpts/2010_03_16_19_00_3.webm;Katsuya OKADA.jpg;1461;1469;6277;48;48;0
/net/per920a/export/das14a/satoh-lab/haolin/nhk/excerpts/2010_03_16_19_00_3.webm;Katsuya OKADA.jpg;1493;1497;6277;49;49;0
/net/per920a/export/das14a/satoh-lab/haolin/nhk/excerpts/2010_03_16_19_00_3.webm;Katsuya OKADA.jpg;1513;1565;6277;50;52;2
/net/per920a/export/das14a/satoh-lab/haolin/nhk/excerpts/2010_03_16_19_00_3.webm;Katsuya OKADA.jpg;1581;1581;6277;52;52;0
/net/per920a/export/das14a/satoh-lab/haolin/nhk/excerpts/2010_03_16_19_00_3.webm;Katsuya OKADA.jpg;1597;1601;6277;53;53;0
/net/per920a/export/das14a/satoh-lab/haolin/nhk/excerpts/2010_03_16_19_00_3.webm;Katsuya OKADA.jpg;1625;1821;6277;54;60;6
/net/per920a/export/das14a/satoh-lab/haolin/nhk/excerpts/2010_03_16_19_00_3.webm;Katsuya OKADA.jpg;1837;2357;6277;61;78;17
/net/per920a/export/das14a/satoh-lab/haolin/nhk/excerpts/2010_03_16_19_00_3.webm;Toru Hashimoto.jpg;2381;2381;6277;79;79;0
/net/per920a/export/das14a/satoh-lab/haolin/nhk/excerpts/2010_03_16_19_00_3.webm;Toru Hashimoto.jpg;2405;2597;6277;80;86;6
/net/per920a/export/das14a/satoh-lab/haolin/nhk/excerpts/2010_03_16_19_00_3.webm;Toru Hashimoto.jpg;2609;2613;6277;86;87;1
/net/per920a/export/das14a/satoh-lab/haolin/nhk/excerpts/2010_03_16_19_00_3.webm;Toru Hashimoto.jpg;2629;2653;6277;87;88;1
/net/per920a/export/das14a/satoh-lab/haolin/nhk/excerpts/2010_03_16_19_00_3.webm;Toru Hashimoto.jpg;2669;2685;6277;88;89;1
/net/per920a/export/das14a/satoh-lab/haolin/nhk/excerpts/2010_03_16_19_00_3.webm;Toru Hashimoto.jpg;2697;2981;6277;89;99;10
/net/per920a/export/das14a/satoh-lab/haolin/nhk/excerpts/2010_03_16_19_00_3.webm;Yukio HATOYAMA.jpg;5101;5109;6277;169;170;1
/net/per920a/export/das14a/satoh-lab/haolin/nhk/excerpts/2010_03_16_19_00_3.webm;Yukio HATOYAMA.jpg;5125;5169;6277;170;172;2
/net/per920a/export/das14a/satoh-lab/haolin/nhk/excerpts/2010_03_16_19_00_3.webm;Yukio HATOYAMA.jpg;5233;5249;6277;174;174;0
/net/per920a/export/das14a/satoh-lab/haolin/nhk/excerpts/2010_03_16_19_00_3.webm;Yukio HATOYAMA.jpg;5269;5309;6277;175;176;1
/net/per920a/export/das14a/satoh-lab/haolin/nhk/excerpts/2010_03_16_19_00_3.webm;Yukio HATOYAMA.jpg;5325;5353;6277;177;178;1
/net/per920a/export/das14a/satoh-lab/haolin/nhk/excerpts/2010_03_20_19_00_3.webm;Yukio HATOYAMA.jpg;9;393;1773;0;13;13
/net/per920a/export/das14a/satoh-lab/haolin/nhk/excerpts/2010_03_20_19_00_3.webm;Yukio HATOYAMA.jpg;461;605;1773;15;20;5
/net/per920a/export/das14a/satoh-lab/haolin/nhk/excerpts/2010_03_20_19_00_3.webm;Yukio HATOYAMA.jpg;669;817;1773;22;27;5
/net/per920a/export/das14a/satoh-lab/haolin/nhk/excerpts/2010_03_20_19_00_3.webm;Yukio HATOYAMA.jpg;1225;1261;1773;40;41;1
/net/per920a/export/das14a/satoh-lab/haolin/nhk/excerpts/2010_03_20_19_00_3.webm;Yukio HATOYAMA.jpg;1273;1585;1773;42;52;10
/net/per920a/export/das14a/satoh-lab/haolin/nhk/excerpts/2010_03_20_19_00_3.webm;Yukio HATOYAMA.jpg;1601;1697;1773;53;56;3
/net/per920a/export/das14a/satoh-lab/haolin/nhk/excerpts/2010_04_28_19_00_1.webm;Yukio HATOYAMA.jpg;9;901;15589;0;30;30
/net/per920a/export/das14a/satoh-lab/haolin/nhk/excerpts/2010_04_28_19_00_1.webm;Yukio HATOYAMA.jpg;1689;1793;15589;56;59;3
/net/per920a/export/das14a/satoh-lab/haolin/nhk/excerpts/2010_04_28_19_00_1.webm;Yukio HATOYAMA.jpg;1809;1865;15589;60;62;2
/net/per920a/export/das14a/satoh-lab/haolin/nhk/excerpts/2010_04_28_19_00_1.webm;Yukio HATOYAMA.jpg;2525;2537;15589;84;84;0
/net/per920a/export/das14a/satoh-lab/haolin/nhk/excerpts/2010_04_28_19_00_1.webm;Yukio HATOYAMA.jpg;2553;2693;15589;85;89;4
/net/per920a/export/das14a/satoh-lab/haolin/nhk/excerpts/2010_04_28_19_00_1.webm;Yukio HATOYAMA.jpg;2717;2821;15589;90;94;4
/net/per920a/export/das14a/satoh-lab/haolin/nhk/excerpts/2010_04_28_19_00_1.webm;Yukio HATOYAMA.jpg;2837;3149;15589;94;105;11
/net/per920a/export/das14a/satoh-lab/haolin/nhk/excerpts/2010_04_28_19_00_1.webm;Yukio HATOYAMA.jpg;3173;3229;15589;105;107;2
/net/per920a/export/das14a/satoh-lab/haolin/nhk/excerpts/2010_04_28_19_00_1.webm;Yukio HATOYAMA.jpg;3245;3285;15589;108;109;1
/net/per920a/export/das14a/satoh-lab/haolin/nhk/excerpts/2010_04_28_19_00_1.webm;Yukio HATOYAMA.jpg;3317;3357;15589;110;111;1
/net/per920a/export/das14a/satoh-lab/haolin/nhk/excerpts/2010_04_28_19_00_1.webm;Yukio HATOYAMA.jpg;3965;4329;15589;132;144;12
/net/per920a/export/das14a/satoh-lab/haolin/nhk/excerpts/2010_04_28_19_00_1.webm;Yukio HATOYAMA.jpg;13185;13201;15589;439;440;1
/net/per920a/export/das14a/satoh-lab/haolin/nhk/excerpts/2010_04_28_19_00_1.webm;Yukio HATOYAMA.jpg;13213;13213;15589;440;440;0
/net/per920a/export/das14a/satoh-lab/haolin/nhk/excerpts/2010_04_28_19_00_1.webm;Yukio HATOYAMA.jpg;13225;13229;15589;441;441;0
/net/per920a/export/das14a/satoh-lab/haolin/nhk/excerpts/2010_04_28_19_00_1.webm;Yukio HATOYAMA.jpg;13249;13249;15589;441;441;0
/net/per920a/export/das14a/satoh-lab/haolin/nhk/excerpts/2010_04_28_19_00_1.webm;Yukio HATOYAMA.jpg;13265;13273;15589;442;442;0
/net/per920a/export/das14a/satoh-lab/haolin/nhk/excerpts/2010_04_28_19_00_1.webm;Yukio HATOYAMA.jpg;13293;13293;15589;443;443;0
/net/per920a/export/das14a/satoh-lab/haolin/nhk/excerpts/2010_04_28_19_00_1.webm;Yukio HATOYAMA.jpg;13385;13389;15589;446;446;0
/net/per920a/export/das14a/satoh-lab/haolin/nhk/excerpts/2010_04_28_19_00_1.webm;Yukio HATOYAMA.jpg;13405;13429;15589;447;447;0
/net/per920a/export/das14a/satoh-lab/haolin/nhk/excerpts/2010_04_28_19_00_1.webm;Yukio HATOYAMA.jpg;13529;13561;15589;451;452;1
/net/per920a/export/das14a/satoh-lab/haolin/nhk/excerpts/2010_04_28_19_00_1.webm;Yukio HATOYAMA.jpg;13573;13589;15589;452;453;1
/net/per920a/export/das14a/satoh-lab/haolin/nhk/excerpts/2010_04_28_19_00_1.webm;Yukio HATOYAMA.jpg;13601;13613;15589;453;454;1
/net/per920a/export/das14a/satoh-lab/haolin/nhk/excerpts/2010_04_28_19_00_1.webm;Yukio HATOYAMA.jpg;14197;14229;15589;473;474;1
/net/per920a/export/das14a/satoh-lab/haolin/nhk/excerpts/2010_04_28_19_00_1.webm;Yukio HATOYAMA.jpg;14245;14565;15589;475;485;10
/net/per920a/export/das14a/satoh-lab/haolin/nhk/excerpts/2010_04_28_19_00_1.webm;Shizuka KAMEI.jpg;12409;12941;15589;413;431;18
/net/per920a/export/das14a/satoh-lab/haolin/nhk/excerpts/2010_04_28_19_00_1.webm;Sadakazu TANIGAKI.jpg;12957;13105;15589;432;437;5
/net/per920a/export/das14a/satoh-lab/haolin/nhk/excerpts/2010_05_15_19_00_2.webm;Yukio HATOYAMA.jpg;1185;1245;1625;39;41;2
/net/per920a/export/das14a/satoh-lab/haolin/nhk/excerpts/2010_05_15_19_00_2.webm;Yukio HATOYAMA.jpg;1257;1261;1625;41;41;0
/net/per920a/export/das14a/satoh-lab/haolin/nhk/excerpts/2010_05_15_19_00_2.webm;Yukio HATOYAMA.jpg;1273;1349;1625;42;44;2
/net/per920a/export/das14a/satoh-lab/haolin/nhk/excerpts/2010_05_15_19_00_2.webm;Yukio HATOYAMA.jpg;1365;1365;1625;45;45;0
/net/per920a/export/das14a/satoh-lab/haolin/nhk/excerpts/2010_05_15_19_00_2.webm;Yukio HATOYAMA.jpg;1381;1385;1625;45;46;1
/net/per920a/export/das14a/satoh-lab/haolin/nhk/excerpts/2010_05_28_19_00_3.webm;Mizuho FUKUSHIMA.jpg;9033;9217;17741;301;307;6
/net/per920a/export/das14a/satoh-lab/haolin/nhk/excerpts/2010_05_28_19_00_3.webm;Mizuho FUKUSHIMA.jpg;9349;9361;17741;311;312;1
/net/per920a/export/das14a/satoh-lab/haolin/nhk/excerpts/2010_05_28_19_00_3.webm;Mizuho FUKUSHIMA.jpg;9385;9385;17741;313;313;0
/net/per920a/export/das14a/satoh-lab/haolin/nhk/excerpts/2010_05_28_19_00_3.webm;Mizuho FUKUSHIMA.jpg;9413;9413;17741;314;314;0
/net/per920a/export/das14a/satoh-lab/haolin/nhk/excerpts/2010_05_28_19_00_3.webm;Mizuho FUKUSHIMA.jpg;9433;9433;17741;314;314;0
/net/per920a/export/das14a/satoh-lab/haolin/nhk/excerpts/2010_05_28_19_00_3.webm;Mizuho FUKUSHIMA.jpg;9445;9457;17741;315;315;0
/net/per920a/export/das14a/satoh-lab/haolin/nhk/excerpts/2010_05_28_19_00_3.webm;Mizuho FUKUSHIMA.jpg;9469;9485;17741;315;316;1
/net/per920a/export/das14a/satoh-lab/haolin/nhk/excerpts/2010_05_28_19_00_3.webm;Mizuho FUKUSHIMA.jpg;9505;9517;17741;317;317;0
/net/per920a/export/das14a/satoh-lab/haolin/nhk/excerpts/2010_05_28_19_00_3.webm;Mizuho FUKUSHIMA.jpg;9601;9601;17741;320;320;0
/net/per920a/export/das14a/satoh-lab/haolin/nhk/excerpts/2010_05_28_19_00_3.webm;Mizuho FUKUSHIMA.jpg;9613;9621;17741;320;321;1
/net/per920a/export/das14a/satoh-lab/haolin/nhk/excerpts/2010_05_28_19_00_3.webm;Mizuho FUKUSHIMA.jpg;9637;9653;17741;321;322;1
/net/per920a/export/das14a/satoh-lab/haolin/nhk/excerpts/2010_05_28_19_00_3.webm;Mizuho FUKUSHIMA.jpg;9741;9749;17741;325;325;0
/net/per920a/export/das14a/satoh-lab/haolin/nhk/excerpts/2010_05_28_19_00_3.webm;Mizuho FUKUSHIMA.jpg;9769;9773;17741;325;326;1
/net/per920a/export/das14a/satoh-lab/haolin/nhk/excerpts/2010_05_28_19_00_3.webm;Mizuho FUKUSHIMA.jpg;9785;9821;17741;326;327;1
/net/per920a/export/das14a/satoh-lab/haolin/nhk/excerpts/2010_05_28_19_00_3.webm;Mizuho FUKUSHIMA.jpg;9837;9837;17741;328;328;0
/net/per920a/export/das14a/satoh-lab/haolin/nhk/excerpts/2010_05_28_19_00_3.webm;Mizuho FUKUSHIMA.jpg;9869;9909;17741;329;330;1
/net/per920a/export/das14a/satoh-lab/haolin/nhk/excerpts/2010_05_28_19_00_3.webm;Mizuho FUKUSHIMA.jpg;9925;9929;17741;331;331;0
/net/per920a/export/das14a/satoh-lab/haolin/nhk/excerpts/2010_05_28_19_00_3.webm;Mizuho FUKUSHIMA.jpg;9941;10013;17741;331;334;3
/net/per920a/export/das14a/satoh-lab/haolin/nhk/excerpts/2010_05_28_19_00_3.webm;Mizuho FUKUSHIMA.jpg;10829;10873;17741;361;362;1
/net/per920a/export/das14a/satoh-lab/haolin/nhk/excerpts/2010_05_28_19_00_3.webm;Mizuho FUKUSHIMA.jpg;10897;10897;17741;363;363;0
/net/per920a/export/das14a/satoh-lab/haolin/nhk/excerpts/2010_05_28_19_00_3.webm;Mizuho FUKUSHIMA.jpg;10909;10909;17741;364;364;0
/net/per920a/export/das14a/satoh-lab/haolin/nhk/excerpts/2010_05_28_19_00_3.webm;Mizuho FUKUSHIMA.jpg;10921;10921;17741;364;364;0
/net/per920a/export/das14a/satoh-lab/haolin/nhk/excerpts/2010_05_28_19_00_3.webm;Mizuho FUKUSHIMA.jpg;10933;10945;17741;364;365;1
/net/per920a/export/das14a/satoh-lab/haolin/nhk/excerpts/2010_05_28_19_00_3.webm;Mizuho FUKUSHIMA.jpg;10961;10973;17741;365;366;1
/net/per920a/export/das14a/satoh-lab/haolin/nhk/excerpts/2010_05_28_19_00_3.webm;Mizuho FUKUSHIMA.jpg;10993;11025;17741;366;367;1
/net/per920a/export/das14a/satoh-lab/haolin/nhk/excerpts/2010_05_28_19_00_3.webm;Mizuho FUKUSHIMA.jpg;11041;11089;17741;368;370;2
/net/per920a/export/das14a/satoh-lab/haolin/nhk/excerpts/2010_05_28_19_00_3.webm;Mizuho FUKUSHIMA.jpg;11109;11109;17741;370;370;0
/net/per920a/export/das14a/satoh-lab/haolin/nhk/excerpts/2010_05_28_19_00_3.webm;Mizuho FUKUSHIMA.jpg;11121;11257;17741;371;375;4
/net/per920a/export/das14a/satoh-lab/haolin/nhk/excerpts/2010_05_28_19_00_3.webm;Mizuho FUKUSHIMA.jpg;11321;11325;17741;377;377;0
/net/per920a/export/das14a/satoh-lab/haolin/nhk/excerpts/2010_05_28_19_00_3.webm;Mizuho FUKUSHIMA.jpg;11341;11341;17741;378;378;0
/net/per920a/export/das14a/satoh-lab/haolin/nhk/excerpts/2010_05_28_19_00_3.webm;Mizuho FUKUSHIMA.jpg;11381;11385;17741;379;379;0
/net/per920a/export/das14a/satoh-lab/haolin/nhk/excerpts/2010_05_28_19_00_3.webm;Mizuho FUKUSHIMA.jpg;11401;11437;17741;380;381;1
/net/per920a/export/das14a/satoh-lab/haolin/nhk/excerpts/2010_05_28_19_00_3.webm;Mizuho FUKUSHIMA.jpg;11453;11601;17741;382;387;5
/net/per920a/export/das14a/satoh-lab/haolin/nhk/excerpts/2010_05_28_19_00_3.webm;Mizuho FUKUSHIMA.jpg;11629;11753;17741;388;392;4
/net/per920a/export/das14a/satoh-lab/haolin/nhk/excerpts/2010_05_28_19_00_3.webm;Mizuho FUKUSHIMA.jpg;16569;16577;17741;552;553;1
/net/per920a/export/das14a/satoh-lab/haolin/nhk/excerpts/2010_05_28_19_00_3.webm;Mizuho FUKUSHIMA.jpg;16593;16681;17741;553;556;3
/net/per920a/export/das14a/satoh-lab/haolin/nhk/excerpts/2010_05_28_19_00_3.webm;Mizuho FUKUSHIMA.jpg;16697;16709;17741;557;557;0
/net/per920a/export/das14a/satoh-lab/haolin/nhk/excerpts/2010_05_28_19_00_3.webm;Mizuho FUKUSHIMA.jpg;16725;16737;17741;558;558;0
/net/per920a/export/das14a/satoh-lab/haolin/nhk/excerpts/2010_05_28_19_00_3.webm;Mizuho FUKUSHIMA.jpg;16753;16829;17741;559;561;2
/net/per920a/export/das14a/satoh-lab/haolin/nhk/excerpts/2010_05_28_19_00_3.webm;Mizuho FUKUSHIMA.jpg;16841;16845;17741;561;562;1
/net/per920a/export/das14a/satoh-lab/haolin/nhk/excerpts/2010_05_28_19_00_3.webm;Mizuho FUKUSHIMA.jpg;16857;17009;17741;562;567;5
/net/per920a/export/das14a/satoh-lab/haolin/nhk/excerpts/2010_05_28_19_00_3.webm;Mizuho FUKUSHIMA.jpg;17025;17073;17741;568;569;1
/net/per920a/export/das14a/satoh-lab/haolin/nhk/excerpts/2010_05_28_19_00_3.webm;Mizuho FUKUSHIMA.jpg;17089;17093;17741;570;570;0
/net/per920a/export/das14a/satoh-lab/haolin/nhk/excerpts/2010_05_28_19_00_3.webm;Mizuho FUKUSHIMA.jpg;17109;17413;17741;570;581;11
/net/per920a/export/das14a/satoh-lab/haolin/nhk/excerpts/2010_05_28_19_00_3.webm;Yukio HATOYAMA.jpg;10829;10873;17741;361;362;1
/net/per920a/export/das14a/satoh-lab/haolin/nhk/excerpts/2010_05_28_19_00_3.webm;Yukio HATOYAMA.jpg;10897;10897;17741;363;363;0
/net/per920a/export/das14a/satoh-lab/haolin/nhk/excerpts/2010_05_28_19_00_3.webm;Yukio HATOYAMA.jpg;10909;10909;17741;364;364;0
/net/per920a/export/das14a/satoh-lab/haolin/nhk/excerpts/2010_05_28_19_00_3.webm;Yukio HATOYAMA.jpg;10933;10945;17741;364;365;1
/net/per920a/export/das14a/satoh-lab/haolin/nhk/excerpts/2010_05_28_19_00_3.webm;Yukio HATOYAMA.jpg;10961;10973;17741;365;366;1
/net/per920a/export/das14a/satoh-lab/haolin/nhk/excerpts/2010_05_28_19_00_3.webm;Yukio HATOYAMA.jpg;10993;11025;17741;366;367;1
/net/per920a/export/das14a/satoh-lab/haolin/nhk/excerpts/2010_05_28_19_00_3.webm;Yukio HATOYAMA.jpg;11041;11089;17741;368;370;2
/net/per920a/export/das14a/satoh-lab/haolin/nhk/excerpts/2010_05_28_19_00_3.webm;Yukio HATOYAMA.jpg;11121;11257;17741;371;375;4
/net/per920a/export/das14a/satoh-lab/haolin/nhk/excerpts/2010_05_28_19_00_3.webm;Yukio HATOYAMA.jpg;11285;11293;17741;376;376;0
/net/per920a/export/das14a/satoh-lab/haolin/nhk/excerpts/2010_05_28_19_00_3.webm;Yukio HATOYAMA.jpg;11309;11325;17741;377;377;0
/net/per920a/export/das14a/satoh-lab/haolin/nhk/excerpts/2010_05_28_19_00_3.webm;Yukio HATOYAMA.jpg;11341;11341;17741;378;378;0
/net/per920a/export/das14a/satoh-lab/haolin/nhk/excerpts/2010_05_28_19_00_3.webm;Yukio HATOYAMA.jpg;11365;11365;17741;379;379;0
/net/per920a/export/das14a/satoh-lab/haolin/nhk/excerpts/2010_05_28_19_00_3.webm;Yukio HATOYAMA.jpg;11381;11385;17741;379;379;0
/net/per920a/export/das14a/satoh-lab/haolin/nhk/excerpts/2010_05_28_19_00_3.webm;Yukio HATOYAMA.jpg;11401;11437;17741;380;381;1
/net/per920a/export/das14a/satoh-lab/haolin/nhk/excerpts/2010_05_28_19_00_3.webm;Yukio HATOYAMA.jpg;11453;11601;17741;382;387;5
/net/per920a/export/das14a/satoh-lab/haolin/nhk/excerpts/2010_05_28_19_00_3.webm;Yukio HATOYAMA.jpg;11629;11753;17741;388;392;4
/net/per920a/export/das14a/satoh-lab/haolin/nhk/excerpts/2010_05_28_19_00_3.webm;Yukio HATOYAMA.jpg;12713;12713;17741;424;424;0
/net/per920a/export/das14a/satoh-lab/haolin/nhk/excerpts/2010_05_28_19_00_3.webm;Yukio HATOYAMA.jpg;12729;12729;17741;424;424;0
/net/per920a/export/das14a/satoh-lab/haolin/nhk/excerpts/2010_05_28_19_00_3.webm;Yukio HATOYAMA.jpg;12761;12809;17741;425;427;2
/net/per920a/export/das14a/satoh-lab/haolin/nhk/excerpts/2010_05_28_19_00_3.webm;Yukio HATOYAMA.jpg;12853;12857;17741;428;429;1
/net/per920a/export/das14a/satoh-lab/haolin/nhk/excerpts/2010_05_28_19_00_3.webm;Yukio HATOYAMA.jpg;12925;12961;17741;431;432;1
/net/per920a/export/das14a/satoh-lab/haolin/nhk/excerpts/2010_05_28_19_00_3.webm;Yukio HATOYAMA.jpg;15077;15181;17741;503;506;3
/net/per920a/export/das14a/satoh-lab/haolin/nhk/excerpts/2010_05_28_19_00_3.webm;Yukio HATOYAMA.jpg;16073;16365;17741;536;546;10
/net/per920a/export/das14a/satoh-lab/haolin/nhk/excerpts/2010_05_28_19_00_3.webm;Yukio HATOYAMA.jpg;16569;16577;17741;552;553;1
/net/per920a/export/das14a/satoh-lab/haolin/nhk/excerpts/2010_05_28_19_00_3.webm;Yukio HATOYAMA.jpg;16593;16681;17741;553;556;3
/net/per920a/export/das14a/satoh-lab/haolin/nhk/excerpts/2010_05_28_19_00_3.webm;Yukio HATOYAMA.jpg;16697;16709;17741;557;557;0
/net/per920a/export/das14a/satoh-lab/haolin/nhk/excerpts/2010_05_28_19_00_3.webm;Yukio HATOYAMA.jpg;16725;16737;17741;558;558;0
/net/per920a/export/das14a/satoh-lab/haolin/nhk/excerpts/2010_05_28_19_00_3.webm;Yukio HATOYAMA.jpg;16753;16829;17741;559;561;2
/net/per920a/export/das14a/satoh-lab/haolin/nhk/excerpts/2010_05_28_19_00_3.webm;Yukio HATOYAMA.jpg;16857;17009;17741;562;567;5
/net/per920a/export/das14a/satoh-lab/haolin/nhk/excerpts/2010_05_28_19_00_3.webm;Yukio HATOYAMA.jpg;17025;17073;17741;568;569;1
/net/per920a/export/das14a/satoh-lab/haolin/nhk/excerpts/2010_05_28_19_00_3.webm;Yukio HATOYAMA.jpg;17089;17093;17741;570;570;0
/net/per920a/export/das14a/satoh-lab/haolin/nhk/excerpts/2010_05_28_19_00_3.webm;Yukio HATOYAMA.jpg;17109;17413;17741;570;581;11
/net/per920a/export/das14a/satoh-lab/haolin/nhk/excerpts/2010_06_03_19_00_3.webm;Seiji MAEHARA.jpg;45;77;8633;1;2;1
/net/per920a/export/das14a/satoh-lab/haolin/nhk/excerpts/2010_06_03_19_00_3.webm;Seiji MAEHARA.jpg;361;361;8633;12;12;0
/net/per920a/export/das14a/satoh-lab/haolin/nhk/excerpts/2010_06_03_19_00_3.webm;Seiji MAEHARA.jpg;373;385;8633;12;12;0
/net/per920a/export/das14a/satoh-lab/haolin/nhk/excerpts/2010_06_03_19_00_3.webm;Seiji MAEHARA.jpg;401;413;8633;13;13;0
/net/per920a/export/das14a/satoh-lab/haolin/nhk/excerpts/2010_06_03_19_00_3.webm;Seiji MAEHARA.jpg;429;433;8633;14;14;0
/net/per920a/export/das14a/satoh-lab/haolin/nhk/excerpts/2010_06_03_19_00_3.webm;Seiji MAEHARA.jpg;461;481;8633;15;16;1
/net/per920a/export/das14a/satoh-lab/haolin/nhk/excerpts/2010_06_03_19_00_3.webm;Seiji MAEHARA.jpg;505;513;8633;16;17;1
/net/per920a/export/das14a/satoh-lab/haolin/nhk/excerpts/2010_06_03_19_00_3.webm;Seiji MAEHARA.jpg;577;577;8633;19;19;0
/net/per920a/export/das14a/satoh-lab/haolin/nhk/excerpts/2010_06_03_19_00_3.webm;Seiji MAEHARA.jpg;593;601;8633;19;20;1
/net/per920a/export/das14a/satoh-lab/haolin/nhk/excerpts/2010_06_03_19_00_3.webm;Seiji MAEHARA.jpg;617;629;8633;20;20;0
/net/per920a/export/das14a/satoh-lab/haolin/nhk/excerpts/2010_06_03_19_00_3.webm;Seiji MAEHARA.jpg;753;753;8633;25;25;0
/net/per920a/export/das14a/satoh-lab/haolin/nhk/excerpts/2010_06_03_19_00_3.webm;Seiji MAEHARA.jpg;789;805;8633;26;26;0
/net/per920a/export/das14a/satoh-lab/haolin/nhk/excerpts/2010_06_03_19_00_3.webm;Yoshihiko Noda.jpg;837;877;8633;27;29;2
/net/per920a/export/das14a/satoh-lab/haolin/nhk/excerpts/2010_06_03_19_00_3.webm;Yoshihiko Noda.jpg;977;981;8633;32;32;0
/net/per920a/export/das14a/satoh-lab/haolin/nhk/excerpts/2010_06_03_19_00_3.webm;Yoshihiko Noda.jpg;993;993;8633;33;33;0
/net/per920a/export/das14a/satoh-lab/haolin/nhk/excerpts/2010_06_03_19_00_3.webm;Yoshihiko Noda.jpg;1005;1061;8633;33;35;2
/net/per920a/export/das14a/satoh-lab/haolin/nhk/excerpts/2010_06_03_19_00_3.webm;Yoshihiko Noda.jpg;1077;1325;8633;35;44;9
/net/per920a/export/das14a/satoh-lab/haolin/nhk/excerpts/2010_06_03_19_00_3.webm;Yoshihiko Noda.jpg;1337;1345;8633;44;44;0
/net/per920a/export/das14a/satoh-lab/haolin/nhk/excerpts/2010_06_03_19_00_3.webm;Yoshihiko Noda.jpg;1357;1361;8633;45;45;0
/net/per920a/export/das14a/satoh-lab/haolin/nhk/excerpts/2010_06_03_19_00_3.webm;Yoshihiko Noda.jpg;1393;1433;8633;46;47;1
/net/per920a/export/das14a/satoh-lab/haolin/nhk/excerpts/2010_06_03_19_00_3.webm;Yoshihiko Noda.jpg;1445;1517;8633;48;50;2
/net/per920a/export/das14a/satoh-lab/haolin/nhk/excerpts/2010_06_03_19_00_3.webm;Yoshihiko Noda.jpg;1537;1561;8633;51;52;1
/net/per920a/export/das14a/satoh-lab/haolin/nhk/excerpts/2010_06_03_19_00_3.webm;Yoshihiko Noda.jpg;1577;1585;8633;52;52;0
/net/per920a/export/das14a/satoh-lab/haolin/nhk/excerpts/2010_06_03_19_00_3.webm;Yoshihiko Noda.jpg;1601;1633;8633;53;54;1
/net/per920a/export/das14a/satoh-lab/haolin/nhk/excerpts/2010_06_03_19_00_3.webm;Yoshihiko Noda.jpg;1649;1653;8633;55;55;0
/net/per920a/export/das14a/satoh-lab/haolin/nhk/excerpts/2010_06_03_19_00_3.webm;Yoshihiko Noda.jpg;1673;1725;8633;55;57;2
/net/per920a/export/das14a/satoh-lab/haolin/nhk/excerpts/2010_06_07_19_00_2.webm;Seiji MAEHARA.jpg;2041;2041;3905;67;67;0
/net/per920a/export/das14a/satoh-lab/haolin/nhk/excerpts/2010_06_07_19_00_2.webm;Seiji MAEHARA.jpg;2065;2065;3905;68;68;0
/net/per920a/export/das14a/satoh-lab/haolin/nhk/excerpts/2010_06_07_19_00_2.webm;Seiji MAEHARA.jpg;2085;2093;3905;69;69;0
/net/per920a/export/das14a/satoh-lab/haolin/nhk/excerpts/2010_06_07_19_00_2.webm;Seiji MAEHARA.jpg;2145;2157;3905;71;71;0
/net/per920a/export/das14a/satoh-lab/haolin/nhk/excerpts/2010_06_07_19_00_2.webm;Yukio EDANO.jpg;3537;3669;3905;117;122;5
/net/per920a/export/das14a/satoh-lab/haolin/nhk/excerpts/2010_06_07_19_00_2.webm;Yukio EDANO.jpg;3685;3785;3905;122;126;4
/net/per920a/export/das14a/satoh-lab/haolin/nhk/excerpts/2010_06_07_19_00_2.webm;Yukio EDANO.jpg;3805;3817;3905;126;127;1
/net/per920a/export/das14a/satoh-lab/haolin/nhk/excerpts/2010_06_07_19_00_2.webm;Yukio EDANO.jpg;3833;3877;3905;127;129;2
/net/per920a/export/das14a/satoh-lab/haolin/nhk/excerpts/2010_06_07_19_00_2.webm;Yukio EDANO.jpg;3893;3901;3905;129;129;0
/net/per920a/export/das14a/satoh-lab/haolin/nhk/excerpts/2010_06_07_19_00_3.webm;Yukio EDANO.jpg;9;277;481;0;9;9
/net/per920a/export/das14a/satoh-lab/haolin/nhk/excerpts/2010_06_07_19_00_3.webm;Yukio EDANO.jpg;293;377;481;9;12;3
/net/per920a/export/das14a/satoh-lab/haolin/nhk/excerpts/2010_06_07_19_00_3.webm;Yukio EDANO.jpg;393;397;481;13;13;0
/net/per920a/export/das14a/satoh-lab/haolin/nhk/excerpts/2010_06_07_19_00_3.webm;Yukio EDANO.jpg;413;477;481;13;15;2
/net/per920a/export/das14a/satoh-lab/haolin/nhk/excerpts/2010_06_16_19_00_1.webm;Ichiro OZAWA.jpg;485;493;6693;16;16;0
/net/per920a/export/das14a/satoh-lab/haolin/nhk/excerpts/2010_06_16_19_00_1.webm;Ichiro OZAWA.jpg;505;505;6693;16;16;0
/net/per920a/export/das14a/satoh-lab/haolin/nhk/excerpts/2010_06_16_19_00_1.webm;Ichiro OZAWA.jpg;529;553;6693;17;18;1
/net/per920a/export/das14a/satoh-lab/haolin/nhk/excerpts/2010_06_16_19_00_1.webm;Naoto KAN.jpg;1833;1941;6693;61;64;3
/net/per920a/export/das14a/satoh-lab/haolin/nhk/excerpts/2010_06_16_19_00_1.webm;Naoto KAN.jpg;3541;3561;6693;117;118;1
/net/per920a/export/das14a/satoh-lab/haolin/nhk/excerpts/2010_06_16_19_00_1.webm;Naoto KAN.jpg;3657;3689;6693;121;122;1
/net/per920a/export/das14a/satoh-lab/haolin/nhk/excerpts/2010_06_16_19_00_1.webm;Naoto KAN.jpg;3737;3745;6693;124;124;0
/net/per920a/export/das14a/satoh-lab/haolin/nhk/excerpts/2010_06_16_19_00_1.webm;Naoto KAN.jpg;5397;5397;6693;179;179;0
/net/per920a/export/das14a/satoh-lab/haolin/nhk/excerpts/2010_06_16_19_00_1.webm;Naoto KAN.jpg;5413;5417;6693;180;180;0
/net/per920a/export/das14a/satoh-lab/haolin/nhk/excerpts/2010_06_16_19_00_1.webm;Naoto KAN.jpg;5433;5441;6693;181;181;0
/net/per920a/export/das14a/satoh-lab/haolin/nhk/excerpts/2010_06_16_19_00_1.webm;Naoto KAN.jpg;5553;5717;6693;185;190;5
/net/per920a/export/das14a/satoh-lab/haolin/nhk/excerpts/2010_06_16_19_00_1.webm;Naoto KAN.jpg;5733;6145;6693;191;204;13
/net/per920a/export/das14a/satoh-lab/haolin/nhk/excerpts/2010_06_16_19_00_1.webm;Naoto KAN.jpg;6161;6353;6693;205;211;6
/net/per920a/export/das14a/satoh-lab/haolin/nhk/excerpts/2010_06_16_19_00_1.webm;Natsuo YAMAGUCHI.jpg;4513;4613;6693;150;153;3
/net/per920a/export/das14a/satoh-lab/haolin/nhk/excerpts/2010_06_16_19_00_1.webm;Sadakazu TANIGAKI.jpg;6529;6689;6693;217;222;5
/net/per920a/export/das14a/satoh-lab/haolin/nhk/excerpts/2010_06_24_19_00_1.webm;Sadakazu TANIGAKI.jpg;1077;1097;9089;35;36;1
/net/per920a/export/das14a/satoh-lab/haolin/nhk/excerpts/2010_06_24_19_00_1.webm;Sadakazu TANIGAKI.jpg;1113;1121;9089;37;37;0
/net/per920a/export/das14a/satoh-lab/haolin/nhk/excerpts/2010_06_24_19_00_1.webm;Sadakazu TANIGAKI.jpg;1241;1321;9089;41;44;3
/net/per920a/export/das14a/satoh-lab/haolin/nhk/excerpts/2010_06_24_19_00_1.webm;Sadakazu TANIGAKI.jpg;1373;1421;9089;45;47;2
/net/per920a/export/das14a/satoh-lab/haolin/nhk/excerpts/2010_06_24_19_00_1.webm;Sadakazu TANIGAKI.jpg;1437;1441;9089;47;48;1
/net/per920a/export/das14a/satoh-lab/haolin/nhk/excerpts/2010_06_24_19_00_1.webm;Sadakazu TANIGAKI.jpg;1453;1509;9089;48;50;2
/net/per920a/export/das14a/satoh-lab/haolin/nhk/excerpts/2010_06_24_19_00_1.webm;Sadakazu TANIGAKI.jpg;1533;1569;9089;51;52;1
/net/per920a/export/das14a/satoh-lab/haolin/nhk/excerpts/2010_06_24_19_00_1.webm;Sadakazu TANIGAKI.jpg;1581;1589;9089;52;52;0
/net/per920a/export/das14a/satoh-lab/haolin/nhk/excerpts/2010_06_24_19_00_1.webm;Sadakazu TANIGAKI.jpg;1605;1605;9089;53;53;0
/net/per920a/export/das14a/satoh-lab/haolin/nhk/excerpts/2010_06_24_19_00_1.webm;Sadakazu TANIGAKI.jpg;1617;1621;9089;53;54;1
/net/per920a/export/das14a/satoh-lab/haolin/nhk/excerpts/2010_06_24_19_00_1.webm;Sadakazu TANIGAKI.jpg;1633;1685;9089;54;56;2
/net/per920a/export/das14a/satoh-lab/haolin/nhk/excerpts/2010_06_24_19_00_1.webm;Sadakazu TANIGAKI.jpg;1701;1725;9089;56;57;1
/net/per920a/export/das14a/satoh-lab/haolin/nhk/excerpts/2010_06_24_19_00_1.webm;Sadakazu TANIGAKI.jpg;1749;1761;9089;58;58;0
/net/per920a/export/das14a/satoh-lab/haolin/nhk/excerpts/2010_06_24_19_00_1.webm;Sadakazu TANIGAKI.jpg;1777;1789;9089;59;59;0
/net/per920a/export/das14a/satoh-lab/haolin/nhk/excerpts/2010_06_24_19_00_1.webm;Sadakazu TANIGAKI.jpg;1825;1849;9089;60;61;1
/net/per920a/export/das14a/satoh-lab/haolin/nhk/excerpts/2010_06_24_19_00_1.webm;Sadakazu TANIGAKI.jpg;1873;1889;9089;62;62;0
/net/per920a/export/das14a/satoh-lab/haolin/nhk/excerpts/2010_06_24_19_00_1.webm;Sadakazu TANIGAKI.jpg;1901;1901;9089;63;63;0
/net/per920a/export/das14a/satoh-lab/haolin/nhk/excerpts/2010_06_24_19_00_1.webm;Sadakazu TANIGAKI.jpg;1917;1929;9089;63;64;1
/net/per920a/export/das14a/satoh-lab/haolin/nhk/excerpts/2010_06_24_19_00_1.webm;Sadakazu TANIGAKI.jpg;1941;1981;9089;64;66;2
/net/per920a/export/das14a/satoh-lab/haolin/nhk/excerpts/2010_06_24_19_00_1.webm;Sadakazu TANIGAKI.jpg;1997;1997;9089;66;66;0
/net/per920a/export/das14a/satoh-lab/haolin/nhk/excerpts/2010_06_24_19_00_1.webm;Sadakazu TANIGAKI.jpg;2013;2077;9089;67;69;2
/net/per920a/export/das14a/satoh-lab/haolin/nhk/excerpts/2010_06_24_19_00_1.webm;Sadakazu TANIGAKI.jpg;2157;2197;9089;71;73;2
/net/per920a/export/das14a/satoh-lab/haolin/nhk/excerpts/2010_06_24_19_00_1.webm;Sadakazu TANIGAKI.jpg;2221;2245;9089;74;74;0
/net/per920a/export/das14a/satoh-lab/haolin/nhk/excerpts/2010_06_24_19_00_1.webm;Sadakazu TANIGAKI.jpg;2257;2269;9089;75;75;0
/net/per920a/export/das14a/satoh-lab/haolin/nhk/excerpts/2010_06_24_19_00_1.webm;Sadakazu TANIGAKI.jpg;2281;2281;9089;76;76;0
/net/per920a/export/das14a/satoh-lab/haolin/nhk/excerpts/2010_06_24_19_00_1.webm;Sadakazu TANIGAKI.jpg;2297;2333;9089;76;77;1
/net/per920a/export/das14a/satoh-lab/haolin/nhk/excerpts/2010_06_24_19_00_1.webm;Sadakazu TANIGAKI.jpg;2369;2373;9089;78;79;1
/net/per920a/export/das14a/satoh-lab/haolin/nhk/excerpts/2010_06_24_19_00_1.webm;Sadakazu TANIGAKI.jpg;2389;2417;9089;79;80;1
/net/per920a/export/das14a/satoh-lab/haolin/nhk/excerpts/2010_06_24_19_00_1.webm;Sadakazu TANIGAKI.jpg;2441;2441;9089;81;81;0
/net/per920a/export/das14a/satoh-lab/haolin/nhk/excerpts/2010_06_24_19_00_1.webm;Sadakazu TANIGAKI.jpg;2461;2481;9089;82;82;0
/net/per920a/export/das14a/satoh-lab/haolin/nhk/excerpts/2010_06_24_19_00_1.webm;Sadakazu TANIGAKI.jpg;2513;2513;9089;83;83;0
/net/per920a/export/das14a/satoh-lab/haolin/nhk/excerpts/2010_06_24_19_00_1.webm;Sadakazu TANIGAKI.jpg;2525;2529;9089;84;84;0
/net/per920a/export/das14a/satoh-lab/haolin/nhk/excerpts/2010_06_24_19_00_1.webm;Sadakazu TANIGAKI.jpg;2541;2541;9089;84;84;0
/net/per920a/export/das14a/satoh-lab/haolin/nhk/excerpts/2010_06_24_19_00_1.webm;Sadakazu TANIGAKI.jpg;2553;2597;9089;85;86;1
/net/per920a/export/das14a/satoh-lab/haolin/nhk/excerpts/2010_06_24_19_00_1.webm;Sadakazu TANIGAKI.jpg;2621;2645;9089;87;88;1
/net/per920a/export/das14a/satoh-lab/haolin/nhk/excerpts/2010_06_24_19_00_1.webm;Sadakazu TANIGAKI.jpg;2689;2693;9089;89;89;0
/net/per920a/export/das14a/satoh-lab/haolin/nhk/excerpts/2010_06_24_19_00_1.webm;Sadakazu TANIGAKI.jpg;2705;2725;9089;90;90;0
/net/per920a/export/das14a/satoh-lab/haolin/nhk/excerpts/2010_06_24_19_00_1.webm;Natsuo YAMAGUCHI.jpg;2925;2949;9089;97;98;1
/net/per920a/export/das14a/satoh-lab/haolin/nhk/excerpts/2010_06_24_19_00_1.webm;Natsuo YAMAGUCHI.jpg;2993;2993;9089;99;99;0
/net/per920a/export/das14a/satoh-lab/haolin/nhk/excerpts/2010_06_24_19_00_1.webm;Natsuo YAMAGUCHI.jpg;3005;3333;9089;100;111;11
/net/per920a/export/das14a/satoh-lab/haolin/nhk/excerpts/2010_06_24_19_00_1.webm;Natsuo YAMAGUCHI.jpg;3361;3897;9089;112;129;17
/net/per920a/export/das14a/satoh-lab/haolin/nhk/excerpts/2010_06_24_19_00_1.webm;Natsuo YAMAGUCHI.jpg;3913;4117;9089;130;137;7
/net/per920a/export/das14a/satoh-lab/haolin/nhk/excerpts/2010_06_24_19_00_1.webm;Natsuo YAMAGUCHI.jpg;4177;4253;9089;139;141;2
/net/per920a/export/das14a/satoh-lab/haolin/nhk/excerpts/2010_06_24_19_00_1.webm;Natsuo YAMAGUCHI.jpg;4265;4273;9089;142;142;0
/net/per920a/export/das14a/satoh-lab/haolin/nhk/excerpts/2010_06_24_19_00_1.webm;Kazuo SHII.jpg;4333;4361;9089;144;145;1
/net/per920a/export/das14a/satoh-lab/haolin/nhk/excerpts/2010_06_24_19_00_1.webm;Kazuo SHII.jpg;4585;5293;9089;152;176;24
/net/per920a/export/das14a/satoh-lab/haolin/nhk/excerpts/2010_06_24_19_00_1.webm;Kazuo SHII.jpg;5313;5353;9089;177;178;1
/net/per920a/export/das14a/satoh-lab/haolin/nhk/excerpts/2010_06_24_19_00_1.webm;Mizuho FUKUSHIMA.jpg;5485;5485;9089;182;182;0
/net/per920a/export/das14a/satoh-lab/haolin/nhk/excerpts/2010_06_24_19_00_1.webm;Mizuho FUKUSHIMA.jpg;5769;6513;9089;192;217;25
/net/per920a/export/das14a/satoh-lab/haolin/nhk/excerpts/2010_06_24_19_00_1.webm;Shizuka KAMEI.jpg;6765;6781;9089;225;226;1
/net/per920a/export/das14a/satoh-lab/haolin/nhk/excerpts/2010_06_24_19_00_1.webm;Shizuka KAMEI.jpg;7141;7253;9089;238;241;3
/net/per920a/export/das14a/satoh-lab/haolin/nhk/excerpts/2010_06_24_19_00_1.webm;Shizuka KAMEI.jpg;7269;7357;9089;242;245;3
/net/per920a/export/das14a/satoh-lab/haolin/nhk/excerpts/2010_06_24_19_00_1.webm;Shizuka KAMEI.jpg;7373;7421;9089;245;247;2
/net/per920a/export/das14a/satoh-lab/haolin/nhk/excerpts/2010_06_24_19_00_1.webm;Shizuka KAMEI.jpg;7437;7441;9089;247;248;1
/net/per920a/export/das14a/satoh-lab/haolin/nhk/excerpts/2010_06_24_19_00_1.webm;Shizuka KAMEI.jpg;7457;7541;9089;248;251;3
/net/per920a/export/das14a/satoh-lab/haolin/nhk/excerpts/2010_06_24_19_00_1.webm;Yoshimi WATANABE.jpg;7729;7825;9089;257;260;3
/net/per920a/export/das14a/satoh-lab/haolin/nhk/excerpts/2010_06_24_19_00_1.webm;Yoshimi WATANABE.jpg;7849;8597;9089;261;286;25
/net/per920a/export/das14a/satoh-lab/haolin/nhk/excerpts/2010_08_06_19_00_1.webm;Naoto KAN.jpg;19421;19937;22537;648;665;17
/net/per920a/export/das14a/satoh-lab/haolin/nhk/excerpts/2010_08_19_19_00_1.webm;Yukio HATOYAMA.jpg;913;1053;13405;30;35;5
/net/per920a/export/das14a/satoh-lab/haolin/nhk/excerpts/2010_08_19_19_00_1.webm;Yukio HATOYAMA.jpg;2145;2233;13405;71;74;3
/net/per920a/export/das14a/satoh-lab/haolin/nhk/excerpts/2010_08_19_19_00_1.webm;Yukio HATOYAMA.jpg;2257;2261;13405;75;75;0
/net/per920a/export/das14a/satoh-lab/haolin/nhk/excerpts/2010_08_19_19_00_1.webm;Yukio HATOYAMA.jpg;2273;2293;13405;75;76;1
/net/per920a/export/das14a/satoh-lab/haolin/nhk/excerpts/2010_08_19_19_00_1.webm;Yukio HATOYAMA.jpg;2305;2305;13405;76;76;0
/net/per920a/export/das14a/satoh-lab/haolin/nhk/excerpts/2010_08_19_19_00_1.webm;Yukio HATOYAMA.jpg;2333;2333;13405;77;77;0
/net/per920a/export/das14a/satoh-lab/haolin/nhk/excerpts/2010_08_19_19_00_1.webm;Yukio HATOYAMA.jpg;2361;2373;13405;78;79;1
/net/per920a/export/das14a/satoh-lab/haolin/nhk/excerpts/2010_08_19_19_00_1.webm;Yukio HATOYAMA.jpg;2405;2405;13405;80;80;0
/net/per920a/export/das14a/satoh-lab/haolin/nhk/excerpts/2010_08_19_19_00_1.webm;Yukio HATOYAMA.jpg;2421;2429;13405;80;80;0
/net/per920a/export/das14a/satoh-lab/haolin/nhk/excerpts/2010_08_19_19_00_1.webm;Yukio HATOYAMA.jpg;2441;2441;13405;81;81;0
/net/per920a/export/das14a/satoh-lab/haolin/nhk/excerpts/2010_08_19_19_00_1.webm;Yukio HATOYAMA.jpg;2465;2465;13405;82;82;0
/net/per920a/export/das14a/satoh-lab/haolin/nhk/excerpts/2010_08_19_19_00_1.webm;Yukio HATOYAMA.jpg;2685;2693;13405;89;89;0
/net/per920a/export/das14a/satoh-lab/haolin/nhk/excerpts/2010_08_19_19_00_1.webm;Yukio HATOYAMA.jpg;6501;6501;13405;216;216;0
/net/per920a/export/das14a/satoh-lab/haolin/nhk/excerpts/2010_08_19_19_00_1.webm;Yukio HATOYAMA.jpg;6513;6521;13405;217;217;0
/net/per920a/export/das14a/satoh-lab/haolin/nhk/excerpts/2010_08_19_19_00_1.webm;Yukio HATOYAMA.jpg;6629;6629;13405;221;221;0
/net/per920a/export/das14a/satoh-lab/haolin/nhk/excerpts/2010_08_19_19_00_1.webm;Yukio HATOYAMA.jpg;6685;6689;13405;222;223;1
/net/per920a/export/das14a/satoh-lab/haolin/nhk/excerpts/2010_08_19_19_00_1.webm;Yukio HATOYAMA.jpg;6705;6709;13405;223;223;0
/net/per920a/export/das14a/satoh-lab/haolin/nhk/excerpts/2010_08_19_19_00_1.webm;Yukio HATOYAMA.jpg;6721;6749;13405;224;225;1
/net/per920a/export/das14a/satoh-lab/haolin/nhk/excerpts/2010_08_19_19_00_1.webm;Yukio HATOYAMA.jpg;7213;7217;13405;240;240;0
/net/per920a/export/das14a/satoh-lab/haolin/nhk/excerpts/2010_08_19_19_00_1.webm;Yukio HATOYAMA.jpg;7261;7265;13405;242;242;0
/net/per920a/export/das14a/satoh-lab/haolin/nhk/excerpts/2010_08_19_19_00_1.webm;Yukio HATOYAMA.jpg;7277;7281;13405;242;242;0
/net/per920a/export/das14a/satoh-lab/haolin/nhk/excerpts/2010_08_19_19_00_1.webm;Ichiro OZAWA.jpg;2077;2077;13405;69;69;0
/net/per920a/export/das14a/satoh-lab/haolin/nhk/excerpts/2010_08_19_19_00_1.webm;Ichiro OZAWA.jpg;2093;2105;13405;69;70;1
/net/per920a/export/das14a/satoh-lab/haolin/nhk/excerpts/2010_08_19_19_00_1.webm;Ichiro OZAWA.jpg;2133;2233;13405;71;74;3
/net/per920a/export/das14a/satoh-lab/haolin/nhk/excerpts/2010_08_19_19_00_1.webm;Ichiro OZAWA.jpg;6865;6889;13405;228;229;1
/net/per920a/export/das14a/satoh-lab/haolin/nhk/excerpts/2010_08_19_19_00_1.webm;Ichiro OZAWA.jpg;6901;6901;13405;230;230;0
/net/per920a/export/das14a/satoh-lab/haolin/nhk/excerpts/2010_08_19_19_00_1.webm;Ichiro OZAWA.jpg;6981;6981;13405;232;232;0
/net/per920a/export/das14a/satoh-lab/haolin/nhk/excerpts/2010_08_19_19_00_1.webm;Ichiro OZAWA.jpg;6993;7037;13405;233;234;1
/net/per920a/export/das14a/satoh-lab/haolin/nhk/excerpts/2010_08_19_19_00_1.webm;Ichiro OZAWA.jpg;7049;7049;13405;235;235;0
/net/per920a/export/das14a/satoh-lab/haolin/nhk/excerpts/2010_08_19_19_00_1.webm;Ichiro OZAWA.jpg;7069;7077;13405;235;235;0
/net/per920a/export/das14a/satoh-lab/haolin/nhk/excerpts/2010_08_19_19_00_1.webm;Ichiro OZAWA.jpg;7101;7101;13405;236;236;0
/net/per920a/export/das14a/satoh-lab/haolin/nhk/excerpts/2010_08_19_19_00_1.webm;Ichiro OZAWA.jpg;7117;7125;13405;237;237;0
/net/per920a/export/das14a/satoh-lab/haolin/nhk/excerpts/2010_08_19_19_00_1.webm;Ichiro OZAWA.jpg;7173;7173;13405;239;239;0
/net/per920a/export/das14a/satoh-lab/haolin/nhk/excerpts/2010_08_19_19_00_1.webm;Ichiro OZAWA.jpg;7365;7377;13405;245;245;0
/net/per920a/export/das14a/satoh-lab/haolin/nhk/excerpts/2010_08_19_19_00_1.webm;Ichiro OZAWA.jpg;7485;7489;13405;249;249;0
/net/per920a/export/das14a/satoh-lab/haolin/nhk/excerpts/2010_08_19_19_00_1.webm;Ichiro OZAWA.jpg;7585;7589;13405;252;253;1
/net/per920a/export/das14a/satoh-lab/haolin/nhk/excerpts/2010_08_19_19_00_1.webm;Ichiro OZAWA.jpg;11857;11857;13405;395;395;0
/net/per920a/export/das14a/satoh-lab/haolin/nhk/excerpts/2010_08_19_19_00_1.webm;Ichiro OZAWA.jpg;11869;11869;13405;395;395;0
/net/per920a/export/das14a/satoh-lab/haolin/nhk/excerpts/2010_08_19_19_00_1.webm;Ichiro OZAWA.jpg;12045;12045;13405;401;401;0
/net/per920a/export/das14a/satoh-lab/haolin/nhk/excerpts/2010_08_19_19_00_1.webm;Ichiro OZAWA.jpg;12061;12069;13405;402;402;0
/net/per920a/export/das14a/satoh-lab/haolin/nhk/excerpts/2010_08_19_19_00_1.webm;Ichiro OZAWA.jpg;12093;12097;13405;403;403;0
/net/per920a/export/das14a/satoh-lab/haolin/nhk/excerpts/2010_08_19_19_00_1.webm;Ichiro OZAWA.jpg;12185;12193;13405;406;406;0
/net/per920a/export/das14a/satoh-lab/haolin/nhk/excerpts/2010_08_19_19_00_1.webm;Takenori KANZAKI.jpg;3901;3905;13405;130;130;0
/net/per920a/export/das14a/satoh-lab/haolin/nhk/excerpts/2010_08_19_19_00_1.webm;Takenori KANZAKI.jpg;3929;3957;13405;131;131;0
/net/per920a/export/das14a/satoh-lab/haolin/nhk/excerpts/2010_08_19_19_00_1.webm;Takenori KANZAKI.jpg;4041;4049;13405;134;135;1
/net/per920a/export/das14a/satoh-lab/haolin/nhk/excerpts/2010_08_19_19_00_1.webm;Takenori KANZAKI.jpg;4065;4085;13405;135;136;1
/net/per920a/export/das14a/satoh-lab/haolin/nhk/excerpts/2010_08_19_19_00_1.webm;Takenori KANZAKI.jpg;4105;4113;13405;136;137;1
/net/per920a/export/das14a/satoh-lab/haolin/nhk/excerpts/2010_08_19_19_00_1.webm;Takenori KANZAKI.jpg;4125;4125;13405;137;137;0
/net/per920a/export/das14a/satoh-lab/haolin/nhk/excerpts/2010_08_19_19_00_1.webm;Takenori KANZAKI.jpg;4145;4177;13405;138;139;1
/net/per920a/export/das14a/satoh-lab/haolin/nhk/excerpts/2010_08_19_19_00_1.webm;Takenori KANZAKI.jpg;4193;4197;13405;139;139;0
/net/per920a/export/das14a/satoh-lab/haolin/nhk/excerpts/2010_08_19_19_00_1.webm;Naoto KAN.jpg;10829;11169;13405;361;372;11
/net/per920a/export/das14a/satoh-lab/haolin/nhk/excerpts/2010_08_19_19_00_1.webm;Naoto KAN.jpg;12261;12265;13405;408;408;0
/net/per920a/export/das14a/satoh-lab/haolin/nhk/excerpts/2010_08_19_19_00_1.webm;Naoto KAN.jpg;12277;12285;13405;409;409;0
/net/per920a/export/das14a/satoh-lab/haolin/nhk/excerpts/2010_08_19_19_00_1.webm;Naoto KAN.jpg;12301;12309;13405;410;410;0
/net/per920a/export/das14a/satoh-lab/haolin/nhk/excerpts/2010_08_19_19_00_1.webm;Naoto KAN.jpg;12321;12329;13405;410;411;1
/net/per920a/export/das14a/satoh-lab/haolin/nhk/excerpts/2010_08_19_19_00_1.webm;Naoto KAN.jpg;12361;12369;13405;412;412;0
/net/per920a/export/das14a/satoh-lab/haolin/nhk/excerpts/2010_08_19_19_00_1.webm;Naoto KAN.jpg;12389;12389;13405;413;413;0
/net/per920a/export/das14a/satoh-lab/haolin/nhk/excerpts/2010_08_19_19_00_1.webm;Naoto KAN.jpg;12409;12413;13405;413;413;0
/net/per920a/export/das14a/satoh-lab/haolin/nhk/excerpts/2010_08_19_19_00_1.webm;Naoto KAN.jpg;12425;12437;13405;414;414;0
/net/per920a/export/das14a/satoh-lab/haolin/nhk/excerpts/2010_08_19_19_00_1.webm;Naoto KAN.jpg;12449;12461;13405;415;415;0
/net/per920a/export/das14a/satoh-lab/haolin/nhk/excerpts/2010_08_19_19_00_1.webm;Naoto KAN.jpg;12473;12553;13405;415;418;3
/net/per920a/export/das14a/satoh-lab/haolin/nhk/excerpts/2010_08_19_19_00_1.webm;Naoto KAN.jpg;12601;13325;13405;420;444;24
/net/per920a/export/das14a/satoh-lab/haolin/nhk/excerpts/2010_08_29_19_00_1.webm;Naoto KAN.jpg;1885;1961;7437;62;65;3
/net/per920a/export/das14a/satoh-lab/haolin/nhk/excerpts/2010_08_29_19_00_1.webm;Naoto KAN.jpg;2033;2033;7437;67;67;0
/net/per920a/export/das14a/satoh-lab/haolin/nhk/excerpts/2010_08_29_19_00_1.webm;Naoto KAN.jpg;2765;2765;7437;92;92;0
/net/per920a/export/das14a/satoh-lab/haolin/nhk/excerpts/2010_08_29_19_00_1.webm;Naoto KAN.jpg;6897;6925;7437;229;230;1
/net/per920a/export/das14a/satoh-lab/haolin/nhk/excerpts/2010_08_29_19_00_1.webm;Naoto KAN.jpg;6953;7285;7437;231;242;11
/net/per920a/export/das14a/satoh-lab/haolin/nhk/excerpts/2010_08_29_19_00_1.webm;Naoto KAN.jpg;7301;7369;7437;243;245;2
/net/per920a/export/das14a/satoh-lab/haolin/nhk/excerpts/2010_08_29_19_00_1.webm;Yukio HATOYAMA.jpg;3037;3041;7437;101;101;0
/net/per920a/export/das14a/satoh-lab/haolin/nhk/excerpts/2010_08_29_19_00_1.webm;Yukio HATOYAMA.jpg;3053;3053;7437;101;101;0
/net/per920a/export/das14a/satoh-lab/haolin/nhk/excerpts/2010_08_29_19_00_1.webm;Yukio HATOYAMA.jpg;3101;3105;7437;103;103;0
/net/per920a/export/das14a/satoh-lab/haolin/nhk/excerpts/2010_08_29_19_00_1.webm;Yukio HATOYAMA.jpg;3117;3117;7437;103;103;0
/net/per920a/export/das14a/satoh-lab/haolin/nhk/excerpts/2010_08_29_19_00_1.webm;Yukio HATOYAMA.jpg;6897;6925;7437;229;230;1
/net/per920a/export/das14a/satoh-lab/haolin/nhk/excerpts/2010_08_29_19_00_1.webm;Yukio HATOYAMA.jpg;6953;7285;7437;231;242;11
/net/per920a/export/das14a/satoh-lab/haolin/nhk/excerpts/2010_08_29_19_00_1.webm;Yukio HATOYAMA.jpg;7301;7369;7437;243;245;2
/net/per920a/export/das14a/satoh-lab/haolin/nhk/excerpts/2010_08_29_19_00_1.webm;Takenori KANZAKI.jpg;5053;5069;7437;168;169;1
/net/per920a/export/das14a/satoh-lab/haolin/nhk/excerpts/2010_08_29_19_00_1.webm;Takenori KANZAKI.jpg;5085;5109;7437;169;170;1
/net/per920a/export/das14a/satoh-lab/haolin/nhk/excerpts/2010_08_29_19_00_1.webm;Takenori KANZAKI.jpg;5125;5185;7437;170;172;2
/net/per920a/export/das14a/satoh-lab/haolin/nhk/excerpts/2010_08_29_19_00_1.webm;Takenori KANZAKI.jpg;5197;5197;7437;173;173;0
/net/per920a/export/das14a/satoh-lab/haolin/nhk/excerpts/2010_08_29_19_00_1.webm;Takenori KANZAKI.jpg;5209;5217;7437;173;173;0
/net/per920a/export/das14a/satoh-lab/haolin/nhk/excerpts/2010_08_29_19_00_1.webm;Takenori KANZAKI.jpg;5269;5277;7437;175;175;0
/net/per920a/export/das14a/satoh-lab/haolin/nhk/excerpts/2010_08_29_19_00_1.webm;Takenori KANZAKI.jpg;5321;5337;7437;177;177;0
/net/per920a/export/das14a/satoh-lab/haolin/nhk/excerpts/2010_08_29_19_00_1.webm;Takenori KANZAKI.jpg;5353;5353;7437;178;178;0
/net/per920a/export/das14a/satoh-lab/haolin/nhk/excerpts/2010_08_29_19_00_1.webm;Takenori KANZAKI.jpg;5385;5577;7437;179;185;6
/net/per920a/export/das14a/satoh-lab/haolin/nhk/excerpts/2010_08_29_19_00_1.webm;Takenori KANZAKI.jpg;5605;5845;7437;186;194;8
/net/per920a/export/das14a/satoh-lab/haolin/nhk/excerpts/2010_09_11_19_00_1.webm;Ichiro OZAWA.jpg;1521;1521;6541;50;50;0
/net/per920a/export/das14a/satoh-lab/haolin/nhk/excerpts/2010_09_11_19_00_1.webm;Ichiro OZAWA.jpg;1565;1565;6541;52;52;0
/net/per920a/export/das14a/satoh-lab/haolin/nhk/excerpts/2010_09_11_19_00_1.webm;Ichiro OZAWA.jpg;1721;1725;6541;57;57;0
/net/per920a/export/das14a/satoh-lab/haolin/nhk/excerpts/2010_09_11_19_00_1.webm;Ichiro OZAWA.jpg;2209;2213;6541;73;73;0
/net/per920a/export/das14a/satoh-lab/haolin/nhk/excerpts/2010_09_11_19_00_1.webm;Ichiro OZAWA.jpg;2225;2229;6541;74;74;0
/net/per920a/export/das14a/satoh-lab/haolin/nhk/excerpts/2010_09_11_19_00_1.webm;Ichiro OZAWA.jpg;2249;2265;6541;74;75;1
/net/per920a/export/das14a/satoh-lab/haolin/nhk/excerpts/2010_09_11_19_00_1.webm;Ichiro OZAWA.jpg;2285;2289;6541;76;76;0
/net/per920a/export/das14a/satoh-lab/haolin/nhk/excerpts/2010_09_11_19_00_1.webm;Ichiro OZAWA.jpg;2317;2329;6541;77;77;0
/net/per920a/export/das14a/satoh-lab/haolin/nhk/excerpts/2010_09_11_19_00_1.webm;Ichiro OZAWA.jpg;2377;2377;6541;79;79;0
/net/per920a/export/das14a/satoh-lab/haolin/nhk/excerpts/2010_09_11_19_00_1.webm;Ichiro OZAWA.jpg;2469;2469;6541;82;82;0
/net/per920a/export/das14a/satoh-lab/haolin/nhk/excerpts/2010_09_11_19_00_1.webm;Ichiro OZAWA.jpg;2485;2485;6541;82;82;0
/net/per920a/export/das14a/satoh-lab/haolin/nhk/excerpts/2010_09_11_19_00_1.webm;Ichiro OZAWA.jpg;2509;2509;6541;83;83;0
/net/per920a/export/das14a/satoh-lab/haolin/nhk/excerpts/2010_09_11_19_00_1.webm;Ichiro OZAWA.jpg;2521;2529;6541;84;84;0
/net/per920a/export/das14a/satoh-lab/haolin/nhk/excerpts/2010_09_11_19_00_1.webm;Ichiro OZAWA.jpg;2545;2549;6541;84;84;0
/net/per920a/export/das14a/satoh-lab/haolin/nhk/excerpts/2010_09_11_19_00_1.webm;Ichiro OZAWA.jpg;2573;2573;6541;85;85;0
/net/per920a/export/das14a/satoh-lab/haolin/nhk/excerpts/2010_09_11_19_00_1.webm;Ichiro OZAWA.jpg;2589;2589;6541;86;86;0
/net/per920a/export/das14a/satoh-lab/haolin/nhk/excerpts/2010_09_11_19_00_1.webm;Ichiro OZAWA.jpg;2605;2605;6541;86;86;0
/net/per920a/export/das14a/satoh-lab/haolin/nhk/excerpts/2010_09_11_19_00_1.webm;Ichiro OZAWA.jpg;2625;2637;6541;87;87;0
/net/per920a/export/das14a/satoh-lab/haolin/nhk/excerpts/2010_09_11_19_00_1.webm;Ichiro OZAWA.jpg;2721;2765;6541;90;92;2
/net/per920a/export/das14a/satoh-lab/haolin/nhk/excerpts/2010_09_11_19_00_1.webm;Ichiro OZAWA.jpg;2805;2813;6541;93;93;0
/net/per920a/export/das14a/satoh-lab/haolin/nhk/excerpts/2010_09_11_19_00_1.webm;Ichiro OZAWA.jpg;2825;2825;6541;94;94;0
/net/per920a/export/das14a/satoh-lab/haolin/nhk/excerpts/2010_09_11_19_00_1.webm;Ichiro OZAWA.jpg;2841;2845;6541;94;94;0
/net/per920a/export/das14a/satoh-lab/haolin/nhk/excerpts/2010_09_11_19_00_1.webm;Ichiro OZAWA.jpg;2929;2965;6541;97;98;1
/net/per920a/export/das14a/satoh-lab/haolin/nhk/excerpts/2010_09_11_19_00_1.webm;Ichiro OZAWA.jpg;2993;3005;6541;99;100;1
/net/per920a/export/das14a/satoh-lab/haolin/nhk/excerpts/2010_09_11_19_00_1.webm;Ichiro OZAWA.jpg;3049;3053;6541;101;101;0
/net/per920a/export/das14a/satoh-lab/haolin/nhk/excerpts/2010_09_11_19_00_1.webm;Ichiro OZAWA.jpg;3093;3097;6541;103;103;0
/net/per920a/export/das14a/satoh-lab/haolin/nhk/excerpts/2010_09_11_19_00_1.webm;Ichiro OZAWA.jpg;3113;3181;6541;103;106;3
/net/per920a/export/das14a/satoh-lab/haolin/nhk/excerpts/2010_09_11_19_00_1.webm;Ichiro OZAWA.jpg;3193;3193;6541;106;106;0
/net/per920a/export/das14a/satoh-lab/haolin/nhk/excerpts/2010_09_11_19_00_1.webm;Ichiro OZAWA.jpg;3205;3233;6541;106;107;1
/net/per920a/export/das14a/satoh-lab/haolin/nhk/excerpts/2010_09_11_19_00_1.webm;Naoto KAN.jpg;4017;4017;6541;133;133;0
/net/per920a/export/das14a/satoh-lab/haolin/nhk/excerpts/2010_09_11_19_00_1.webm;Naoto KAN.jpg;4033;4069;6541;134;135;1
/net/per920a/export/das14a/satoh-lab/haolin/nhk/excerpts/2010_09_11_19_00_1.webm;Naoto KAN.jpg;4137;4325;6541;137;144;7
/net/per920a/export/das14a/satoh-lab/haolin/nhk/excerpts/2010_09_11_19_00_1.webm;Naoto KAN.jpg;4365;4497;6541;145;149;4
/net/per920a/export/das14a/satoh-lab/haolin/nhk/excerpts/2010_09_11_19_00_1.webm;Naoto KAN.jpg;4513;4677;6541;150;155;5
/net/per920a/export/das14a/satoh-lab/haolin/nhk/excerpts/2010_09_11_19_00_1.webm;Naoto KAN.jpg;4717;4753;6541;157;158;1
/net/per920a/export/das14a/satoh-lab/haolin/nhk/excerpts/2010_09_11_19_00_1.webm;Naoto KAN.jpg;4769;4797;6541;158;159;1
/net/per920a/export/das14a/satoh-lab/haolin/nhk/excerpts/2010_09_11_19_00_1.webm;Naoto KAN.jpg;4813;4821;6541;160;160;0
/net/per920a/export/das14a/satoh-lab/haolin/nhk/excerpts/2010_09_11_19_00_1.webm;Naoto KAN.jpg;4841;4925;6541;161;164;3
/net/per920a/export/das14a/satoh-lab/haolin/nhk/excerpts/2010_09_11_19_00_1.webm;Naoto KAN.jpg;4941;4977;6541;164;165;1
/net/per920a/export/das14a/satoh-lab/haolin/nhk/excerpts/2010_09_11_19_00_1.webm;Naoto KAN.jpg;4993;5025;6541;166;167;1
/net/per920a/export/das14a/satoh-lab/haolin/nhk/excerpts/2010_09_11_19_00_1.webm;Naoto KAN.jpg;5061;5065;6541;168;168;0
/net/per920a/export/das14a/satoh-lab/haolin/nhk/excerpts/2010_09_11_19_00_1.webm;Naoto KAN.jpg;5077;5121;6541;169;170;1
/net/per920a/export/das14a/satoh-lab/haolin/nhk/excerpts/2010_09_11_19_00_1.webm;Naoto KAN.jpg;5233;5281;6541;174;176;2
/net/per920a/export/das14a/satoh-lab/haolin/nhk/excerpts/2010_09_11_19_00_1.webm;Naoto KAN.jpg;5317;5329;6541;177;177;0
/net/per920a/export/das14a/satoh-lab/haolin/nhk/excerpts/2010_09_11_19_00_1.webm;Naoto KAN.jpg;5341;5353;6541;178;178;0
/net/per920a/export/das14a/satoh-lab/haolin/nhk/excerpts/2010_09_11_19_00_1.webm;Naoto KAN.jpg;5413;5413;6541;180;180;0
/net/per920a/export/das14a/satoh-lab/haolin/nhk/excerpts/2010_09_11_19_00_1.webm;Naoto KAN.jpg;5445;5445;6541;181;181;0
/net/per920a/export/das14a/satoh-lab/haolin/nhk/excerpts/2010_09_11_19_00_1.webm;Naoto KAN.jpg;5457;5461;6541;181;182;1
/net/per920a/export/das14a/satoh-lab/haolin/nhk/excerpts/2010_09_11_19_00_1.webm;Naoto KAN.jpg;5473;5497;6541;182;183;1
/net/per920a/export/das14a/satoh-lab/haolin/nhk/excerpts/2010_09_11_19_00_1.webm;Naoto KAN.jpg;5517;5537;6541;183;184;1
/net/per920a/export/das14a/satoh-lab/haolin/nhk/excerpts/2010_09_11_19_00_1.webm;Naoto KAN.jpg;5641;5645;6541;188;188;0
/net/per920a/export/das14a/satoh-lab/haolin/nhk/excerpts/2010_09_11_19_00_1.webm;Naoto KAN.jpg;5661;5673;6541;188;189;1
/net/per920a/export/das14a/satoh-lab/haolin/nhk/excerpts/2010_09_11_19_00_1.webm;Naoto KAN.jpg;5689;5697;6541;189;189;0
/net/per920a/export/das14a/satoh-lab/haolin/nhk/excerpts/2010_09_11_19_00_1.webm;Naoto KAN.jpg;5717;5725;6541;190;190;0
/net/per920a/export/das14a/satoh-lab/haolin/nhk/excerpts/2010_09_11_19_00_1.webm;Naoto KAN.jpg;5737;5737;6541;191;191;0
/net/per920a/export/das14a/satoh-lab/haolin/nhk/excerpts/2010_09_11_19_00_1.webm;Naoto KAN.jpg;5749;5753;6541;191;191;0
/net/per920a/export/das14a/satoh-lab/haolin/nhk/excerpts/2010_09_11_19_00_1.webm;Naoto KAN.jpg;5765;5765;6541;192;192;0
/net/per920a/export/das14a/satoh-lab/haolin/nhk/excerpts/2010_09_11_19_00_1.webm;Naoto KAN.jpg;5777;5777;6541;192;192;0
/net/per920a/export/das14a/satoh-lab/haolin/nhk/excerpts/2010_09_11_19_00_1.webm;Naoto KAN.jpg;5825;5857;6541;194;195;1
/net/per920a/export/das14a/satoh-lab/haolin/nhk/excerpts/2010_09_11_19_00_1.webm;Naoto KAN.jpg;5889;5897;6541;196;196;0
/net/per920a/export/das14a/satoh-lab/haolin/nhk/excerpts/2010_09_11_19_00_1.webm;Naoto KAN.jpg;5913;5969;6541;197;198;1
/net/per920a/export/das14a/satoh-lab/haolin/nhk/excerpts/2010_09_11_19_00_1.webm;Naoto KAN.jpg;6093;6105;6541;203;203;0
/net/per920a/export/das14a/satoh-lab/haolin/nhk/excerpts/2010_09_11_19_00_1.webm;Naoto KAN.jpg;6161;6161;6541;205;205;0
/net/per920a/export/das14a/satoh-lab/haolin/nhk/excerpts/2010_09_11_19_00_1.webm;Naoto KAN.jpg;6205;6237;6541;206;207;1
/net/per920a/export/das14a/satoh-lab/haolin/nhk/excerpts/2010_09_11_19_00_1.webm;Yukio HATOYAMA.jpg;6397;6397;6541;213;213;0
/net/per920a/export/das14a/satoh-lab/haolin/nhk/excerpts/2010_09_11_19_00_1.webm;Yukio HATOYAMA.jpg;6413;6417;6541;213;213;0
/net/per920a/export/das14a/satoh-lab/haolin/nhk/excerpts/2010_09_11_19_00_1.webm;Yukio HATOYAMA.jpg;6429;6537;6541;214;217;3
/net/per920a/export/das14a/satoh-lab/haolin/nhk/excerpts/2010_09_13_19_00_1.webm;Ichiro OZAWA.jpg;629;629;1509;20;20;0
/net/per920a/export/das14a/satoh-lab/haolin/nhk/excerpts/2010_09_13_19_00_1.webm;Ichiro OZAWA.jpg;713;717;1509;23;23;0
/net/per920a/export/das14a/satoh-lab/haolin/nhk/excerpts/2010_09_13_19_00_1.webm;Ichiro OZAWA.jpg;949;1069;1509;31;35;4
/net/per920a/export/das14a/satoh-lab/haolin/nhk/excerpts/2010_09_13_19_00_1.webm;Ichiro OZAWA.jpg;1417;1421;1509;46;47;1
/net/per920a/export/das14a/satoh-lab/haolin/nhk/excerpts/2010_09_13_19_00_1.webm;Ichiro OZAWA.jpg;1465;1465;1509;48;48;0
/net/per920a/export/das14a/satoh-lab/haolin/nhk/excerpts/2010_09_13_19_00_1.webm;Ichiro OZAWA.jpg;1477;1481;1509;48;49;1
/net/per920a/export/das14a/satoh-lab/haolin/nhk/excerpts/2010_09_17_19_00_2.webm;Seiji MAEHARA.jpg;917;925;6329;30;30;0
/net/per920a/export/das14a/satoh-lab/haolin/nhk/excerpts/2010_09_17_19_00_2.webm;Seiji MAEHARA.jpg;937;937;6329;31;31;0
/net/per920a/export/das14a/satoh-lab/haolin/nhk/excerpts/2010_09_17_19_00_2.webm;Seiji MAEHARA.jpg;961;961;6329;32;32;0
/net/per920a/export/das14a/satoh-lab/haolin/nhk/excerpts/2010_09_17_19_00_2.webm;Seiji MAEHARA.jpg;981;985;6329;32;32;0
/net/per920a/export/das14a/satoh-lab/haolin/nhk/excerpts/2010_09_17_19_00_2.webm;Seiji MAEHARA.jpg;1001;1005;6329;33;33;0
/net/per920a/export/das14a/satoh-lab/haolin/nhk/excerpts/2010_09_17_19_00_2.webm;Seiji MAEHARA.jpg;1017;1017;6329;33;33;0
/net/per920a/export/das14a/satoh-lab/haolin/nhk/excerpts/2010_09_17_19_00_2.webm;Seiji MAEHARA.jpg;1069;1073;6329;35;35;0
/net/per920a/export/das14a/satoh-lab/haolin/nhk/excerpts/2010_09_17_19_00_2.webm;Seiji MAEHARA.jpg;6189;6325;6329;206;210;4
/net/per920a/export/das14a/satoh-lab/haolin/nhk/excerpts/2010_09_17_19_00_2.webm;Katsuya OKADA.jpg;3153;3201;6329;105;106;1
/net/per920a/export/das14a/satoh-lab/haolin/nhk/excerpts/2010_09_17_19_00_2.webm;Katsuya OKADA.jpg;3801;3813;6329;126;127;1
/net/per920a/export/das14a/satoh-lab/haolin/nhk/excerpts/2010_09_17_19_00_2.webm;Katsuya OKADA.jpg;4029;4029;6329;134;134;0
/net/per920a/export/das14a/satoh-lab/haolin/nhk/excerpts/2010_09_17_19_00_2.webm;Katsuya OKADA.jpg;4057;4057;6329;135;135;0
/net/per920a/export/das14a/satoh-lab/haolin/nhk/excerpts/2010_09_17_19_00_2.webm;Naoto KAN.jpg;5361;5361;6329;178;178;0
/net/per920a/export/das14a/satoh-lab/haolin/nhk/excerpts/2010_09_17_19_00_2.webm;Naoto KAN.jpg;5377;5661;6329;179;188;9
/net/per920a/export/das14a/satoh-lab/haolin/nhk/excerpts/2010_09_17_19_00_2.webm;Yoshihiko Noda.jpg;6189;6325;6329;206;210;4
/net/per920a/export/das14a/satoh-lab/haolin/nhk/excerpts/2010_09_17_19_00_3.webm;Yoshihiko Noda.jpg;9;29;661;0;0;0
/net/per920a/export/das14a/satoh-lab/haolin/nhk/excerpts/2010_10_08_19_00_3.webm;Naoto KAN.jpg;173;241;909;5;7;2
/net/per920a/export/das14a/satoh-lab/haolin/nhk/excerpts/2010_10_08_19_00_3.webm;Naoto KAN.jpg;257;325;909;8;10;2
/net/per920a/export/das14a/satoh-lab/haolin/nhk/excerpts/2010_10_08_19_00_3.webm;Naoto KAN.jpg;473;473;909;15;15;0
/net/per920a/export/das14a/satoh-lab/haolin/nhk/excerpts/2010_10_08_19_00_3.webm;Naoto KAN.jpg;489;497;909;16;16;0
/net/per920a/export/das14a/satoh-lab/haolin/nhk/excerpts/2010_10_08_19_00_3.webm;Naoto KAN.jpg;513;525;909;16;17;1
/net/per920a/export/das14a/satoh-lab/haolin/nhk/excerpts/2010_10_08_19_00_3.webm;Naoto KAN.jpg;713;737;909;23;24;1
/net/per920a/export/das14a/satoh-lab/haolin/nhk/excerpts/2010_10_08_19_00_3.webm;Naoto KAN.jpg;761;761;909;25;25;0
/net/per920a/export/das14a/satoh-lab/haolin/nhk/excerpts/2010_10_08_19_00_3.webm;Naoto KAN.jpg;785;821;909;25;27;2
/net/per920a/export/das14a/satoh-lab/haolin/nhk/excerpts/2010_10_09_19_00_2.webm;Yoshihiko Noda.jpg;2697;2697;10229;89;89;0
/net/per920a/export/das14a/satoh-lab/haolin/nhk/excerpts/2010_10_09_19_00_2.webm;Yoshihiko Noda.jpg;2709;2709;10229;90;90;0
/net/per920a/export/das14a/satoh-lab/haolin/nhk/excerpts/2010_10_09_19_00_2.webm;Yoshihiko Noda.jpg;2721;2721;10229;90;90;0
/net/per920a/export/das14a/satoh-lab/haolin/nhk/excerpts/2010_10_09_19_00_2.webm;Yoshihiko Noda.jpg;2741;2761;10229;91;92;1
/net/per920a/export/das14a/satoh-lab/haolin/nhk/excerpts/2010_10_09_19_00_2.webm;Yoshihiko Noda.jpg;2785;2837;10229;92;94;2
/net/per920a/export/das14a/satoh-lab/haolin/nhk/excerpts/2010_10_09_19_00_2.webm;Yoshihiko Noda.jpg;2853;2857;10229;95;95;0
/net/per920a/export/das14a/satoh-lab/haolin/nhk/excerpts/2010_10_09_19_00_2.webm;Yoshihiko Noda.jpg;2901;2901;10229;96;96;0
/net/per920a/export/das14a/satoh-lab/haolin/nhk/excerpts/2010_10_09_19_00_2.webm;Yoshihiko Noda.jpg;2965;2981;10229;98;99;1
/net/per920a/export/das14a/satoh-lab/haolin/nhk/excerpts/2010_10_09_19_00_2.webm;Yoshihiko Noda.jpg;2997;3009;10229;99;100;1
/net/per920a/export/das14a/satoh-lab/haolin/nhk/excerpts/2010_10_09_19_00_2.webm;Yoshihiko Noda.jpg;3021;3049;10229;100;101;1
/net/per920a/export/das14a/satoh-lab/haolin/nhk/excerpts/2010_10_09_19_00_2.webm;Yoshihiko Noda.jpg;3597;3609;10229;119;120;1
/net/per920a/export/das14a/satoh-lab/haolin/nhk/excerpts/2010_10_09_19_00_2.webm;Yoshihiko Noda.jpg;3621;3657;10229;120;121;1
/net/per920a/export/das14a/satoh-lab/haolin/nhk/excerpts/2010_10_09_19_00_2.webm;Yoshihiko Noda.jpg;3697;3709;10229;123;123;0
/net/per920a/export/das14a/satoh-lab/haolin/nhk/excerpts/2010_10_09_19_00_2.webm;Yoshihiko Noda.jpg;3725;3777;10229;124;125;1
/net/per920a/export/das14a/satoh-lab/haolin/nhk/excerpts/2010_10_09_19_00_2.webm;Yoshihiko Noda.jpg;3821;3841;10229;127;128;1
/net/per920a/export/das14a/satoh-lab/haolin/nhk/excerpts/2010_10_09_19_00_2.webm;Yoshihiko Noda.jpg;5073;5349;10229;169;178;9
/net/per920a/export/das14a/satoh-lab/haolin/nhk/excerpts/2010_10_09_19_00_2.webm;Yoshihiko Noda.jpg;5361;5409;10229;178;180;2
/net/per920a/export/das14a/satoh-lab/haolin/nhk/excerpts/2010_10_09_19_00_2.webm;Yoshihiko Noda.jpg;5421;5445;10229;180;181;1
/net/per920a/export/das14a/satoh-lab/haolin/nhk/excerpts/2010_10_09_19_00_2.webm;Yoshihiko Noda.jpg;8141;8165;10229;271;272;1
/net/per920a/export/das14a/satoh-lab/haolin/nhk/excerpts/2010_10_09_19_00_2.webm;Yoshihiko Noda.jpg;8177;8225;10229;272;274;2
/net/per920a/export/das14a/satoh-lab/haolin/nhk/excerpts/2010_10_09_19_00_2.webm;Yoshihiko Noda.jpg;8249;8257;10229;274;275;1
/net/per920a/export/das14a/satoh-lab/haolin/nhk/excerpts/2010_10_09_19_00_2.webm;Yoshihiko Noda.jpg;8269;8269;10229;275;275;0
/net/per920a/export/das14a/satoh-lab/haolin/nhk/excerpts/2010_10_09_19_00_2.webm;Yoshihiko Noda.jpg;8281;8309;10229;276;276;0
/net/per920a/export/das14a/satoh-lab/haolin/nhk/excerpts/2010_10_09_19_00_2.webm;Yoshihiko Noda.jpg;8321;8345;10229;277;278;1
/net/per920a/export/das14a/satoh-lab/haolin/nhk/excerpts/2010_10_09_19_00_2.webm;Yoshihiko Noda.jpg;8365;8477;10229;278;282;4
/net/per920a/export/das14a/satoh-lab/haolin/nhk/excerpts/2010_10_09_19_00_2.webm;Yoshihiko Noda.jpg;8489;8529;10229;282;284;2
/net/per920a/export/das14a/satoh-lab/haolin/nhk/excerpts/2010_10_09_19_00_2.webm;Yoshihiko Noda.jpg;8577;8581;10229;285;286;1
/net/per920a/export/das14a/satoh-lab/haolin/nhk/excerpts/2010_10_09_19_00_2.webm;Yoshihiko Noda.jpg;8593;8613;10229;286;287;1
/net/per920a/export/das14a/satoh-lab/haolin/nhk/excerpts/2010_10_09_19_00_2.webm;Yoshihiko Noda.jpg;8629;8641;10229;287;288;1
/net/per920a/export/das14a/satoh-lab/haolin/nhk/excerpts/2010_10_09_19_00_2.webm;Yoshihiko Noda.jpg;8657;8665;10229;288;288;0
/net/per920a/export/das14a/satoh-lab/haolin/nhk/excerpts/2010_10_12_19_00_1.webm;Naoto KAN.jpg;4701;4709;11573;156;157;1
/net/per920a/export/das14a/satoh-lab/haolin/nhk/excerpts/2010_10_12_19_00_1.webm;Naoto KAN.jpg;4781;4965;11573;159;165;6
/net/per920a/export/das14a/satoh-lab/haolin/nhk/excerpts/2010_10_12_19_00_1.webm;Naoto KAN.jpg;5613;5629;11573;187;187;0
/net/per920a/export/das14a/satoh-lab/haolin/nhk/excerpts/2010_10_12_19_00_1.webm;Naoto KAN.jpg;5677;5741;11573;189;191;2
/net/per920a/export/das14a/satoh-lab/haolin/nhk/excerpts/2010_10_12_19_00_1.webm;Naoto KAN.jpg;5769;5837;11573;192;194;2
/net/per920a/export/das14a/satoh-lab/haolin/nhk/excerpts/2010_10_12_19_00_1.webm;Naoto KAN.jpg;5853;6141;11573;195;204;9
/net/per920a/export/das14a/satoh-lab/haolin/nhk/excerpts/2010_10_12_19_00_1.webm;Naoto KAN.jpg;6161;6985;11573;205;232;27
/net/per920a/export/das14a/satoh-lab/haolin/nhk/excerpts/2010_10_12_19_00_1.webm;Naoto KAN.jpg;7009;7061;11573;233;235;2
/net/per920a/export/das14a/satoh-lab/haolin/nhk/excerpts/2010_10_12_19_00_1.webm;Naoto KAN.jpg;7081;7097;11573;236;236;0
/net/per920a/export/das14a/satoh-lab/haolin/nhk/excerpts/2010_10_12_19_00_1.webm;Naoto KAN.jpg;7109;7129;11573;237;237;0
/net/per920a/export/das14a/satoh-lab/haolin/nhk/excerpts/2010_10_12_19_00_1.webm;Naoto KAN.jpg;7141;7513;11573;238;250;12
/net/per920a/export/das14a/satoh-lab/haolin/nhk/excerpts/2010_10_12_19_00_1.webm;Naoto KAN.jpg;7529;7645;11573;251;254;3
/net/per920a/export/das14a/satoh-lab/haolin/nhk/excerpts/2010_10_12_19_00_1.webm;Naoto KAN.jpg;7661;8085;11573;255;269;14
/net/per920a/export/das14a/satoh-lab/haolin/nhk/excerpts/2010_10_12_19_00_1.webm;Naoto KAN.jpg;8097;8101;11573;270;270;0
/net/per920a/export/das14a/satoh-lab/haolin/nhk/excerpts/2010_10_12_19_00_1.webm;Katsuya OKADA.jpg;10241;10469;11573;341;349;8
/net/per920a/export/das14a/satoh-lab/haolin/nhk/excerpts/2010_10_12_19_00_1.webm;Katsuya OKADA.jpg;10545;11501;11573;351;383;32
/net/per920a/export/das14a/satoh-lab/haolin/nhk/excerpts/2010_11_01_19_00_2.webm;Seiji MAEHARA.jpg;6745;6761;13525;224;225;1
/net/per920a/export/das14a/satoh-lab/haolin/nhk/excerpts/2010_11_01_19_00_2.webm;Seiji MAEHARA.jpg;12381;12429;13525;412;414;2
/net/per920a/export/das14a/satoh-lab/haolin/nhk/excerpts/2010_11_01_19_00_2.webm;Seiji MAEHARA.jpg;12441;12445;13525;414;414;0
/net/per920a/export/das14a/satoh-lab/haolin/nhk/excerpts/2010_11_13_19_00_1.webm;Naoto KAN.jpg;649;733;32769;21;24;3
/net/per920a/export/das14a/satoh-lab/haolin/nhk/excerpts/2010_11_13_19_00_1.webm;Naoto KAN.jpg;2073;2205;32769;69;73;4
/net/per920a/export/das14a/satoh-lab/haolin/nhk/excerpts/2010_11_13_19_00_1.webm;Naoto KAN.jpg;2221;2329;32769;74;77;3
/net/per920a/export/das14a/satoh-lab/haolin/nhk/excerpts/2010_11_13_19_00_1.webm;Naoto KAN.jpg;2425;2705;32769;80;90;10
/net/per920a/export/das14a/satoh-lab/haolin/nhk/excerpts/2010_11_13_19_00_1.webm;Naoto KAN.jpg;4173;4349;32769;139;145;6
/net/per920a/export/das14a/satoh-lab/haolin/nhk/excerpts/2010_11_13_19_00_1.webm;Naoto KAN.jpg;5753;5753;32769;191;191;0
/net/per920a/export/das14a/satoh-lab/haolin/nhk/excerpts/2010_11_13_19_00_1.webm;Naoto KAN.jpg;5769;5793;32769;192;193;1
/net/per920a/export/das14a/satoh-lab/haolin/nhk/excerpts/2010_11_13_19_00_1.webm;Naoto KAN.jpg;10633;10641;32769;354;354;0
/net/per920a/export/das14a/satoh-lab/haolin/nhk/excerpts/2010_11_13_19_00_1.webm;Naoto KAN.jpg;10653;10665;32769;355;355;0
/net/per920a/export/das14a/satoh-lab/haolin/nhk/excerpts/2010_11_13_19_00_1.webm;Naoto KAN.jpg;15337;16261;32769;511;542;31
/net/per920a/export/das14a/satoh-lab/haolin/nhk/excerpts/2010_11_13_19_00_1.webm;Naoto KAN.jpg;16277;16385;32769;542;546;4
/net/per920a/export/das14a/satoh-lab/haolin/nhk/excerpts/2010_11_13_19_00_1.webm;Naoto KAN.jpg;16401;17037;32769;547;568;21
/net/per920a/export/das14a/satoh-lab/haolin/nhk/excerpts/2010_11_13_19_00_1.webm;Naoto KAN.jpg;17113;17153;32769;570;572;2
/net/per920a/export/das14a/satoh-lab/haolin/nhk/excerpts/2010_11_13_19_00_1.webm;Naoto KAN.jpg;17865;18249;32769;595;608;13
/net/per920a/export/das14a/satoh-lab/haolin/nhk/excerpts/2010_11_13_19_00_1.webm;Naoto KAN.jpg;18413;18665;32769;614;622;8
/net/per920a/export/das14a/satoh-lab/haolin/nhk/excerpts/2010_11_13_19_00_1.webm;Naoto KAN.jpg;18677;19233;32769;622;641;19
/net/per920a/export/das14a/satoh-lab/haolin/nhk/excerpts/2010_11_13_19_00_1.webm;Naoto KAN.jpg;21649;21653;32769;722;722;0
/net/per920a/export/das14a/satoh-lab/haolin/nhk/excerpts/2010_11_13_19_00_1.webm;Naoto KAN.jpg;21669;21713;32769;722;724;2
/net/per920a/export/das14a/satoh-lab/haolin/nhk/excerpts/2010_11_13_19_00_1.webm;Naoto KAN.jpg;21729;21769;32769;724;726;2
/net/per920a/export/das14a/satoh-lab/haolin/nhk/excerpts/2010_11_13_19_00_1.webm;Naoto KAN.jpg;22917;23301;32769;764;777;13
/net/per920a/export/das14a/satoh-lab/haolin/nhk/excerpts/2010_11_13_19_00_1.webm;Naoto KAN.jpg;29933;29969;32769;998;999;1
/net/per920a/export/das14a/satoh-lab/haolin/nhk/excerpts/2010_11_13_19_00_1.webm;Naoto KAN.jpg;29985;30005;32769;1000;1000;0
/net/per920a/export/das14a/satoh-lab/haolin/nhk/excerpts/2010_11_13_19_00_1.webm;Naoto KAN.jpg;30021;30089;32769;1001;1003;2
/net/per920a/export/das14a/satoh-lab/haolin/nhk/excerpts/2010_11_13_19_00_1.webm;Naoto KAN.jpg;30769;31045;32769;1026;1035;9
/net/per920a/export/das14a/satoh-lab/haolin/nhk/excerpts/2010_11_13_19_00_1.webm;Seiji MAEHARA.jpg;14049;14049;32769;468;468;0
/net/per920a/export/das14a/satoh-lab/haolin/nhk/excerpts/2010_11_13_19_00_1.webm;Seiji MAEHARA.jpg;14061;14125;32769;469;471;2
/net/per920a/export/das14a/satoh-lab/haolin/nhk/excerpts/2010_11_27_19_00_2.webm;Naoto KAN.jpg;9;61;6181;0;2;2
/net/per920a/export/das14a/satoh-lab/haolin/nhk/excerpts/2010_11_27_19_00_2.webm;Naoto KAN.jpg;77;537;6181;2;17;15
/net/per920a/export/das14a/satoh-lab/haolin/nhk/excerpts/2010_11_27_19_00_2.webm;Naoto KAN.jpg;553;817;6181;18;27;9
/net/per920a/export/das14a/satoh-lab/haolin/nhk/excerpts/2010_11_27_19_00_2.webm;Naoto KAN.jpg;1821;1833;6181;60;61;1
/net/per920a/export/das14a/satoh-lab/haolin/nhk/excerpts/2010_11_27_19_00_2.webm;Naoto KAN.jpg;1849;1853;6181;61;61;0
/net/per920a/export/das14a/satoh-lab/haolin/nhk/excerpts/2010_11_27_19_00_2.webm;Naoto KAN.jpg;1869;1969;6181;62;65;3
/net/per920a/export/das14a/satoh-lab/haolin/nhk/excerpts/2010_11_27_19_00_2.webm;Naoto KAN.jpg;1985;2081;6181;66;69;3
/net/per920a/export/das14a/satoh-lab/haolin/nhk/excerpts/2010_11_27_19_00_2.webm;Naoto KAN.jpg;2097;2109;6181;69;70;1
/net/per920a/export/das14a/satoh-lab/haolin/nhk/excerpts/2010_11_27_19_00_2.webm;Naoto KAN.jpg;2121;2145;6181;70;71;1
/net/per920a/export/das14a/satoh-lab/haolin/nhk/excerpts/2010_11_27_19_00_2.webm;Naoto KAN.jpg;2157;2193;6181;71;73;2
/net/per920a/export/das14a/satoh-lab/haolin/nhk/excerpts/2010_11_27_19_00_2.webm;Naoto KAN.jpg;2209;2265;6181;73;75;2
/net/per920a/export/das14a/satoh-lab/haolin/nhk/excerpts/2010_11_27_19_00_2.webm;Naoto KAN.jpg;2285;2289;6181;76;76;0
/net/per920a/export/das14a/satoh-lab/haolin/nhk/excerpts/2010_11_27_19_00_2.webm;Naoto KAN.jpg;2301;2321;6181;76;77;1
/net/per920a/export/das14a/satoh-lab/haolin/nhk/excerpts/2010_11_27_19_00_2.webm;Naoto KAN.jpg;2353;2353;6181;78;78;0
/net/per920a/export/das14a/satoh-lab/haolin/nhk/excerpts/2010_11_27_19_00_2.webm;Naoto KAN.jpg;2373;2373;6181;79;79;0
/net/per920a/export/das14a/satoh-lab/haolin/nhk/excerpts/2010_11_27_19_00_2.webm;Naoto KAN.jpg;2385;2385;6181;79;79;0
/net/per920a/export/das14a/satoh-lab/haolin/nhk/excerpts/2010_11_27_19_00_2.webm;Naoto KAN.jpg;2429;2429;6181;80;80;0
/net/per920a/export/das14a/satoh-lab/haolin/nhk/excerpts/2010_11_27_19_00_2.webm;Naoto KAN.jpg;2465;2465;6181;82;82;0
/net/per920a/export/das14a/satoh-lab/haolin/nhk/excerpts/2010_11_27_19_00_2.webm;Naoto KAN.jpg;2505;2601;6181;83;86;3
/net/per920a/export/das14a/satoh-lab/haolin/nhk/excerpts/2010_11_27_19_00_2.webm;Naoto KAN.jpg;2629;2633;6181;87;87;0
/net/per920a/export/das14a/satoh-lab/haolin/nhk/excerpts/2010_11_27_19_00_2.webm;Naoto KAN.jpg;2673;2677;6181;89;89;0
/net/per920a/export/das14a/satoh-lab/haolin/nhk/excerpts/2010_11_27_19_00_2.webm;Naoto KAN.jpg;2697;2765;6181;89;92;3
/net/per920a/export/das14a/satoh-lab/haolin/nhk/excerpts/2010_11_27_19_00_2.webm;Naoto KAN.jpg;2781;2785;6181;92;92;0
/net/per920a/export/das14a/satoh-lab/haolin/nhk/excerpts/2010_11_27_19_00_2.webm;Naoto KAN.jpg;2805;2809;6181;93;93;0
/net/per920a/export/das14a/satoh-lab/haolin/nhk/excerpts/2010_11_27_19_00_2.webm;Naoto KAN.jpg;2881;2881;6181;96;96;0
/net/per920a/export/das14a/satoh-lab/haolin/nhk/excerpts/2010_11_27_19_00_2.webm;Naoto KAN.jpg;2893;2901;6181;96;96;0
/net/per920a/export/das14a/satoh-lab/haolin/nhk/excerpts/2010_11_27_19_00_2.webm;Naoto KAN.jpg;2925;2925;6181;97;97;0
/net/per920a/export/das14a/satoh-lab/haolin/nhk/excerpts/2010_11_27_19_00_2.webm;Naoto KAN.jpg;2945;2957;6181;98;98;0
/net/per920a/export/das14a/satoh-lab/haolin/nhk/excerpts/2010_11_27_19_00_2.webm;Naoto KAN.jpg;3037;3045;6181;101;101;0
/net/per920a/export/das14a/satoh-lab/haolin/nhk/excerpts/2010_11_27_19_00_2.webm;Naoto KAN.jpg;3061;3061;6181;102;102;0
/net/per920a/export/das14a/satoh-lab/haolin/nhk/excerpts/2010_11_27_19_00_2.webm;Naoto KAN.jpg;3089;3089;6181;102;102;0
/net/per920a/export/das14a/satoh-lab/haolin/nhk/excerpts/2010_11_27_19_00_2.webm;Naoto KAN.jpg;3101;3101;6181;103;103;0
/net/per920a/export/das14a/satoh-lab/haolin/nhk/excerpts/2010_11_27_19_00_2.webm;Naoto KAN.jpg;3157;3161;6181;105;105;0
/net/per920a/export/das14a/satoh-lab/haolin/nhk/excerpts/2010_11_27_19_00_2.webm;Naoto KAN.jpg;3173;3189;6181;105;106;1
/net/per920a/export/das14a/satoh-lab/haolin/nhk/excerpts/2010_11_27_19_00_2.webm;Naoto KAN.jpg;3225;3241;6181;107;108;1
/net/per920a/export/das14a/satoh-lab/haolin/nhk/excerpts/2010_11_27_19_00_2.webm;Naoto KAN.jpg;3257;3285;6181;108;109;1
/net/per920a/export/das14a/satoh-lab/haolin/nhk/excerpts/2010_11_27_19_00_2.webm;Naoto KAN.jpg;3325;3341;6181;110;111;1
/net/per920a/export/das14a/satoh-lab/haolin/nhk/excerpts/2010_11_27_19_00_2.webm;Naoto KAN.jpg;3389;3389;6181;112;112;0
/net/per920a/export/das14a/satoh-lab/haolin/nhk/excerpts/2010_11_27_19_00_2.webm;Naoto KAN.jpg;3429;3433;6181;114;114;0
/net/per920a/export/das14a/satoh-lab/haolin/nhk/excerpts/2010_11_27_19_00_2.webm;Yukio HATOYAMA.jpg;1869;1969;6181;62;65;3
/net/per920a/export/das14a/satoh-lab/haolin/nhk/excerpts/2010_11_27_19_00_2.webm;Yukio HATOYAMA.jpg;2097;2109;6181;69;70;1
/net/per920a/export/das14a/satoh-lab/haolin/nhk/excerpts/2010_11_27_19_00_2.webm;Yukio HATOYAMA.jpg;2121;2145;6181;70;71;1
/net/per920a/export/das14a/satoh-lab/haolin/nhk/excerpts/2010_11_27_19_00_2.webm;Yukio HATOYAMA.jpg;2157;2193;6181;71;73;2
/net/per920a/export/das14a/satoh-lab/haolin/nhk/excerpts/2010_11_27_19_00_2.webm;Yukio HATOYAMA.jpg;2209;2213;6181;73;73;0
/net/per920a/export/das14a/satoh-lab/haolin/nhk/excerpts/2010_11_27_19_00_2.webm;Yukio HATOYAMA.jpg;2301;2321;6181;76;77;1
/net/per920a/export/das14a/satoh-lab/haolin/nhk/excerpts/2010_11_27_19_00_2.webm;Yukio HATOYAMA.jpg;2353;2353;6181;78;78;0
/net/per920a/export/das14a/satoh-lab/haolin/nhk/excerpts/2010_11_27_19_00_2.webm;Yukio HATOYAMA.jpg;2385;2385;6181;79;79;0
/net/per920a/export/das14a/satoh-lab/haolin/nhk/excerpts/2010_11_27_19_00_2.webm;Yukio HATOYAMA.jpg;2429;2429;6181;80;80;0
/net/per920a/export/das14a/satoh-lab/haolin/nhk/excerpts/2010_11_27_19_00_2.webm;Yukio HATOYAMA.jpg;2465;2465;6181;82;82;0
/net/per920a/export/das14a/satoh-lab/haolin/nhk/excerpts/2010_11_27_19_00_2.webm;Yukio HATOYAMA.jpg;2505;2601;6181;83;86;3
/net/per920a/export/das14a/satoh-lab/haolin/nhk/excerpts/2010_11_27_19_00_2.webm;Yukio HATOYAMA.jpg;2629;2633;6181;87;87;0
/net/per920a/export/das14a/satoh-lab/haolin/nhk/excerpts/2010_11_27_19_00_2.webm;Yukio HATOYAMA.jpg;2673;2677;6181;89;89;0
/net/per920a/export/das14a/satoh-lab/haolin/nhk/excerpts/2010_11_27_19_00_2.webm;Yukio HATOYAMA.jpg;2697;2765;6181;89;92;3
/net/per920a/export/das14a/satoh-lab/haolin/nhk/excerpts/2010_11_27_19_00_2.webm;Yukio HATOYAMA.jpg;2781;2785;6181;92;92;0
/net/per920a/export/das14a/satoh-lab/haolin/nhk/excerpts/2010_11_27_19_00_2.webm;Yukio HATOYAMA.jpg;2893;2901;6181;96;96;0
/net/per920a/export/das14a/satoh-lab/haolin/nhk/excerpts/2010_11_27_19_00_2.webm;Yukio HATOYAMA.jpg;2925;2925;6181;97;97;0
/net/per920a/export/das14a/satoh-lab/haolin/nhk/excerpts/2010_11_27_19_00_2.webm;Yukio HATOYAMA.jpg;2945;2957;6181;98;98;0
/net/per920a/export/das14a/satoh-lab/haolin/nhk/excerpts/2010_11_27_19_00_2.webm;Yukio HATOYAMA.jpg;3037;3045;6181;101;101;0
/net/per920a/export/das14a/satoh-lab/haolin/nhk/excerpts/2010_11_27_19_00_2.webm;Yukio HATOYAMA.jpg;3061;3061;6181;102;102;0
/net/per920a/export/das14a/satoh-lab/haolin/nhk/excerpts/2010_11_27_19_00_2.webm;Yukio HATOYAMA.jpg;3101;3101;6181;103;103;0
/net/per920a/export/das14a/satoh-lab/haolin/nhk/excerpts/2010_11_27_19_00_2.webm;Yukio HATOYAMA.jpg;3157;3161;6181;105;105;0
/net/per920a/export/das14a/satoh-lab/haolin/nhk/excerpts/2010_11_27_19_00_2.webm;Yukio HATOYAMA.jpg;3173;3189;6181;105;106;1
/net/per920a/export/das14a/satoh-lab/haolin/nhk/excerpts/2010_11_27_19_00_2.webm;Yukio HATOYAMA.jpg;3225;3241;6181;107;108;1
/net/per920a/export/das14a/satoh-lab/haolin/nhk/excerpts/2010_11_27_19_00_2.webm;Yukio HATOYAMA.jpg;3257;3285;6181;108;109;1
/net/per920a/export/das14a/satoh-lab/haolin/nhk/excerpts/2010_11_27_19_00_2.webm;Katsuya OKADA.jpg;5353;5445;6181;178;181;3
/net/per920a/export/das14a/satoh-lab/haolin/nhk/excerpts/2010_11_27_19_00_2.webm;Katsuya OKADA.jpg;5461;5709;6181;182;190;8
/net/per920a/export/das14a/satoh-lab/haolin/nhk/excerpts/2010_11_27_19_00_2.webm;Katsuya OKADA.jpg;5725;6177;6181;190;205;15
/net/per920a/export/das14a/satoh-lab/haolin/nhk/excerpts/2010_12_02_19_00_2.webm;Yoshihiko Noda.jpg;2405;2409;3421;80;80;0
/net/per920a/export/das14a/satoh-lab/haolin/nhk/excerpts/2010_12_02_19_00_2.webm;Yoshihiko Noda.jpg;2421;2421;3421;80;80;0
/net/per920a/export/das14a/satoh-lab/haolin/nhk/excerpts/2010_12_02_19_00_2.webm;Yoshihiko Noda.jpg;2433;2437;3421;81;81;0
/net/per920a/export/das14a/satoh-lab/haolin/nhk/excerpts/2010_12_06_19_00_1.webm;Seiji MAEHARA.jpg;9101;9589;12413;303;319;16
/net/per920a/export/das14a/satoh-lab/haolin/nhk/excerpts/2010_12_06_19_00_1.webm;Seiji MAEHARA.jpg;9605;9673;12413;320;322;2
/net/per920a/export/das14a/satoh-lab/haolin/nhk/excerpts/2010_12_06_19_00_1.webm;Seiji MAEHARA.jpg;9701;9713;12413;323;323;0
/net/per920a/export/das14a/satoh-lab/haolin/nhk/excerpts/2010_12_06_19_00_1.webm;Seiji MAEHARA.jpg;10849;10885;12413;361;363;2
/net/per920a/export/das14a/satoh-lab/haolin/nhk/excerpts/2010_12_06_19_00_1.webm;Seiji MAEHARA.jpg;10901;11077;12413;363;369;6
/net/per920a/export/das14a/satoh-lab/haolin/nhk/excerpts/2010_12_06_19_00_1.webm;Seiji MAEHARA.jpg;11093;11217;12413;369;374;5
/net/per920a/export/das14a/satoh-lab/haolin/nhk/excerpts/2010_12_15_19_00_3.webm;Ichiro OZAWA.jpg;101;121;2797;3;4;1
/net/per920a/export/das14a/satoh-lab/haolin/nhk/excerpts/2010_12_15_19_00_3.webm;Ichiro OZAWA.jpg;137;605;2797;4;20;16
/net/per920a/export/das14a/satoh-lab/haolin/nhk/excerpts/2010_12_15_19_00_3.webm;Ichiro OZAWA.jpg;1169;1169;2797;38;38;0
/net/per920a/export/das14a/satoh-lab/haolin/nhk/excerpts/2010_12_15_19_00_3.webm;Ichiro OZAWA.jpg;1189;1193;2797;39;39;0
/net/per920a/export/das14a/satoh-lab/haolin/nhk/excerpts/2010_12_15_19_00_3.webm;Ichiro OZAWA.jpg;1209;1221;2797;40;40;0
/net/per920a/export/das14a/satoh-lab/haolin/nhk/excerpts/2010_12_15_19_00_3.webm;Ichiro OZAWA.jpg;1249;1253;2797;41;41;0
/net/per920a/export/das14a/satoh-lab/haolin/nhk/excerpts/2010_12_15_19_00_3.webm;Ichiro OZAWA.jpg;1265;1269;2797;42;42;0
/net/per920a/export/das14a/satoh-lab/haolin/nhk/excerpts/2010_12_15_19_00_3.webm;Ichiro OZAWA.jpg;1293;1309;2797;42;43;1
/net/per920a/export/das14a/satoh-lab/haolin/nhk/excerpts/2010_12_15_19_00_3.webm;Ichiro OZAWA.jpg;1873;1921;2797;62;63;1
/net/per920a/export/das14a/satoh-lab/haolin/nhk/excerpts/2010_12_15_19_00_3.webm;Katsuya OKADA.jpg;1957;1993;2797;65;66;1
/net/per920a/export/das14a/satoh-lab/haolin/nhk/excerpts/2010_12_15_19_00_3.webm;Katsuya OKADA.jpg;2009;2021;2797;66;67;1
/net/per920a/export/das14a/satoh-lab/haolin/nhk/excerpts/2010_12_15_19_00_3.webm;Katsuya OKADA.jpg;2053;2069;2797;68;68;0
/net/per920a/export/das14a/satoh-lab/haolin/nhk/excerpts/2010_12_15_19_00_3.webm;Katsuya OKADA.jpg;2137;2157;2797;71;71;0
/net/per920a/export/das14a/satoh-lab/haolin/nhk/excerpts/2010_12_15_19_00_3.webm;Katsuya OKADA.jpg;2621;2621;2797;87;87;0
/net/per920a/export/das14a/satoh-lab/haolin/nhk/excerpts/2010_12_15_19_00_3.webm;Katsuya OKADA.jpg;2637;2641;2797;87;87;0
/net/per920a/export/das14a/satoh-lab/haolin/nhk/excerpts/2010_12_15_19_00_3.webm;Katsuya OKADA.jpg;2653;2669;2797;88;88;0
/net/per920a/export/das14a/satoh-lab/haolin/nhk/excerpts/2010_12_15_19_00_3.webm;Katsuya OKADA.jpg;2685;2689;2797;89;89;0
/net/per920a/export/das14a/satoh-lab/haolin/nhk/excerpts/2010_12_20_19_00_2.webm;Ichiro OZAWA.jpg;21;725;14905;0;24;24
/net/per920a/export/das14a/satoh-lab/haolin/nhk/excerpts/2010_12_20_19_00_2.webm;Ichiro OZAWA.jpg;1029;1049;14905;34;34;0
/net/per920a/export/das14a/satoh-lab/haolin/nhk/excerpts/2010_12_20_19_00_2.webm;Ichiro OZAWA.jpg;1061;1065;14905;35;35;0
/net/per920a/export/das14a/satoh-lab/haolin/nhk/excerpts/2010_12_20_19_00_2.webm;Ichiro OZAWA.jpg;1961;2445;14905;65;81;16
/net/per920a/export/das14a/satoh-lab/haolin/nhk/excerpts/2010_12_20_19_00_2.webm;Ichiro OZAWA.jpg;2613;2621;14905;87;87;0
/net/per920a/export/das14a/satoh-lab/haolin/nhk/excerpts/2010_12_20_19_00_2.webm;Ichiro OZAWA.jpg;11985;12089;14905;399;403;4
/net/per920a/export/das14a/satoh-lab/haolin/nhk/excerpts/2010_12_20_19_00_2.webm;Ichiro OZAWA.jpg;12965;12993;14905;432;433;1
/net/per920a/export/das14a/satoh-lab/haolin/nhk/excerpts/2010_12_20_19_00_2.webm;Naoto KAN.jpg;1237;1289;14905;41;42;1
/net/per920a/export/das14a/satoh-lab/haolin/nhk/excerpts/2010_12_20_19_00_2.webm;Naoto KAN.jpg;1301;1321;14905;43;44;1
/net/per920a/export/das14a/satoh-lab/haolin/nhk/excerpts/2010_12_20_19_00_2.webm;Naoto KAN.jpg;1357;1361;14905;45;45;0
/net/per920a/export/das14a/satoh-lab/haolin/nhk/excerpts/2010_12_20_19_00_2.webm;Naoto KAN.jpg;1377;1377;14905;45;45;0
/net/per920a/export/das14a/satoh-lab/haolin/nhk/excerpts/2010_12_20_19_00_2.webm;Naoto KAN.jpg;1397;1417;14905;46;47;1
/net/per920a/export/das14a/satoh-lab/haolin/nhk/excerpts/2010_12_20_19_00_2.webm;Naoto KAN.jpg;1445;1465;14905;48;48;0
/net/per920a/export/das14a/satoh-lab/haolin/nhk/excerpts/2010_12_20_19_00_2.webm;Naoto KAN.jpg;1837;1949;14905;61;64;3
/net/per920a/export/das14a/satoh-lab/haolin/nhk/excerpts/2010_12_20_19_00_2.webm;Naoto KAN.jpg;1961;2445;14905;65;81;16
/net/per920a/export/das14a/satoh-lab/haolin/nhk/excerpts/2010_12_20_19_00_2.webm;Naoto KAN.jpg;2801;2825;14905;93;94;1
/net/per920a/export/das14a/satoh-lab/haolin/nhk/excerpts/2010_12_20_19_00_2.webm;Naoto KAN.jpg;2841;2869;14905;94;95;1
/net/per920a/export/das14a/satoh-lab/haolin/nhk/excerpts/2010_12_20_19_00_2.webm;Naoto KAN.jpg;2893;2897;14905;96;96;0
/net/per920a/export/das14a/satoh-lab/haolin/nhk/excerpts/2010_12_20_19_00_2.webm;Naoto KAN.jpg;2909;2953;14905;96;98;2
/net/per920a/export/das14a/satoh-lab/haolin/nhk/excerpts/2010_12_20_19_00_2.webm;Naoto KAN.jpg;2977;3053;14905;99;101;2
/net/per920a/export/das14a/satoh-lab/haolin/nhk/excerpts/2010_12_20_19_00_2.webm;Naoto KAN.jpg;3069;3125;14905;102;104;2
/net/per920a/export/das14a/satoh-lab/haolin/nhk/excerpts/2010_12_20_19_00_2.webm;Naoto KAN.jpg;3145;3153;14905;104;105;1
/net/per920a/export/das14a/satoh-lab/haolin/nhk/excerpts/2010_12_20_19_00_2.webm;Naoto KAN.jpg;3185;3189;14905;106;106;0
/net/per920a/export/das14a/satoh-lab/haolin/nhk/excerpts/2010_12_20_19_00_2.webm;Naoto KAN.jpg;3213;3245;14905;107;108;1
/net/per920a/export/das14a/satoh-lab/haolin/nhk/excerpts/2010_12_20_19_00_2.webm;Naoto KAN.jpg;3257;3261;14905;108;108;0
/net/per920a/export/das14a/satoh-lab/haolin/nhk/excerpts/2010_12_20_19_00_2.webm;Naoto KAN.jpg;3281;3365;14905;109;112;3
/net/per920a/export/das14a/satoh-lab/haolin/nhk/excerpts/2010_12_20_19_00_2.webm;Naoto KAN.jpg;3377;3413;14905;112;113;1
/net/per920a/export/das14a/satoh-lab/haolin/nhk/excerpts/2010_12_20_19_00_2.webm;Naoto KAN.jpg;3425;3473;14905;114;115;1
/net/per920a/export/das14a/satoh-lab/haolin/nhk/excerpts/2010_12_20_19_00_2.webm;Naoto KAN.jpg;3489;3573;14905;116;119;3
/net/per920a/export/das14a/satoh-lab/haolin/nhk/excerpts/2010_12_20_19_00_2.webm;Naoto KAN.jpg;3589;3721;14905;119;124;5
/net/per920a/export/das14a/satoh-lab/haolin/nhk/excerpts/2010_12_20_19_00_2.webm;Naoto KAN.jpg;3737;3789;14905;124;126;2
/net/per920a/export/das14a/satoh-lab/haolin/nhk/excerpts/2010_12_20_19_00_2.webm;Naoto KAN.jpg;3801;3813;14905;126;127;1
/net/per920a/export/das14a/satoh-lab/haolin/nhk/excerpts/2010_12_20_19_00_2.webm;Naoto KAN.jpg;3825;4077;14905;127;135;8
/net/per920a/export/das14a/satoh-lab/haolin/nhk/excerpts/2010_12_20_19_00_2.webm;Katsuya OKADA.jpg;2909;2961;14905;96;98;2
/net/per920a/export/das14a/satoh-lab/haolin/nhk/excerpts/2010_12_20_19_00_2.webm;Katsuya OKADA.jpg;2977;3053;14905;99;101;2
/net/per920a/export/das14a/satoh-lab/haolin/nhk/excerpts/2010_12_20_19_00_2.webm;Katsuya OKADA.jpg;3069;3125;14905;102;104;2
/net/per920a/export/das14a/satoh-lab/haolin/nhk/excerpts/2010_12_20_19_00_2.webm;Katsuya OKADA.jpg;3145;3153;14905;104;105;1
/net/per920a/export/das14a/satoh-lab/haolin/nhk/excerpts/2010_12_20_19_00_2.webm;Katsuya OKADA.jpg;3185;3189;14905;106;106;0
/net/per920a/export/das14a/satoh-lab/haolin/nhk/excerpts/2010_12_20_19_00_2.webm;Katsuya OKADA.jpg;3213;3245;14905;107;108;1
/net/per920a/export/das14a/satoh-lab/haolin/nhk/excerpts/2010_12_20_19_00_2.webm;Katsuya OKADA.jpg;3257;3261;14905;108;108;0
/net/per920a/export/das14a/satoh-lab/haolin/nhk/excerpts/2010_12_20_19_00_2.webm;Katsuya OKADA.jpg;3281;3365;14905;109;112;3
/net/per920a/export/das14a/satoh-lab/haolin/nhk/excerpts/2010_12_20_19_00_2.webm;Katsuya OKADA.jpg;3377;3413;14905;112;113;1
/net/per920a/export/das14a/satoh-lab/haolin/nhk/excerpts/2010_12_20_19_00_2.webm;Katsuya OKADA.jpg;3425;3473;14905;114;115;1
/net/per920a/export/das14a/satoh-lab/haolin/nhk/excerpts/2010_12_20_19_00_2.webm;Katsuya OKADA.jpg;3489;3573;14905;116;119;3
/net/per920a/export/das14a/satoh-lab/haolin/nhk/excerpts/2010_12_20_19_00_2.webm;Katsuya OKADA.jpg;3589;3721;14905;119;124;5
/net/per920a/export/das14a/satoh-lab/haolin/nhk/excerpts/2010_12_20_19_00_2.webm;Katsuya OKADA.jpg;3737;3789;14905;124;126;2
/net/per920a/export/das14a/satoh-lab/haolin/nhk/excerpts/2010_12_20_19_00_2.webm;Katsuya OKADA.jpg;3801;3813;14905;126;127;1
/net/per920a/export/das14a/satoh-lab/haolin/nhk/excerpts/2010_12_20_19_00_2.webm;Katsuya OKADA.jpg;4465;4609;14905;148;153;5
/net/per920a/export/das14a/satoh-lab/haolin/nhk/excerpts/2010_12_20_19_00_2.webm;Katsuya OKADA.jpg;5185;5281;14905;172;176;4
/net/per920a/export/das14a/satoh-lab/haolin/nhk/excerpts/2010_12_20_19_00_2.webm;Katsuya OKADA.jpg;5537;6397;14905;184;213;29
/net/per920a/export/das14a/satoh-lab/haolin/nhk/excerpts/2010_12_20_19_00_2.webm;Katsuya OKADA.jpg;13145;13169;14905;438;439;1
/net/per920a/export/das14a/satoh-lab/haolin/nhk/excerpts/2010_12_20_19_00_2.webm;Katsuya OKADA.jpg;13709;13889;14905;457;463;6
/net/per920a/export/das14a/satoh-lab/haolin/nhk/excerpts/2010_12_20_19_00_2.webm;Yukio HATOYAMA.jpg;7277;7293;14905;242;243;1
/net/per920a/export/das14a/satoh-lab/haolin/nhk/excerpts/2010_12_20_19_00_2.webm;Yukio HATOYAMA.jpg;7305;7309;14905;243;243;0
/net/per920a/export/das14a/satoh-lab/haolin/nhk/excerpts/2010_12_20_19_00_2.webm;Yukio HATOYAMA.jpg;7329;7337;14905;244;244;0
/net/per920a/export/das14a/satoh-lab/haolin/nhk/excerpts/2010_12_20_19_00_2.webm;Yukio HATOYAMA.jpg;7361;7421;14905;245;247;2
/net/per920a/export/das14a/satoh-lab/haolin/nhk/excerpts/2010_12_20_19_00_2.webm;Yukio HATOYAMA.jpg;7437;7481;14905;247;249;2
/net/per920a/export/das14a/satoh-lab/haolin/nhk/excerpts/2010_12_20_19_00_2.webm;Yukio HATOYAMA.jpg;7497;7525;14905;249;250;1
/net/per920a/export/das14a/satoh-lab/haolin/nhk/excerpts/2010_12_20_19_00_2.webm;Yukio HATOYAMA.jpg;7549;7761;14905;251;258;7
/net/per920a/export/das14a/satoh-lab/haolin/nhk/excerpts/2010_12_20_19_00_2.webm;Yukio HATOYAMA.jpg;7777;8009;14905;259;267;8
/net/per920a/export/das14a/satoh-lab/haolin/nhk/excerpts/2010_12_20_19_00_2.webm;Yukio HATOYAMA.jpg;8029;8029;14905;267;267;0
/net/per920a/export/das14a/satoh-lab/haolin/nhk/excerpts/2010_12_20_19_00_2.webm;Yukio HATOYAMA.jpg;8049;8181;14905;268;272;4
/net/per920a/export/das14a/satoh-lab/haolin/nhk/excerpts/2010_12_20_19_00_2.webm;Yukio HATOYAMA.jpg;8197;8221;14905;273;274;1
/net/per920a/export/das14a/satoh-lab/haolin/nhk/excerpts/2010_12_20_19_00_2.webm;Yukio HATOYAMA.jpg;8237;8237;14905;274;274;0
/net/per920a/export/das14a/satoh-lab/haolin/nhk/excerpts/2010_12_20_19_00_2.webm;Yukio HATOYAMA.jpg;8253;8257;14905;275;275;0
/net/per920a/export/das14a/satoh-lab/haolin/nhk/excerpts/2010_12_20_19_00_2.webm;Yukio HATOYAMA.jpg;8281;8293;14905;276;276;0
/net/per920a/export/das14a/satoh-lab/haolin/nhk/excerpts/2010_12_20_19_00_2.webm;Yukio HATOYAMA.jpg;8345;8381;14905;278;279;1
/net/per920a/export/das14a/satoh-lab/haolin/nhk/excerpts/2010_12_20_19_00_2.webm;Yukio HATOYAMA.jpg;8397;8421;14905;279;280;1
/net/per920a/export/das14a/satoh-lab/haolin/nhk/excerpts/2010_12_20_19_00_2.webm;Yukio HATOYAMA.jpg;8445;8449;14905;281;281;0
/net/per920a/export/das14a/satoh-lab/haolin/nhk/excerpts/2010_12_20_19_00_2.webm;Yukio HATOYAMA.jpg;8465;8497;14905;282;283;1
/net/per920a/export/das14a/satoh-lab/haolin/nhk/excerpts/2010_12_20_19_00_2.webm;Yukio HATOYAMA.jpg;8521;8521;14905;284;284;0
/net/per920a/export/das14a/satoh-lab/haolin/nhk/excerpts/2010_12_20_19_00_2.webm;Yukio HATOYAMA.jpg;8537;8541;14905;284;284;0
/net/per920a/export/das14a/satoh-lab/haolin/nhk/excerpts/2010_12_20_19_00_2.webm;Yukio HATOYAMA.jpg;8553;8565;14905;285;285;0
/net/per920a/export/das14a/satoh-lab/haolin/nhk/excerpts/2010_12_20_19_00_2.webm;Yukio HATOYAMA.jpg;8581;8585;14905;286;286;0
/net/per920a/export/das14a/satoh-lab/haolin/nhk/excerpts/2010_12_20_19_00_2.webm;Yukio HATOYAMA.jpg;8605;8629;14905;286;287;1
/net/per920a/export/das14a/satoh-lab/haolin/nhk/excerpts/2010_12_20_19_00_2.webm;Yukio HATOYAMA.jpg;8645;8649;14905;288;288;0
/net/per920a/export/das14a/satoh-lab/haolin/nhk/excerpts/2010_12_20_19_00_2.webm;Yukio HATOYAMA.jpg;8665;8753;14905;288;291;3
/net/per920a/export/das14a/satoh-lab/haolin/nhk/excerpts/2010_12_20_19_00_2.webm;Yukio HATOYAMA.jpg;8773;8793;14905;292;293;1
/net/per920a/export/das14a/satoh-lab/haolin/nhk/excerpts/2010_12_20_19_00_2.webm;Yukio HATOYAMA.jpg;8809;9041;14905;293;301;8
/net/per920a/export/das14a/satoh-lab/haolin/nhk/excerpts/2010_12_20_19_00_2.webm;Yukio HATOYAMA.jpg;9057;9061;14905;302;302;0
/net/per920a/export/das14a/satoh-lab/haolin/nhk/excerpts/2010_12_20_19_00_2.webm;Yukio HATOYAMA.jpg;9077;9261;14905;302;308;6
/net/per920a/export/das14a/satoh-lab/haolin/nhk/excerpts/2010_12_20_19_00_2.webm;Yukio HATOYAMA.jpg;10525;10633;14905;350;354;4
/net/per920a/export/das14a/satoh-lab/haolin/nhk/excerpts/2010_12_20_19_00_2.webm;Yukio HATOYAMA.jpg;10653;10685;14905;355;356;1
/net/per920a/export/das14a/satoh-lab/haolin/nhk/excerpts/2010_12_20_19_00_2.webm;Yukio HATOYAMA.jpg;10701;10861;14905;356;362;6
/net/per920a/export/das14a/satoh-lab/haolin/nhk/excerpts/2010_12_20_19_00_2.webm;Yoshimi WATANABE.jpg;10877;10913;14905;362;363;1
/net/per920a/export/das14a/satoh-lab/haolin/nhk/excerpts/2010_12_20_19_00_2.webm;Yoshimi WATANABE.jpg;10929;10937;14905;364;364;0
/net/per920a/export/das14a/satoh-lab/haolin/nhk/excerpts/2010_12_20_19_00_2.webm;Yoshimi WATANABE.jpg;10953;10965;14905;365;365;0
/net/per920a/export/das14a/satoh-lab/haolin/nhk/excerpts/2010_12_20_19_00_2.webm;Yoshimi WATANABE.jpg;10989;11421;14905;366;380;14
/net/per920a/export/das14a/satoh-lab/haolin/nhk/excerpts/2011_01_12_19_00_1.webm;Naoto KAN.jpg;1181;2133;11333;39;71;32
/net/per920a/export/das14a/satoh-lab/haolin/nhk/excerpts/2011_01_12_19_00_1.webm;Naoto KAN.jpg;2157;2169;11333;71;72;1
/net/per920a/export/das14a/satoh-lab/haolin/nhk/excerpts/2011_01_12_19_00_1.webm;Naoto KAN.jpg;5437;5553;11333;181;185;4
/net/per920a/export/das14a/satoh-lab/haolin/nhk/excerpts/2011_01_12_19_00_1.webm;Naoto KAN.jpg;8365;8453;11333;279;281;2
/net/per920a/export/das14a/satoh-lab/haolin/nhk/excerpts/2011_01_12_19_00_1.webm;Katsuya OKADA.jpg;4957;5029;11333;165;167;2
/net/per920a/export/das14a/satoh-lab/haolin/nhk/excerpts/2011_01_12_19_00_1.webm;Katsuya OKADA.jpg;5045;5153;11333;168;171;3
/net/per920a/export/das14a/satoh-lab/haolin/nhk/excerpts/2011_01_12_19_00_1.webm;Katsuya OKADA.jpg;5169;5173;11333;172;172;0
/net/per920a/export/das14a/satoh-lab/haolin/nhk/excerpts/2011_01_12_19_00_1.webm;Katsuya OKADA.jpg;5189;5357;11333;173;178;5
/net/per920a/export/das14a/satoh-lab/haolin/nhk/excerpts/2011_01_12_19_00_1.webm;Yukio HATOYAMA.jpg;7729;7757;11333;257;258;1
/net/per920a/export/das14a/satoh-lab/haolin/nhk/excerpts/2011_01_12_19_00_1.webm;Yukio HATOYAMA.jpg;7769;7769;11333;259;259;0
/net/per920a/export/das14a/satoh-lab/haolin/nhk/excerpts/2011_01_12_19_00_1.webm;Yukio HATOYAMA.jpg;7785;7873;11333;259;262;3
/net/per920a/export/das14a/satoh-lab/haolin/nhk/excerpts/2011_01_12_19_00_1.webm;Yukio HATOYAMA.jpg;7889;7897;11333;263;263;0
/net/per920a/export/das14a/satoh-lab/haolin/nhk/excerpts/2011_01_12_19_00_1.webm;Yukio HATOYAMA.jpg;7913;7933;11333;263;264;1
/net/per920a/export/das14a/satoh-lab/haolin/nhk/excerpts/2011_01_12_19_00_1.webm;Yukio HATOYAMA.jpg;7945;7945;11333;264;264;0
/net/per920a/export/das14a/satoh-lab/haolin/nhk/excerpts/2011_01_12_19_00_1.webm;Yukio HATOYAMA.jpg;7965;7985;11333;265;266;1
/net/per920a/export/das14a/satoh-lab/haolin/nhk/excerpts/2011_01_23_19_00_3.webm;Sadakazu TANIGAKI.jpg;21;497;6513;0;16;16
/net/per920a/export/das14a/satoh-lab/haolin/nhk/excerpts/2011_01_23_19_00_3.webm;Sadakazu TANIGAKI.jpg;609;617;6513;20;20;0
/net/per920a/export/das14a/satoh-lab/haolin/nhk/excerpts/2011_01_23_19_00_3.webm;Sadakazu TANIGAKI.jpg;633;653;6513;21;21;0
/net/per920a/export/das14a/satoh-lab/haolin/nhk/excerpts/2011_01_23_19_00_3.webm;Sadakazu TANIGAKI.jpg;669;1125;6513;22;37;15
/net/per920a/export/das14a/satoh-lab/haolin/nhk/excerpts/2011_01_23_19_00_3.webm;Sadakazu TANIGAKI.jpg;1349;1485;6513;44;49;5
/net/per920a/export/das14a/satoh-lab/haolin/nhk/excerpts/2011_01_23_19_00_3.webm;Sadakazu TANIGAKI.jpg;1517;1517;6513;50;50;0
/net/per920a/export/das14a/satoh-lab/haolin/nhk/excerpts/2011_01_23_19_00_3.webm;Sadakazu TANIGAKI.jpg;1533;1785;6513;51;59;8
/net/per920a/export/das14a/satoh-lab/haolin/nhk/excerpts/2011_01_23_19_00_3.webm;Sadakazu TANIGAKI.jpg;1841;2017;6513;61;67;6
/net/per920a/export/das14a/satoh-lab/haolin/nhk/excerpts/2011_01_23_19_00_3.webm;Sadakazu TANIGAKI.jpg;2033;2385;6513;67;79;12
/net/per920a/export/das14a/satoh-lab/haolin/nhk/excerpts/2011_01_23_19_00_3.webm;Sadakazu TANIGAKI.jpg;2401;2413;6513;79;80;1
/net/per920a/export/das14a/satoh-lab/haolin/nhk/excerpts/2011_01_23_19_00_3.webm;Sadakazu TANIGAKI.jpg;2429;3217;6513;80;107;27
/net/per920a/export/das14a/satoh-lab/haolin/nhk/excerpts/2011_01_23_19_00_3.webm;Sadakazu TANIGAKI.jpg;5725;6033;6513;190;201;11
/net/per920a/export/das14a/satoh-lab/haolin/nhk/excerpts/2011_01_23_19_00_3.webm;Naoto KAN.jpg;5533;5537;6513;184;184;0
/net/per920a/export/das14a/satoh-lab/haolin/nhk/excerpts/2011_01_23_19_00_3.webm;Naoto KAN.jpg;5549;5553;6513;184;185;1
/net/per920a/export/das14a/satoh-lab/haolin/nhk/excerpts/2011_01_23_19_00_3.webm;Naoto KAN.jpg;5573;5609;6513;185;186;1
/net/per920a/export/das14a/satoh-lab/haolin/nhk/excerpts/2011_01_23_19_00_3.webm;Naoto KAN.jpg;5629;5633;6513;187;187;0
/net/per920a/export/das14a/satoh-lab/haolin/nhk/excerpts/2011_01_23_19_00_3.webm;Naoto KAN.jpg;5645;5657;6513;188;188;0
/net/per920a/export/das14a/satoh-lab/haolin/nhk/excerpts/2011_01_23_19_00_3.webm;Naoto KAN.jpg;5669;5685;6513;188;189;1
/net/per920a/export/das14a/satoh-lab/haolin/nhk/excerpts/2011_01_24_19_00_2.webm;Katsuya OKADA.jpg;133;793;6873;4;26;22
/net/per920a/export/das14a/satoh-lab/haolin/nhk/excerpts/2011_01_24_19_00_2.webm;Shizuka KAMEI.jpg;805;829;6873;26;27;1
/net/per920a/export/das14a/satoh-lab/haolin/nhk/excerpts/2011_01_24_19_00_2.webm;Shizuka KAMEI.jpg;849;869;6873;28;28;0
/net/per920a/export/das14a/satoh-lab/haolin/nhk/excerpts/2011_01_24_19_00_2.webm;Shizuka KAMEI.jpg;889;889;6873;29;29;0
/net/per920a/export/das14a/satoh-lab/haolin/nhk/excerpts/2011_01_24_19_00_2.webm;Shizuka KAMEI.jpg;901;905;6873;30;30;0
/net/per920a/export/das14a/satoh-lab/haolin/nhk/excerpts/2011_01_24_19_00_2.webm;Shizuka KAMEI.jpg;921;933;6873;30;31;1
/net/per920a/export/das14a/satoh-lab/haolin/nhk/excerpts/2011_01_24_19_00_2.webm;Shizuka KAMEI.jpg;949;1033;6873;31;34;3
/net/per920a/export/das14a/satoh-lab/haolin/nhk/excerpts/2011_01_24_19_00_2.webm;Shizuka KAMEI.jpg;1045;1077;6873;34;35;1
/net/per920a/export/das14a/satoh-lab/haolin/nhk/excerpts/2011_01_24_19_00_2.webm;Shizuka KAMEI.jpg;1093;1093;6873;36;36;0
/net/per920a/export/das14a/satoh-lab/haolin/nhk/excerpts/2011_01_24_19_00_2.webm;Shizuka KAMEI.jpg;1129;1129;6873;37;37;0
/net/per920a/export/das14a/satoh-lab/haolin/nhk/excerpts/2011_01_24_19_00_2.webm;Shizuka KAMEI.jpg;1141;1237;6873;38;41;3
/net/per920a/export/das14a/satoh-lab/haolin/nhk/excerpts/2011_01_24_19_00_2.webm;Sadakazu TANIGAKI.jpg;1277;2609;6873;42;86;44
/net/per920a/export/das14a/satoh-lab/haolin/nhk/excerpts/2011_01_24_19_00_2.webm;Yoshimi WATANABE.jpg;2621;2685;6873;87;89;2
/net/per920a/export/das14a/satoh-lab/haolin/nhk/excerpts/2011_01_24_19_00_2.webm;Yoshimi WATANABE.jpg;2709;2713;6873;90;90;0
/net/per920a/export/das14a/satoh-lab/haolin/nhk/excerpts/2011_01_24_19_00_2.webm;Yoshimi WATANABE.jpg;2745;2745;6873;91;91;0
/net/per920a/export/das14a/satoh-lab/haolin/nhk/excerpts/2011_01_24_19_00_2.webm;Yoshimi WATANABE.jpg;2769;2773;6873;92;92;0
/net/per920a/export/das14a/satoh-lab/haolin/nhk/excerpts/2011_01_24_19_00_2.webm;Yoshimi WATANABE.jpg;2797;2805;6873;93;93;0
/net/per920a/export/das14a/satoh-lab/haolin/nhk/excerpts/2011_01_24_19_00_2.webm;Yoshimi WATANABE.jpg;2821;2845;6873;93;94;1
/net/per920a/export/das14a/satoh-lab/haolin/nhk/excerpts/2011_01_24_19_00_2.webm;Yoshimi WATANABE.jpg;2861;2861;6873;95;95;0
/net/per920a/export/das14a/satoh-lab/haolin/nhk/excerpts/2011_01_24_19_00_2.webm;Yoshimi WATANABE.jpg;2873;2873;6873;95;95;0
/net/per920a/export/das14a/satoh-lab/haolin/nhk/excerpts/2011_01_24_19_00_2.webm;Yoshimi WATANABE.jpg;2897;2933;6873;96;97;1
/net/per920a/export/das14a/satoh-lab/haolin/nhk/excerpts/2011_01_24_19_00_2.webm;Yoshimi WATANABE.jpg;2949;2953;6873;98;98;0
/net/per920a/export/das14a/satoh-lab/haolin/nhk/excerpts/2011_01_24_19_00_2.webm;Yoshimi WATANABE.jpg;2965;2965;6873;98;98;0
/net/per920a/export/das14a/satoh-lab/haolin/nhk/excerpts/2011_01_24_19_00_2.webm;Yoshimi WATANABE.jpg;2977;2977;6873;99;99;0
/net/per920a/export/das14a/satoh-lab/haolin/nhk/excerpts/2011_01_24_19_00_2.webm;Yoshimi WATANABE.jpg;2993;2997;6873;99;99;0
/net/per920a/export/das14a/satoh-lab/haolin/nhk/excerpts/2011_01_24_19_00_2.webm;Yoshimi WATANABE.jpg;3021;3025;6873;100;100;0
/net/per920a/export/das14a/satoh-lab/haolin/nhk/excerpts/2011_01_24_19_00_2.webm;Yoshimi WATANABE.jpg;3045;3053;6873;101;101;0
/net/per920a/export/das14a/satoh-lab/haolin/nhk/excerpts/2011_01_24_19_00_2.webm;Yoshimi WATANABE.jpg;3069;3077;6873;102;102;0
/net/per920a/export/das14a/satoh-lab/haolin/nhk/excerpts/2011_01_24_19_00_2.webm;Yoshimi WATANABE.jpg;3133;3153;6873;104;105;1
/net/per920a/export/das14a/satoh-lab/haolin/nhk/excerpts/2011_01_24_19_00_2.webm;Kazuo SHII.jpg;3417;3657;6873;113;121;8
/net/per920a/export/das14a/satoh-lab/haolin/nhk/excerpts/2011_01_24_19_00_2.webm;Toru Hashimoto.jpg;4637;5261;6873;154;175;21
/net/per920a/export/das14a/satoh-lab/haolin/nhk/excerpts/2011_01_24_19_00_2.webm;Ichiro OZAWA.jpg;5613;5617;6873;187;187;0
/net/per920a/export/das14a/satoh-lab/haolin/nhk/excerpts/2011_01_24_19_00_2.webm;Ichiro OZAWA.jpg;5629;5629;6873;187;187;0
/net/per920a/export/das14a/satoh-lab/haolin/nhk/excerpts/2011_01_24_19_00_2.webm;Ichiro OZAWA.jpg;5653;5661;6873;188;188;0
/net/per920a/export/das14a/satoh-lab/haolin/nhk/excerpts/2011_01_24_19_00_2.webm;Ichiro OZAWA.jpg;5673;5673;6873;189;189;0
/net/per920a/export/das14a/satoh-lab/haolin/nhk/excerpts/2011_01_24_19_00_2.webm;Ichiro OZAWA.jpg;5685;5713;6873;189;190;1
/net/per920a/export/das14a/satoh-lab/haolin/nhk/excerpts/2011_01_24_19_00_2.webm;Ichiro OZAWA.jpg;5733;5733;6873;191;191;0
/net/per920a/export/das14a/satoh-lab/haolin/nhk/excerpts/2011_01_24_19_00_2.webm;Ichiro OZAWA.jpg;5785;5821;6873;192;193;1
/net/per920a/export/das14a/satoh-lab/haolin/nhk/excerpts/2011_01_24_19_00_2.webm;Ichiro OZAWA.jpg;5841;5941;6873;194;197;3
/net/per920a/export/das14a/satoh-lab/haolin/nhk/excerpts/2011_01_24_19_00_2.webm;Ichiro OZAWA.jpg;5973;5973;6873;199;199;0
/net/per920a/export/das14a/satoh-lab/haolin/nhk/excerpts/2011_01_24_19_00_2.webm;Ichiro OZAWA.jpg;6073;6193;6873;202;206;4
/net/per920a/export/das14a/satoh-lab/haolin/nhk/excerpts/2011_02_14_19_00_1.webm;Naoto KAN.jpg;141;193;7685;4;6;2
/net/per920a/export/das14a/satoh-lab/haolin/nhk/excerpts/2011_02_14_19_00_1.webm;Naoto KAN.jpg;4733;4853;7685;157;161;4
/net/per920a/export/das14a/satoh-lab/haolin/nhk/excerpts/2011_02_14_19_00_1.webm;Naoto KAN.jpg;4969;4981;7685;165;165;0
/net/per920a/export/das14a/satoh-lab/haolin/nhk/excerpts/2011_02_14_19_00_1.webm;Naoto KAN.jpg;4997;5041;7685;166;167;1
/net/per920a/export/das14a/satoh-lab/haolin/nhk/excerpts/2011_02_14_19_00_1.webm;Naoto KAN.jpg;5149;5349;7685;171;178;7
/net/per920a/export/das14a/satoh-lab/haolin/nhk/excerpts/2011_02_14_19_00_1.webm;Naoto KAN.jpg;5365;5365;7685;178;178;0
/net/per920a/export/das14a/satoh-lab/haolin/nhk/excerpts/2011_02_14_19_00_1.webm;Naoto KAN.jpg;6069;6213;7685;202;206;4
/net/per920a/export/das14a/satoh-lab/haolin/nhk/excerpts/2011_02_14_19_00_1.webm;Naoto KAN.jpg;6585;6673;7685;219;222;3
/net/per920a/export/das14a/satoh-lab/haolin/nhk/excerpts/2011_02_14_19_00_1.webm;Naoto KAN.jpg;6689;6737;7685;222;224;2
/net/per920a/export/das14a/satoh-lab/haolin/nhk/excerpts/2011_02_14_19_00_1.webm;Ichiro OZAWA.jpg;2373;2973;7685;79;99;20
/net/per920a/export/das14a/satoh-lab/haolin/nhk/excerpts/2011_02_14_19_00_1.webm;Katsuya OKADA.jpg;4865;4957;7685;162;165;3
/net/per920a/export/das14a/satoh-lab/haolin/nhk/excerpts/2011_02_14_19_00_1.webm;Katsuya OKADA.jpg;4969;4981;7685;165;165;0
/net/per920a/export/das14a/satoh-lab/haolin/nhk/excerpts/2011_02_14_19_00_1.webm;Katsuya OKADA.jpg;4997;5041;7685;166;167;1
/net/per920a/export/das14a/satoh-lab/haolin/nhk/excerpts/2011_02_14_19_00_1.webm;Katsuya OKADA.jpg;6473;6477;7685;215;215;0
/net/per920a/export/das14a/satoh-lab/haolin/nhk/excerpts/2011_02_14_19_00_1.webm;Katsuya OKADA.jpg;6493;6573;7685;216;218;2
/net/per920a/export/das14a/satoh-lab/haolin/nhk/excerpts/2011_02_14_19_00_1.webm;Katsuya OKADA.jpg;6821;7225;7685;227;240;13
/net/per920a/export/das14a/satoh-lab/haolin/nhk/excerpts/2011_02_20_19_00_1.webm;Taro ASO.jpg;2045;2933;3781;68;97;29
/net/per920a/export/das14a/satoh-lab/haolin/nhk/excerpts/2011_02_20_19_00_1.webm;Taro ASO.jpg;3209;3209;3781;106;106;0
/net/per920a/export/das14a/satoh-lab/haolin/nhk/excerpts/2011_02_20_19_00_1.webm;Taro ASO.jpg;3221;3221;3781;107;107;0
/net/per920a/export/das14a/satoh-lab/haolin/nhk/excerpts/2011_02_20_19_00_1.webm;Taro ASO.jpg;3245;3249;3781;108;108;0
/net/per920a/export/das14a/satoh-lab/haolin/nhk/excerpts/2011_02_20_19_00_1.webm;Taro ASO.jpg;3265;3633;3781;108;121;13
/net/per920a/export/das14a/satoh-lab/haolin/nhk/excerpts/2011_02_20_19_00_1.webm;Taro ASO.jpg;3649;3705;3781;121;123;2
/net/per920a/export/das14a/satoh-lab/haolin/nhk/excerpts/2011_02_20_19_00_1.webm;Naoto KAN.jpg;2045;2933;3781;68;97;29
/net/per920a/export/das14a/satoh-lab/haolin/nhk/excerpts/2011_02_20_19_00_1.webm;Naoto KAN.jpg;3045;3193;3781;101;106;5
/net/per920a/export/das14a/satoh-lab/haolin/nhk/excerpts/2011_03_18_19_00_1.webm;Yukio EDANO.jpg;3733;4105;42445;124;136;12
/net/per920a/export/das14a/satoh-lab/haolin/nhk/excerpts/2011_03_18_19_00_1.webm;Yukio HATOYAMA.jpg;6601;7253;42445;220;241;21
/net/per920a/export/das14a/satoh-lab/haolin/nhk/excerpts/2011_03_20_19_00_1.webm;Yukio EDANO.jpg;16669;17389;32493;556;580;24
/net/per920a/export/das14a/satoh-lab/haolin/nhk/excerpts/2011_04_18_19_00_3.webm;Yukio EDANO.jpg;9;21;549;0;0;0
/net/per920a/export/das14a/satoh-lab/haolin/nhk/excerpts/2011_04_18_19_00_3.webm;Yukio EDANO.jpg;37;121;549;1;3;2
/net/per920a/export/das14a/satoh-lab/haolin/nhk/excerpts/2011_05_01_19_00_1.webm;Yukio EDANO.jpg;5653;6145;6629;188;204;16
/net/per920a/export/das14a/satoh-lab/haolin/nhk/excerpts/2011_05_01_19_00_1.webm;Yukio EDANO.jpg;6161;6225;6629;205;207;2
/net/per920a/export/das14a/satoh-lab/haolin/nhk/excerpts/2011_05_01_19_00_1.webm;Yukio EDANO.jpg;6241;6253;6629;208;208;0
/net/per920a/export/das14a/satoh-lab/haolin/nhk/excerpts/2011_05_01_19_00_1.webm;Yukio EDANO.jpg;6269;6557;6629;208;218;10
/net/per920a/export/das14a/satoh-lab/haolin/nhk/excerpts/2011_05_02_19_00_1.webm;Yukio EDANO.jpg;20317;20889;24337;677;696;19
/net/per920a/export/das14a/satoh-lab/haolin/nhk/excerpts/2011_05_04_19_00_2.webm;Naoto KAN.jpg;905;909;9273;30;30;0
/net/per920a/export/das14a/satoh-lab/haolin/nhk/excerpts/2011_05_04_19_00_2.webm;Naoto KAN.jpg;929;961;9273;30;32;2
/net/per920a/export/das14a/satoh-lab/haolin/nhk/excerpts/2011_05_04_19_00_2.webm;Naoto KAN.jpg;1393;1397;9273;46;46;0
/net/per920a/export/das14a/satoh-lab/haolin/nhk/excerpts/2011_05_04_19_00_2.webm;Naoto KAN.jpg;1409;1409;9273;46;46;0
/net/per920a/export/das14a/satoh-lab/haolin/nhk/excerpts/2011_05_04_19_00_2.webm;Naoto KAN.jpg;1765;1825;9273;58;60;2
/net/per920a/export/das14a/satoh-lab/haolin/nhk/excerpts/2011_05_04_19_00_2.webm;Naoto KAN.jpg;1841;1841;9273;61;61;0
/net/per920a/export/das14a/satoh-lab/haolin/nhk/excerpts/2011_05_04_19_00_2.webm;Naoto KAN.jpg;1861;1925;9273;62;64;2
/net/per920a/export/das14a/satoh-lab/haolin/nhk/excerpts/2011_05_04_19_00_2.webm;Naoto KAN.jpg;1973;2085;9273;65;69;4
/net/per920a/export/das14a/satoh-lab/haolin/nhk/excerpts/2011_05_04_19_00_2.webm;Naoto KAN.jpg;2101;2297;9273;70;76;6
/net/per920a/export/das14a/satoh-lab/haolin/nhk/excerpts/2011_05_04_19_00_2.webm;Yasuo FUKUDA.jpg;8505;8529;9273;283;284;1
/net/per920a/export/das14a/satoh-lab/haolin/nhk/excerpts/2011_05_04_19_00_2.webm;Yasuo FUKUDA.jpg;8557;8565;9273;285;285;0
/net/per920a/export/das14a/satoh-lab/haolin/nhk/excerpts/2011_05_04_19_00_2.webm;Yasuo FUKUDA.jpg;8653;8665;9273;288;288;0
/net/per920a/export/das14a/satoh-lab/haolin/nhk/excerpts/2011_05_04_19_00_2.webm;Yasuo FUKUDA.jpg;8681;8689;9273;289;289;0
/net/per920a/export/das14a/satoh-lab/haolin/nhk/excerpts/2011_05_04_19_00_2.webm;Yasuo FUKUDA.jpg;8705;8741;9273;290;291;1
/net/per920a/export/das14a/satoh-lab/haolin/nhk/excerpts/2011_05_04_19_00_2.webm;Yasuo FUKUDA.jpg;8757;8813;9273;291;293;2
/net/per920a/export/das14a/satoh-lab/haolin/nhk/excerpts/2011_05_04_19_00_2.webm;Yasuo FUKUDA.jpg;8829;8857;9273;294;295;1
/net/per920a/export/das14a/satoh-lab/haolin/nhk/excerpts/2011_05_04_19_00_2.webm;Yasuo FUKUDA.jpg;8873;8881;9273;295;295;0
/net/per920a/export/das14a/satoh-lab/haolin/nhk/excerpts/2011_05_04_19_00_2.webm;Yasuo FUKUDA.jpg;8905;8977;9273;296;299;3
/net/per920a/export/das14a/satoh-lab/haolin/nhk/excerpts/2011_05_04_19_00_2.webm;Yasuo FUKUDA.jpg;9009;9045;9273;300;301;1
/net/per920a/export/das14a/satoh-lab/haolin/nhk/excerpts/2011_05_04_19_00_2.webm;Yasuo FUKUDA.jpg;9065;9065;9273;302;302;0
/net/per920a/export/das14a/satoh-lab/haolin/nhk/excerpts/2011_05_04_19_00_2.webm;Yasuo FUKUDA.jpg;9085;9085;9273;302;302;0
/net/per920a/export/das14a/satoh-lab/haolin/nhk/excerpts/2011_05_04_19_00_2.webm;Yasuo FUKUDA.jpg;9105;9105;9273;303;303;0
/net/per920a/export/das14a/satoh-lab/haolin/nhk/excerpts/2011_05_04_19_00_2.webm;Yasuo FUKUDA.jpg;9117;9125;9273;303;304;1
/net/per920a/export/das14a/satoh-lab/haolin/nhk/excerpts/2011_05_31_19_00_2.webm;Sadakazu TANIGAKI.jpg;33;33;11657;1;1;0
/net/per920a/export/das14a/satoh-lab/haolin/nhk/excerpts/2011_05_31_19_00_2.webm;Sadakazu TANIGAKI.jpg;61;81;11657;2;2;0
/net/per920a/export/das14a/satoh-lab/haolin/nhk/excerpts/2011_05_31_19_00_2.webm;Sadakazu TANIGAKI.jpg;97;133;11657;3;4;1
/net/per920a/export/das14a/satoh-lab/haolin/nhk/excerpts/2011_05_31_19_00_2.webm;Sadakazu TANIGAKI.jpg;149;153;11657;4;5;1
/net/per920a/export/das14a/satoh-lab/haolin/nhk/excerpts/2011_05_31_19_00_2.webm;Sadakazu TANIGAKI.jpg;169;169;11657;5;5;0
/net/per920a/export/das14a/satoh-lab/haolin/nhk/excerpts/2011_05_31_19_00_2.webm;Sadakazu TANIGAKI.jpg;201;205;11657;6;6;0
/net/per920a/export/das14a/satoh-lab/haolin/nhk/excerpts/2011_05_31_19_00_2.webm;Sadakazu TANIGAKI.jpg;221;221;11657;7;7;0
/net/per920a/export/das14a/satoh-lab/haolin/nhk/excerpts/2011_05_31_19_00_2.webm;Sadakazu TANIGAKI.jpg;237;277;11657;7;9;2
/net/per920a/export/das14a/satoh-lab/haolin/nhk/excerpts/2011_05_31_19_00_2.webm;Sadakazu TANIGAKI.jpg;293;365;11657;9;12;3
/net/per920a/export/das14a/satoh-lab/haolin/nhk/excerpts/2011_05_31_19_00_2.webm;Sadakazu TANIGAKI.jpg;381;389;11657;12;12;0
/net/per920a/export/das14a/satoh-lab/haolin/nhk/excerpts/2011_05_31_19_00_2.webm;Sadakazu TANIGAKI.jpg;421;421;11657;14;14;0
/net/per920a/export/das14a/satoh-lab/haolin/nhk/excerpts/2011_05_31_19_00_2.webm;Sadakazu TANIGAKI.jpg;477;485;11657;15;16;1
/net/per920a/export/das14a/satoh-lab/haolin/nhk/excerpts/2011_05_31_19_00_2.webm;Sadakazu TANIGAKI.jpg;525;537;11657;17;17;0
/net/per920a/export/das14a/satoh-lab/haolin/nhk/excerpts/2011_05_31_19_00_2.webm;Sadakazu TANIGAKI.jpg;569;629;11657;18;20;2
/net/per920a/export/das14a/satoh-lab/haolin/nhk/excerpts/2011_05_31_19_00_2.webm;Sadakazu TANIGAKI.jpg;649;649;11657;21;21;0
/net/per920a/export/das14a/satoh-lab/haolin/nhk/excerpts/2011_05_31_19_00_2.webm;Sadakazu TANIGAKI.jpg;665;673;11657;22;22;0
/net/per920a/export/das14a/satoh-lab/haolin/nhk/excerpts/2011_05_31_19_00_2.webm;Sadakazu TANIGAKI.jpg;685;693;11657;22;23;1
/net/per920a/export/das14a/satoh-lab/haolin/nhk/excerpts/2011_05_31_19_00_2.webm;Sadakazu TANIGAKI.jpg;705;765;11657;23;25;2
/net/per920a/export/das14a/satoh-lab/haolin/nhk/excerpts/2011_05_31_19_00_2.webm;Sadakazu TANIGAKI.jpg;781;845;11657;26;28;2
/net/per920a/export/das14a/satoh-lab/haolin/nhk/excerpts/2011_05_31_19_00_2.webm;Sadakazu TANIGAKI.jpg;869;869;11657;28;28;0
/net/per920a/export/das14a/satoh-lab/haolin/nhk/excerpts/2011_05_31_19_00_2.webm;Sadakazu TANIGAKI.jpg;881;889;11657;29;29;0
/net/per920a/export/das14a/satoh-lab/haolin/nhk/excerpts/2011_05_31_19_00_2.webm;Sadakazu TANIGAKI.jpg;905;949;11657;30;31;1
/net/per920a/export/das14a/satoh-lab/haolin/nhk/excerpts/2011_05_31_19_00_2.webm;Sadakazu TANIGAKI.jpg;965;1009;11657;32;33;1
/net/per920a/export/das14a/satoh-lab/haolin/nhk/excerpts/2011_05_31_19_00_2.webm;Sadakazu TANIGAKI.jpg;1929;1969;11657;64;65;1
/net/per920a/export/das14a/satoh-lab/haolin/nhk/excerpts/2011_05_31_19_00_2.webm;Sadakazu TANIGAKI.jpg;1981;2065;11657;66;68;2
/net/per920a/export/das14a/satoh-lab/haolin/nhk/excerpts/2011_05_31_19_00_2.webm;Sadakazu TANIGAKI.jpg;2089;2189;11657;69;73;4
/net/per920a/export/das14a/satoh-lab/haolin/nhk/excerpts/2011_05_31_19_00_2.webm;Sadakazu TANIGAKI.jpg;2201;2285;11657;73;76;3
/net/per920a/export/das14a/satoh-lab/haolin/nhk/excerpts/2011_05_31_19_00_2.webm;Sadakazu TANIGAKI.jpg;2297;2337;11657;76;77;1
/net/per920a/export/das14a/satoh-lab/haolin/nhk/excerpts/2011_05_31_19_00_2.webm;Sadakazu TANIGAKI.jpg;2529;2537;11657;84;84;0
/net/per920a/export/das14a/satoh-lab/haolin/nhk/excerpts/2011_05_31_19_00_2.webm;Sadakazu TANIGAKI.jpg;2569;2617;11657;85;87;2
/net/per920a/export/das14a/satoh-lab/haolin/nhk/excerpts/2011_05_31_19_00_2.webm;Sadakazu TANIGAKI.jpg;2629;2629;11657;87;87;0
/net/per920a/export/das14a/satoh-lab/haolin/nhk/excerpts/2011_05_31_19_00_2.webm;Sadakazu TANIGAKI.jpg;2977;3761;11657;99;125;26
/net/per920a/export/das14a/satoh-lab/haolin/nhk/excerpts/2011_05_31_19_00_2.webm;Natsuo YAMAGUCHI.jpg;1021;1821;11657;34;60;26
/net/per920a/export/das14a/satoh-lab/haolin/nhk/excerpts/2011_05_31_19_00_2.webm;Natsuo YAMAGUCHI.jpg;2749;2961;11657;91;98;7
/net/per920a/export/das14a/satoh-lab/haolin/nhk/excerpts/2011_05_31_19_00_2.webm;Natsuo YAMAGUCHI.jpg;2977;3761;11657;99;125;26
/net/per920a/export/das14a/satoh-lab/haolin/nhk/excerpts/2011_05_31_19_00_2.webm;Naoto KAN.jpg;5949;5981;11657;198;199;1
/net/per920a/export/das14a/satoh-lab/haolin/nhk/excerpts/2011_05_31_19_00_2.webm;Naoto KAN.jpg;5993;5993;11657;199;199;0
/net/per920a/export/das14a/satoh-lab/haolin/nhk/excerpts/2011_05_31_19_00_2.webm;Naoto KAN.jpg;6005;6005;11657;200;200;0
/net/per920a/export/das14a/satoh-lab/haolin/nhk/excerpts/2011_05_31_19_00_2.webm;Naoto KAN.jpg;6021;6045;11657;200;201;1
/net/per920a/export/das14a/satoh-lab/haolin/nhk/excerpts/2011_05_31_19_00_2.webm;Naoto KAN.jpg;6061;6085;11657;202;203;1
/net/per920a/export/das14a/satoh-lab/haolin/nhk/excerpts/2011_05_31_19_00_2.webm;Naoto KAN.jpg;6101;6141;11657;203;204;1
/net/per920a/export/das14a/satoh-lab/haolin/nhk/excerpts/2011_05_31_19_00_2.webm;Naoto KAN.jpg;6177;6197;11657;206;206;0
/net/per920a/export/das14a/satoh-lab/haolin/nhk/excerpts/2011_05_31_19_00_2.webm;Naoto KAN.jpg;6233;6265;11657;207;209;2
/net/per920a/export/das14a/satoh-lab/haolin/nhk/excerpts/2011_05_31_19_00_2.webm;Naoto KAN.jpg;6281;6381;11657;209;212;3
/net/per920a/export/das14a/satoh-lab/haolin/nhk/excerpts/2011_05_31_19_00_2.webm;Naoto KAN.jpg;6397;6701;11657;213;223;10
/net/per920a/export/das14a/satoh-lab/haolin/nhk/excerpts/2011_05_31_19_00_2.webm;Yukio HATOYAMA.jpg;10929;10969;11657;364;366;2
/net/per920a/export/das14a/satoh-lab/haolin/nhk/excerpts/2011_05_31_19_00_2.webm;Yukio HATOYAMA.jpg;10993;11517;11657;366;384;18
/net/per920a/export/das14a/satoh-lab/haolin/nhk/excerpts/2011_05_31_19_00_2.webm;Yukio HATOYAMA.jpg;11533;11557;11657;384;385;1
/net/per920a/export/das14a/satoh-lab/haolin/nhk/excerpts/2011_05_31_19_00_2.webm;Yukio HATOYAMA.jpg;11573;11597;11657;386;386;0
/net/per920a/export/das14a/satoh-lab/haolin/nhk/excerpts/2011_06_01_19_00_2.webm;Shizuka KAMEI.jpg;9;365;369;0;11;11
/net/per920a/export/das14a/satoh-lab/haolin/nhk/excerpts/2011_07_06_19_00_3.webm;Naoto KAN.jpg;10817;11021;13225;360;367;7
/net/per920a/export/das14a/satoh-lab/haolin/nhk/excerpts/2011_07_06_19_00_3.webm;Naoto KAN.jpg;11241;11241;13225;374;374;0
/net/per920a/export/das14a/satoh-lab/haolin/nhk/excerpts/2011_07_06_19_00_3.webm;Naoto KAN.jpg;11269;11293;13225;375;376;1
/net/per920a/export/das14a/satoh-lab/haolin/nhk/excerpts/2011_07_06_19_00_3.webm;Naoto KAN.jpg;11317;11317;13225;377;377;0
/net/per920a/export/das14a/satoh-lab/haolin/nhk/excerpts/2011_07_06_19_00_3.webm;Naoto KAN.jpg;11565;11917;13225;385;397;12
/net/per920a/export/das14a/satoh-lab/haolin/nhk/excerpts/2011_07_06_19_00_3.webm;Naoto KAN.jpg;11929;11929;13225;397;397;0
/net/per920a/export/das14a/satoh-lab/haolin/nhk/excerpts/2011_07_06_19_00_3.webm;Naoto KAN.jpg;11953;11961;13225;398;398;0
/net/per920a/export/das14a/satoh-lab/haolin/nhk/excerpts/2011_07_06_19_00_3.webm;Naoto KAN.jpg;12001;12041;13225;400;401;1
/net/per920a/export/das14a/satoh-lab/haolin/nhk/excerpts/2011_07_06_19_00_3.webm;Naoto KAN.jpg;12065;12077;13225;402;402;0
/net/per920a/export/das14a/satoh-lab/haolin/nhk/excerpts/2011_07_06_19_00_3.webm;Naoto KAN.jpg;12097;12097;13225;403;403;0
/net/per920a/export/das14a/satoh-lab/haolin/nhk/excerpts/2011_07_06_19_00_3.webm;Naoto KAN.jpg;12121;12121;13225;404;404;0
/net/per920a/export/das14a/satoh-lab/haolin/nhk/excerpts/2011_07_06_19_00_3.webm;Naoto KAN.jpg;12133;12153;13225;404;405;1
/net/per920a/export/das14a/satoh-lab/haolin/nhk/excerpts/2011_07_06_19_00_3.webm;Naoto KAN.jpg;12881;12889;13225;429;429;0
/net/per920a/export/das14a/satoh-lab/haolin/nhk/excerpts/2011_07_06_19_00_3.webm;Naoto KAN.jpg;12917;12917;13225;430;430;0
/net/per920a/export/das14a/satoh-lab/haolin/nhk/excerpts/2011_07_06_19_00_3.webm;Naoto KAN.jpg;12929;12933;13225;431;431;0
/net/per920a/export/das14a/satoh-lab/haolin/nhk/excerpts/2011_07_06_19_00_3.webm;Naoto KAN.jpg;12945;12973;13225;431;432;1
/net/per920a/export/das14a/satoh-lab/haolin/nhk/excerpts/2011_08_08_19_00_1.webm;Yoshihiko Noda.jpg;209;209;1377;6;6;0
/net/per920a/export/das14a/satoh-lab/haolin/nhk/excerpts/2011_08_08_19_00_1.webm;Yoshihiko Noda.jpg;225;225;1377;7;7;0
/net/per920a/export/das14a/satoh-lab/haolin/nhk/excerpts/2011_08_08_19_00_1.webm;Yoshihiko Noda.jpg;281;281;1377;9;9;0
/net/per920a/export/das14a/satoh-lab/haolin/nhk/excerpts/2011_08_08_19_00_1.webm;Yoshihiko Noda.jpg;297;301;1377;9;10;1
/net/per920a/export/das14a/satoh-lab/haolin/nhk/excerpts/2011_08_08_19_00_1.webm;Yoshihiko Noda.jpg;1169;1229;1377;39;41;2
/net/per920a/export/das14a/satoh-lab/haolin/nhk/excerpts/2011_08_08_19_00_1.webm;Yoshihiko Noda.jpg;1241;1245;1377;41;41;0
/net/per920a/export/das14a/satoh-lab/haolin/nhk/excerpts/2011_08_08_19_00_1.webm;Yoshihiko Noda.jpg;1265;1265;1377;42;42;0
/net/per920a/export/das14a/satoh-lab/haolin/nhk/excerpts/2011_08_08_19_00_1.webm;Yoshihiko Noda.jpg;1277;1281;1377;42;42;0
/net/per920a/export/das14a/satoh-lab/haolin/nhk/excerpts/2011_08_08_19_00_1.webm;Yoshihiko Noda.jpg;1301;1345;1377;43;44;1
/net/per920a/export/das14a/satoh-lab/haolin/nhk/excerpts/2011_08_08_19_00_1.webm;Yoshihiko Noda.jpg;1361;1373;1377;45;45;0
/net/per920a/export/das14a/satoh-lab/haolin/nhk/excerpts/2011_08_24_19_00_2.webm;Yoshihiko Noda.jpg;5457;5477;6513;181;182;1
/net/per920a/export/das14a/satoh-lab/haolin/nhk/excerpts/2011_08_24_19_00_2.webm;Yoshihiko Noda.jpg;5489;5545;6513;182;184;2
/net/per920a/export/das14a/satoh-lab/haolin/nhk/excerpts/2011_08_24_19_00_2.webm;Yoshihiko Noda.jpg;5597;5617;6513;186;187;1
/net/per920a/export/das14a/satoh-lab/haolin/nhk/excerpts/2011_08_24_19_00_2.webm;Yoshihiko Noda.jpg;5725;5725;6513;190;190;0
/net/per920a/export/das14a/satoh-lab/haolin/nhk/excerpts/2011_08_24_19_00_2.webm;Yoshihiko Noda.jpg;5737;5841;6513;191;194;3
/net/per920a/export/das14a/satoh-lab/haolin/nhk/excerpts/2011_08_30_19_00_1.webm;Seiji MAEHARA.jpg;9;785;6393;0;26;26
/net/per920a/export/das14a/satoh-lab/haolin/nhk/excerpts/2011_08_30_19_00_1.webm;Seiji MAEHARA.jpg;3297;3297;6393;109;109;0
/net/per920a/export/das14a/satoh-lab/haolin/nhk/excerpts/2011_08_30_19_00_1.webm;Seiji MAEHARA.jpg;3325;3409;6393;110;113;3
/net/per920a/export/das14a/satoh-lab/haolin/nhk/excerpts/2011_08_30_19_00_1.webm;Seiji MAEHARA.jpg;3469;3609;6393;115;120;5
/net/per920a/export/das14a/satoh-lab/haolin/nhk/excerpts/2011_08_30_19_00_1.webm;Seiji MAEHARA.jpg;3625;4933;6393;120;164;44
/net/per920a/export/das14a/satoh-lab/haolin/nhk/excerpts/2011_08_30_19_00_1.webm;Ichiro OZAWA.jpg;6301;6389;6393;209;212;3
/net/per920a/export/das14a/satoh-lab/haolin/nhk/excerpts/2011_08_31_19_00_1.webm;Yoshihiko Noda.jpg;833;845;2337;27;28;1
/net/per920a/export/das14a/satoh-lab/haolin/nhk/excerpts/2011_08_31_19_00_1.webm;Yoshihiko Noda.jpg;857;909;2337;28;30;2
/net/per920a/export/das14a/satoh-lab/haolin/nhk/excerpts/2011_08_31_19_00_1.webm;Yoshihiko Noda.jpg;965;965;2337;32;32;0
/net/per920a/export/das14a/satoh-lab/haolin/nhk/excerpts/2011_08_31_19_00_1.webm;Yoshihiko Noda.jpg;989;989;2337;33;33;0
/net/per920a/export/das14a/satoh-lab/haolin/nhk/excerpts/2011_08_31_19_00_1.webm;Yoshihiko Noda.jpg;1129;1129;2337;37;37;0
/net/per920a/export/das14a/satoh-lab/haolin/nhk/excerpts/2011_08_31_19_00_1.webm;Yoshihiko Noda.jpg;1161;1297;2337;38;43;5
/net/per920a/export/das14a/satoh-lab/haolin/nhk/excerpts/2011_08_31_19_00_1.webm;Yoshihiko Noda.jpg;1309;1313;2337;43;43;0
/net/per920a/export/das14a/satoh-lab/haolin/nhk/excerpts/2011_08_31_19_00_1.webm;Yoshihiko Noda.jpg;1369;1377;2337;45;45;0
/net/per920a/export/das14a/satoh-lab/haolin/nhk/excerpts/2011_08_31_19_00_1.webm;Yoshihiko Noda.jpg;1389;1389;2337;46;46;0
/net/per920a/export/das14a/satoh-lab/haolin/nhk/excerpts/2011_08_31_19_00_1.webm;Yoshihiko Noda.jpg;1409;1437;2337;47;47;0
/net/per920a/export/das14a/satoh-lab/haolin/nhk/excerpts/2011_08_31_19_00_1.webm;Yoshihiko Noda.jpg;1461;1465;2337;48;48;0
/net/per920a/export/das14a/satoh-lab/haolin/nhk/excerpts/2011_08_31_19_00_1.webm;Yoshihiko Noda.jpg;1485;1485;2337;49;49;0
/net/per920a/export/das14a/satoh-lab/haolin/nhk/excerpts/2011_08_31_19_00_1.webm;Yoshihiko Noda.jpg;1497;1497;2337;49;49;0
/net/per920a/export/das14a/satoh-lab/haolin/nhk/excerpts/2011_08_31_19_00_1.webm;Yoshihiko Noda.jpg;1997;2333;2337;66;77;11
/net/per920a/export/das14a/satoh-lab/haolin/nhk/excerpts/2011_08_31_19_00_3.webm;Yoshihiko Noda.jpg;169;169;1537;5;5;0
/net/per920a/export/das14a/satoh-lab/haolin/nhk/excerpts/2011_08_31_19_00_3.webm;Yoshihiko Noda.jpg;213;241;1537;7;7;0
/net/per920a/export/das14a/satoh-lab/haolin/nhk/excerpts/2011_08_31_19_00_3.webm;Yoshihiko Noda.jpg;261;261;1537;8;8;0
/net/per920a/export/das14a/satoh-lab/haolin/nhk/excerpts/2011_08_31_19_00_3.webm;Yoshihiko Noda.jpg;277;277;1537;9;9;0
/net/per920a/export/das14a/satoh-lab/haolin/nhk/excerpts/2011_08_31_19_00_3.webm;Yoshihiko Noda.jpg;289;297;1537;9;9;0
/net/per920a/export/das14a/satoh-lab/haolin/nhk/excerpts/2011_08_31_19_00_3.webm;Yoshihiko Noda.jpg;1097;1101;1537;36;36;0
/net/per920a/export/das14a/satoh-lab/haolin/nhk/excerpts/2011_08_31_19_00_3.webm;Yoshihiko Noda.jpg;1129;1129;1537;37;37;0
/net/per920a/export/das14a/satoh-lab/haolin/nhk/excerpts/2011_08_31_19_00_3.webm;Yoshihiko Noda.jpg;1317;1321;1537;43;43;0
/net/per920a/export/das14a/satoh-lab/haolin/nhk/excerpts/2011_09_30_19_00_1.webm;Yoshihiko Noda.jpg;1061;1061;10741;35;35;0
/net/per920a/export/das14a/satoh-lab/haolin/nhk/excerpts/2011_09_30_19_00_1.webm;Yoshihiko Noda.jpg;1081;1085;10741;36;36;0
/net/per920a/export/das14a/satoh-lab/haolin/nhk/excerpts/2011_09_30_19_00_1.webm;Yoshihiko Noda.jpg;1097;1101;10741;36;36;0
/net/per920a/export/das14a/satoh-lab/haolin/nhk/excerpts/2011_09_30_19_00_1.webm;Yoshihiko Noda.jpg;1117;1133;10741;37;37;0
/net/per920a/export/das14a/satoh-lab/haolin/nhk/excerpts/2011_09_30_19_00_1.webm;Yoshihiko Noda.jpg;1145;1157;10741;38;38;0
/net/per920a/export/das14a/satoh-lab/haolin/nhk/excerpts/2011_09_30_19_00_1.webm;Yoshihiko Noda.jpg;1173;1173;10741;39;39;0
/net/per920a/export/das14a/satoh-lab/haolin/nhk/excerpts/2011_09_30_19_00_1.webm;Yoshihiko Noda.jpg;1209;1209;10741;40;40;0
/net/per920a/export/das14a/satoh-lab/haolin/nhk/excerpts/2011_09_30_19_00_1.webm;Yoshihiko Noda.jpg;1225;1237;10741;40;41;1
/net/per920a/export/das14a/satoh-lab/haolin/nhk/excerpts/2011_09_30_19_00_1.webm;Yoshihiko Noda.jpg;1249;1249;10741;41;41;0
/net/per920a/export/das14a/satoh-lab/haolin/nhk/excerpts/2011_09_30_19_00_1.webm;Yoshihiko Noda.jpg;1261;1277;10741;42;42;0
/net/per920a/export/das14a/satoh-lab/haolin/nhk/excerpts/2011_09_30_19_00_1.webm;Yoshihiko Noda.jpg;1289;1385;10741;42;46;4
/net/per920a/export/das14a/satoh-lab/haolin/nhk/excerpts/2011_09_30_19_00_1.webm;Yoshihiko Noda.jpg;1401;1433;10741;46;47;1
/net/per920a/export/das14a/satoh-lab/haolin/nhk/excerpts/2011_09_30_19_00_1.webm;Yukio EDANO.jpg;10721;10737;10741;357;357;0
/net/per920a/export/das14a/satoh-lab/haolin/nhk/excerpts/2011_10_19_19_00_1.webm;Yoshihiko Noda.jpg;1057;1117;9265;35;37;2
/net/per920a/export/das14a/satoh-lab/haolin/nhk/excerpts/2011_10_19_19_00_1.webm;Yoshihiko Noda.jpg;1129;1129;9265;37;37;0
/net/per920a/export/das14a/satoh-lab/haolin/nhk/excerpts/2011_10_19_19_00_1.webm;Yoshihiko Noda.jpg;1881;1997;9265;62;66;4
/net/per920a/export/das14a/satoh-lab/haolin/nhk/excerpts/2011_10_19_19_00_1.webm;Yoshihiko Noda.jpg;2017;2105;9265;67;70;3
/net/per920a/export/das14a/satoh-lab/haolin/nhk/excerpts/2011_10_19_19_00_1.webm;Yoshihiko Noda.jpg;2329;2357;9265;77;78;1
/net/per920a/export/das14a/satoh-lab/haolin/nhk/excerpts/2011_10_19_19_00_1.webm;Yoshihiko Noda.jpg;3001;3081;9265;100;102;2
/net/per920a/export/das14a/satoh-lab/haolin/nhk/excerpts/2011_10_19_19_00_1.webm;Yoshihiko Noda.jpg;3161;3165;9265;105;105;0
/net/per920a/export/das14a/satoh-lab/haolin/nhk/excerpts/2011_10_19_19_00_1.webm;Yoshihiko Noda.jpg;3177;3177;9265;105;105;0
/net/per920a/export/das14a/satoh-lab/haolin/nhk/excerpts/2011_10_19_19_00_1.webm;Yoshihiko Noda.jpg;3205;3217;9265;106;107;1
/net/per920a/export/das14a/satoh-lab/haolin/nhk/excerpts/2011_10_19_19_00_1.webm;Yoshihiko Noda.jpg;3229;3229;9265;107;107;0
/net/per920a/export/das14a/satoh-lab/haolin/nhk/excerpts/2011_10_19_19_00_1.webm;Yoshihiko Noda.jpg;9209;9217;9265;307;307;0
/net/per920a/export/das14a/satoh-lab/haolin/nhk/excerpts/2011_11_07_19_00_2.webm;Yoshihiko Noda.jpg;3049;3365;7385;101;112;11
/net/per920a/export/das14a/satoh-lab/haolin/nhk/excerpts/2011_11_07_19_00_2.webm;Kazuo SHII.jpg;3565;3581;7385;118;119;1
/net/per920a/export/das14a/satoh-lab/haolin/nhk/excerpts/2011_11_07_19_00_2.webm;Kazuo SHII.jpg;3641;3645;7385;121;121;0
/net/per920a/export/das14a/satoh-lab/haolin/nhk/excerpts/2011_11_07_19_00_2.webm;Kazuo SHII.jpg;4837;4837;7385;161;161;0
/net/per920a/export/das14a/satoh-lab/haolin/nhk/excerpts/2011_11_07_19_00_2.webm;Kazuo SHII.jpg;4865;4865;7385;162;162;0
/net/per920a/export/das14a/satoh-lab/haolin/nhk/excerpts/2011_11_07_19_00_2.webm;Kazuo SHII.jpg;4889;4897;7385;162;163;1
/net/per920a/export/das14a/satoh-lab/haolin/nhk/excerpts/2011_11_07_19_00_2.webm;Kazuo SHII.jpg;4917;4925;7385;163;164;1
/net/per920a/export/das14a/satoh-lab/haolin/nhk/excerpts/2011_11_07_19_00_2.webm;Kazuo SHII.jpg;4941;4977;7385;164;165;1
/net/per920a/export/das14a/satoh-lab/haolin/nhk/excerpts/2011_11_07_19_00_2.webm;Shizuka KAMEI.jpg;4129;4569;7385;137;152;15
/net/per920a/export/das14a/satoh-lab/haolin/nhk/excerpts/2011_11_07_19_00_2.webm;Shizuka KAMEI.jpg;4585;4697;7385;152;156;4
/net/per920a/export/das14a/satoh-lab/haolin/nhk/excerpts/2011_11_07_19_00_2.webm;Shizuka KAMEI.jpg;4713;4749;7385;156;158;2
/net/per920a/export/das14a/satoh-lab/haolin/nhk/excerpts/2011_11_07_19_00_2.webm;Shizuka KAMEI.jpg;4765;4793;7385;158;159;1
/net/per920a/export/das14a/satoh-lab/haolin/nhk/excerpts/2011_11_07_19_00_2.webm;Shizuka KAMEI.jpg;5029;5837;7385;167;194;27
/net/per920a/export/das14a/satoh-lab/haolin/nhk/excerpts/2011_11_07_19_00_2.webm;Ichiro OZAWA.jpg;5933;5933;7385;197;197;0
/net/per920a/export/das14a/satoh-lab/haolin/nhk/excerpts/2011_12_16_19_00_2.webm;Yoshihiko Noda.jpg;7973;8373;12201;265;279;14
/net/per920a/export/das14a/satoh-lab/haolin/nhk/excerpts/2011_12_18_19_00_1.webm;Yoshihiko Noda.jpg;5773;5853;10645;192;195;3
/net/per920a/export/das14a/satoh-lab/haolin/nhk/excerpts/2011_12_18_19_00_1.webm;Yoshihiko Noda.jpg;5881;5885;10645;196;196;0
/net/per920a/export/das14a/satoh-lab/haolin/nhk/excerpts/2011_12_18_19_00_1.webm;Yoshihiko Noda.jpg;5905;5929;10645;196;197;1
/net/per920a/export/das14a/satoh-lab/haolin/nhk/excerpts/2011_12_18_19_00_1.webm;Yoshihiko Noda.jpg;5953;5953;10645;198;198;0
/net/per920a/export/das14a/satoh-lab/haolin/nhk/excerpts/2011_12_18_19_00_1.webm;Yoshihiko Noda.jpg;5965;6329;10645;198;211;13
/net/per920a/export/das14a/satoh-lab/haolin/nhk/excerpts/2011_12_18_19_00_1.webm;Yoshihiko Noda.jpg;6345;6629;10645;211;221;10
/net/per920a/export/das14a/satoh-lab/haolin/nhk/excerpts/2011_12_18_19_00_1.webm;Yoshihiko Noda.jpg;10021;10109;10645;334;337;3
/net/per920a/export/das14a/satoh-lab/haolin/nhk/excerpts/2011_12_24_19_00_2.webm;Yoshihiko Noda.jpg;413;445;2285;13;14;1
/net/per920a/export/das14a/satoh-lab/haolin/nhk/excerpts/2011_12_24_19_00_2.webm;Yoshihiko Noda.jpg;465;941;2285;15;31;16
/net/per920a/export/das14a/satoh-lab/haolin/nhk/excerpts/2011_12_24_19_00_2.webm;Yoshihiko Noda.jpg;1197;1461;2285;39;48;9
/net/per920a/export/das14a/satoh-lab/haolin/nhk/excerpts/2011_12_26_19_00_2.webm;Yoshihiko Noda.jpg;1377;1625;7701;45;54;9
/net/per920a/export/das14a/satoh-lab/haolin/nhk/excerpts/2011_12_27_19_00_3.webm;Toru Hashimoto.jpg;3209;3625;4945;107;120;13
/net/per920a/export/das14a/satoh-lab/haolin/nhk/excerpts/2012_01_10_19_00_2.webm;Ichiro OZAWA.jpg;9;369;13097;0;12;12
/net/per920a/export/das14a/satoh-lab/haolin/nhk/excerpts/2012_01_10_19_00_2.webm;Ichiro OZAWA.jpg;777;777;13097;25;25;0
/net/per920a/export/das14a/satoh-lab/haolin/nhk/excerpts/2012_01_10_19_00_2.webm;Ichiro OZAWA.jpg;801;801;13097;26;26;0
/net/per920a/export/das14a/satoh-lab/haolin/nhk/excerpts/2012_01_10_19_00_2.webm;Ichiro OZAWA.jpg;3517;3589;13097;117;119;2
/net/per920a/export/das14a/satoh-lab/haolin/nhk/excerpts/2012_01_10_19_00_2.webm;Ichiro OZAWA.jpg;3605;3617;13097;120;120;0
/net/per920a/export/das14a/satoh-lab/haolin/nhk/excerpts/2012_01_10_19_00_2.webm;Ichiro OZAWA.jpg;3629;3641;13097;121;121;0
/net/per920a/export/das14a/satoh-lab/haolin/nhk/excerpts/2012_01_10_19_00_2.webm;Ichiro OZAWA.jpg;3653;3665;13097;121;122;1
/net/per920a/export/das14a/satoh-lab/haolin/nhk/excerpts/2012_01_10_19_00_2.webm;Ichiro OZAWA.jpg;3677;3677;13097;122;122;0
/net/per920a/export/das14a/satoh-lab/haolin/nhk/excerpts/2012_01_10_19_00_2.webm;Ichiro OZAWA.jpg;3705;3713;13097;123;123;0
/net/per920a/export/das14a/satoh-lab/haolin/nhk/excerpts/2012_01_10_19_00_2.webm;Ichiro OZAWA.jpg;3725;3725;13097;124;124;0
/net/per920a/export/das14a/satoh-lab/haolin/nhk/excerpts/2012_01_10_19_00_2.webm;Ichiro OZAWA.jpg;3757;3761;13097;125;125;0
/net/per920a/export/das14a/satoh-lab/haolin/nhk/excerpts/2012_01_10_19_00_2.webm;Ichiro OZAWA.jpg;3773;3797;13097;125;126;1
/net/per920a/export/das14a/satoh-lab/haolin/nhk/excerpts/2012_01_10_19_00_2.webm;Ichiro OZAWA.jpg;3809;3809;13097;127;127;0
/net/per920a/export/das14a/satoh-lab/haolin/nhk/excerpts/2012_01_10_19_00_2.webm;Ichiro OZAWA.jpg;3833;3837;13097;127;128;1
/net/per920a/export/das14a/satoh-lab/haolin/nhk/excerpts/2012_01_10_19_00_2.webm;Ichiro OZAWA.jpg;3849;3857;13097;128;128;0
/net/per920a/export/das14a/satoh-lab/haolin/nhk/excerpts/2012_01_10_19_00_2.webm;Ichiro OZAWA.jpg;3869;3893;13097;129;129;0
/net/per920a/export/das14a/satoh-lab/haolin/nhk/excerpts/2012_01_10_19_00_2.webm;Ichiro OZAWA.jpg;3913;3917;13097;130;130;0
/net/per920a/export/das14a/satoh-lab/haolin/nhk/excerpts/2012_01_10_19_00_2.webm;Ichiro OZAWA.jpg;4453;4453;13097;148;148;0
/net/per920a/export/das14a/satoh-lab/haolin/nhk/excerpts/2012_01_10_19_00_2.webm;Ichiro OZAWA.jpg;4473;4477;13097;149;149;0
/net/per920a/export/das14a/satoh-lab/haolin/nhk/excerpts/2012_01_10_19_00_2.webm;Ichiro OZAWA.jpg;4489;4489;13097;149;149;0
/net/per920a/export/das14a/satoh-lab/haolin/nhk/excerpts/2012_01_10_19_00_2.webm;Ichiro OZAWA.jpg;4533;4537;13097;151;151;0
/net/per920a/export/das14a/satoh-lab/haolin/nhk/excerpts/2012_01_10_19_00_2.webm;Ichiro OZAWA.jpg;4553;4561;13097;151;152;1
/net/per920a/export/das14a/satoh-lab/haolin/nhk/excerpts/2012_01_10_19_00_2.webm;Ichiro OZAWA.jpg;4581;4593;13097;152;153;1
/net/per920a/export/das14a/satoh-lab/haolin/nhk/excerpts/2012_01_10_19_00_2.webm;Ichiro OZAWA.jpg;4609;4613;13097;153;153;0
/net/per920a/export/das14a/satoh-lab/haolin/nhk/excerpts/2012_01_10_19_00_2.webm;Ichiro OZAWA.jpg;4625;4625;13097;154;154;0
/net/per920a/export/das14a/satoh-lab/haolin/nhk/excerpts/2012_01_10_19_00_2.webm;Ichiro OZAWA.jpg;4641;4645;13097;154;154;0
/net/per920a/export/das14a/satoh-lab/haolin/nhk/excerpts/2012_01_10_19_00_2.webm;Ichiro OZAWA.jpg;4673;4673;13097;155;155;0
/net/per920a/export/das14a/satoh-lab/haolin/nhk/excerpts/2012_01_10_19_00_2.webm;Ichiro OZAWA.jpg;4697;4697;13097;156;156;0
/net/per920a/export/das14a/satoh-lab/haolin/nhk/excerpts/2012_01_10_19_00_2.webm;Ichiro OZAWA.jpg;4709;4733;13097;157;157;0
/net/per920a/export/das14a/satoh-lab/haolin/nhk/excerpts/2012_01_10_19_00_2.webm;Ichiro OZAWA.jpg;4777;4781;13097;159;159;0
/net/per920a/export/das14a/satoh-lab/haolin/nhk/excerpts/2012_01_10_19_00_2.webm;Ichiro OZAWA.jpg;4809;4813;13097;160;160;0
/net/per920a/export/das14a/satoh-lab/haolin/nhk/excerpts/2012_01_10_19_00_2.webm;Ichiro OZAWA.jpg;4877;4877;13097;162;162;0
/net/per920a/export/das14a/satoh-lab/haolin/nhk/excerpts/2012_01_10_19_00_2.webm;Ichiro OZAWA.jpg;4897;4897;13097;163;163;0
/net/per920a/export/das14a/satoh-lab/haolin/nhk/excerpts/2012_01_10_19_00_2.webm;Ichiro OZAWA.jpg;5029;5029;13097;167;167;0
/net/per920a/export/das14a/satoh-lab/haolin/nhk/excerpts/2012_01_10_19_00_2.webm;Ichiro OZAWA.jpg;5089;5089;13097;169;169;0
/net/per920a/export/das14a/satoh-lab/haolin/nhk/excerpts/2012_01_10_19_00_2.webm;Ichiro OZAWA.jpg;5129;5137;13097;171;171;0
/net/per920a/export/das14a/satoh-lab/haolin/nhk/excerpts/2012_01_10_19_00_2.webm;Ichiro OZAWA.jpg;5173;5173;13097;172;172;0
/net/per920a/export/das14a/satoh-lab/haolin/nhk/excerpts/2012_01_10_19_00_2.webm;Ichiro OZAWA.jpg;5189;5189;13097;173;173;0
/net/per920a/export/das14a/satoh-lab/haolin/nhk/excerpts/2012_01_10_19_00_2.webm;Ichiro OZAWA.jpg;5229;5233;13097;174;174;0
/net/per920a/export/das14a/satoh-lab/haolin/nhk/excerpts/2012_01_10_19_00_2.webm;Ichiro OZAWA.jpg;5281;5281;13097;176;176;0
/net/per920a/export/das14a/satoh-lab/haolin/nhk/excerpts/2012_01_10_19_00_2.webm;Ichiro OZAWA.jpg;5297;5297;13097;176;176;0
/net/per920a/export/das14a/satoh-lab/haolin/nhk/excerpts/2012_01_10_19_00_2.webm;Ichiro OZAWA.jpg;5317;5325;13097;177;177;0
/net/per920a/export/das14a/satoh-lab/haolin/nhk/excerpts/2012_01_10_19_00_2.webm;Ichiro OZAWA.jpg;5353;5357;13097;178;178;0
/net/per920a/export/das14a/satoh-lab/haolin/nhk/excerpts/2012_01_10_19_00_2.webm;Ichiro OZAWA.jpg;6105;6321;13097;203;210;7
/net/per920a/export/das14a/satoh-lab/haolin/nhk/excerpts/2012_01_10_19_00_2.webm;Ichiro OZAWA.jpg;6529;6533;13097;217;217;0
/net/per920a/export/das14a/satoh-lab/haolin/nhk/excerpts/2012_01_12_19_00_1.webm;Yoshihiko Noda.jpg;937;1033;8821;31;34;3
/net/per920a/export/das14a/satoh-lab/haolin/nhk/excerpts/2012_01_12_19_00_1.webm;Yoshihiko Noda.jpg;1045;1065;8821;34;35;1
/net/per920a/export/das14a/satoh-lab/haolin/nhk/excerpts/2012_01_12_19_00_1.webm;Yoshihiko Noda.jpg;1081;1133;8821;36;37;1
/net/per920a/export/das14a/satoh-lab/haolin/nhk/excerpts/2012_01_12_19_00_1.webm;Yoshihiko Noda.jpg;4129;4129;8821;137;137;0
/net/per920a/export/das14a/satoh-lab/haolin/nhk/excerpts/2012_01_12_19_00_1.webm;Yoshihiko Noda.jpg;4145;4145;8821;138;138;0
/net/per920a/export/das14a/satoh-lab/haolin/nhk/excerpts/2012_01_12_19_00_1.webm;Yoshihiko Noda.jpg;4157;4173;8821;138;139;1
/net/per920a/export/das14a/satoh-lab/haolin/nhk/excerpts/2012_01_12_19_00_1.webm;Yoshihiko Noda.jpg;5117;5213;8821;170;173;3
/net/per920a/export/das14a/satoh-lab/haolin/nhk/excerpts/2012_01_12_19_00_1.webm;Yoshihiko Noda.jpg;5225;5245;8821;174;174;0
/net/per920a/export/das14a/satoh-lab/haolin/nhk/excerpts/2012_01_12_19_00_1.webm;Yoshihiko Noda.jpg;5261;5321;8821;175;177;2
/net/per920a/export/das14a/satoh-lab/haolin/nhk/excerpts/2012_01_12_19_00_1.webm;Sadakazu TANIGAKI.jpg;8037;8053;8821;267;268;1
/net/per920a/export/das14a/satoh-lab/haolin/nhk/excerpts/2012_01_12_19_00_1.webm;Sadakazu TANIGAKI.jpg;8089;8089;8821;269;269;0
/net/per920a/export/das14a/satoh-lab/haolin/nhk/excerpts/2012_01_12_19_00_1.webm;Sadakazu TANIGAKI.jpg;8105;8117;8821;270;270;0
/net/per920a/export/das14a/satoh-lab/haolin/nhk/excerpts/2012_01_12_19_00_1.webm;Sadakazu TANIGAKI.jpg;8129;8129;8821;270;270;0
/net/per920a/export/das14a/satoh-lab/haolin/nhk/excerpts/2012_01_12_19_00_1.webm;Sadakazu TANIGAKI.jpg;8157;8173;8821;271;272;1
/net/per920a/export/das14a/satoh-lab/haolin/nhk/excerpts/2012_01_12_19_00_1.webm;Sadakazu TANIGAKI.jpg;8189;8197;8821;272;273;1
/net/per920a/export/das14a/satoh-lab/haolin/nhk/excerpts/2012_01_12_19_00_1.webm;Sadakazu TANIGAKI.jpg;8245;8265;8821;274;275;1
/net/per920a/export/das14a/satoh-lab/haolin/nhk/excerpts/2012_01_12_19_00_1.webm;Sadakazu TANIGAKI.jpg;8297;8321;8821;276;277;1
/net/per920a/export/das14a/satoh-lab/haolin/nhk/excerpts/2012_01_12_19_00_1.webm;Sadakazu TANIGAKI.jpg;8333;8341;8821;277;278;1
/net/per920a/export/das14a/satoh-lab/haolin/nhk/excerpts/2012_01_12_19_00_1.webm;Sadakazu TANIGAKI.jpg;8353;8365;8821;278;278;0
/net/per920a/export/das14a/satoh-lab/haolin/nhk/excerpts/2012_01_12_19_00_1.webm;Sadakazu TANIGAKI.jpg;8385;8397;8821;279;279;0
/net/per920a/export/das14a/satoh-lab/haolin/nhk/excerpts/2012_01_12_19_00_1.webm;Sadakazu TANIGAKI.jpg;8409;8417;8821;280;280;0
/net/per920a/export/das14a/satoh-lab/haolin/nhk/excerpts/2012_01_12_19_00_1.webm;Sadakazu TANIGAKI.jpg;8441;8449;8821;281;281;0
/net/per920a/export/das14a/satoh-lab/haolin/nhk/excerpts/2012_02_04_19_00_3.webm;Yoshihiko Noda.jpg;41;709;4533;1;23;22
/net/per920a/export/das14a/satoh-lab/haolin/nhk/excerpts/2012_02_04_19_00_3.webm;Yoshihiko Noda.jpg;929;937;4533;30;31;1
/net/per920a/export/das14a/satoh-lab/haolin/nhk/excerpts/2012_02_04_19_00_3.webm;Yoshihiko Noda.jpg;1101;1801;4533;36;59;23
/net/per920a/export/das14a/satoh-lab/haolin/nhk/excerpts/2012_02_04_19_00_3.webm;Yoshihiko Noda.jpg;1817;1905;4533;60;63;3
/net/per920a/export/das14a/satoh-lab/haolin/nhk/excerpts/2012_02_04_19_00_3.webm;Yoshihiko Noda.jpg;1921;2677;4533;63;89;26
/net/per920a/export/das14a/satoh-lab/haolin/nhk/excerpts/2012_02_04_19_00_3.webm;Yoshihiko Noda.jpg;2693;2789;4533;89;92;3
/net/per920a/export/das14a/satoh-lab/haolin/nhk/excerpts/2012_02_04_19_00_3.webm;Yoshihiko Noda.jpg;2805;3381;4533;93;112;19
/net/per920a/export/das14a/satoh-lab/haolin/nhk/excerpts/2012_02_04_19_00_3.webm;Yoshihiko Noda.jpg;4085;4269;4533;136;142;6
/net/per920a/export/das14a/satoh-lab/haolin/nhk/excerpts/2012_02_04_19_00_3.webm;Yoshihiko Noda.jpg;4285;4445;4533;142;148;6
/net/per920a/export/das14a/satoh-lab/haolin/nhk/excerpts/2012_03_09_19_00_2.webm;Ichiro OZAWA.jpg;9;909;6873;0;30;30
/net/per920a/export/das14a/satoh-lab/haolin/nhk/excerpts/2012_03_09_19_00_2.webm;Ichiro OZAWA.jpg;3977;4257;6873;132;141;9
/net/per920a/export/das14a/satoh-lab/haolin/nhk/excerpts/2012_03_28_19_00_1.webm;Yoshihiko Noda.jpg;837;837;6153;27;27;0
/net/per920a/export/das14a/satoh-lab/haolin/nhk/excerpts/2012_03_28_19_00_1.webm;Yoshihiko Noda.jpg;849;897;6153;28;29;1
/net/per920a/export/das14a/satoh-lab/haolin/nhk/excerpts/2012_03_28_19_00_1.webm;Yoshihiko Noda.jpg;909;909;6153;30;30;0
/net/per920a/export/das14a/satoh-lab/haolin/nhk/excerpts/2012_03_28_19_00_1.webm;Yoshihiko Noda.jpg;949;949;6153;31;31;0
/net/per920a/export/das14a/satoh-lab/haolin/nhk/excerpts/2012_03_28_19_00_1.webm;Yoshihiko Noda.jpg;961;961;6153;32;32;0
/net/per920a/export/das14a/satoh-lab/haolin/nhk/excerpts/2012_03_28_19_00_1.webm;Yoshihiko Noda.jpg;981;1069;6153;32;35;3
/net/per920a/export/das14a/satoh-lab/haolin/nhk/excerpts/2012_03_28_19_00_1.webm;Yoshihiko Noda.jpg;1101;1105;6153;36;36;0
/net/per920a/export/das14a/satoh-lab/haolin/nhk/excerpts/2012_03_28_19_00_1.webm;Yoshihiko Noda.jpg;1129;1141;6153;37;38;1
/net/per920a/export/das14a/satoh-lab/haolin/nhk/excerpts/2012_03_28_19_00_1.webm;Yoshihiko Noda.jpg;1157;1165;6153;38;38;0
/net/per920a/export/das14a/satoh-lab/haolin/nhk/excerpts/2012_03_28_19_00_1.webm;Yoshihiko Noda.jpg;1177;1185;6153;39;39;0
/net/per920a/export/das14a/satoh-lab/haolin/nhk/excerpts/2012_03_28_19_00_1.webm;Yoshihiko Noda.jpg;1213;1341;6153;40;44;4
/net/per920a/export/das14a/satoh-lab/haolin/nhk/excerpts/2012_03_28_19_00_1.webm;Yoshihiko Noda.jpg;1365;1417;6153;45;47;2
/net/per920a/export/das14a/satoh-lab/haolin/nhk/excerpts/2012_03_28_19_00_1.webm;Yoshihiko Noda.jpg;1433;1501;6153;47;50;3
/net/per920a/export/das14a/satoh-lab/haolin/nhk/excerpts/2012_03_28_19_00_1.webm;Seiji MAEHARA.jpg;1581;1625;6153;52;54;2
/net/per920a/export/das14a/satoh-lab/haolin/nhk/excerpts/2012_03_28_19_00_1.webm;Seiji MAEHARA.jpg;2997;3133;6153;99;104;5
/net/per920a/export/das14a/satoh-lab/haolin/nhk/excerpts/2012_03_28_19_00_1.webm;Seiji MAEHARA.jpg;3685;3685;6153;122;122;0
/net/per920a/export/das14a/satoh-lab/haolin/nhk/excerpts/2012_03_28_19_00_1.webm;Seiji MAEHARA.jpg;3709;3709;6153;123;123;0
/net/per920a/export/das14a/satoh-lab/haolin/nhk/excerpts/2012_03_28_19_00_1.webm;Seiji MAEHARA.jpg;3721;3745;6153;123;124;1
/net/per920a/export/das14a/satoh-lab/haolin/nhk/excerpts/2012_03_28_19_00_1.webm;Seiji MAEHARA.jpg;3765;3765;6153;125;125;0
/net/per920a/export/das14a/satoh-lab/haolin/nhk/excerpts/2012_03_28_19_00_1.webm;Seiji MAEHARA.jpg;3785;3789;6153;126;126;0
/net/per920a/export/das14a/satoh-lab/haolin/nhk/excerpts/2012_03_28_19_00_1.webm;Seiji MAEHARA.jpg;3809;3813;6153;126;127;1
/net/per920a/export/das14a/satoh-lab/haolin/nhk/excerpts/2012_03_28_19_00_1.webm;Seiji MAEHARA.jpg;3825;3861;6153;127;128;1
/net/per920a/export/das14a/satoh-lab/haolin/nhk/excerpts/2012_03_28_19_00_1.webm;Seiji MAEHARA.jpg;5317;5329;6153;177;177;0
/net/per920a/export/das14a/satoh-lab/haolin/nhk/excerpts/2012_03_28_19_00_1.webm;Seiji MAEHARA.jpg;5341;5341;6153;177;177;0
/net/per920a/export/das14a/satoh-lab/haolin/nhk/excerpts/2012_03_28_19_00_1.webm;Seiji MAEHARA.jpg;5377;5421;6153;179;180;1
/net/per920a/export/das14a/satoh-lab/haolin/nhk/excerpts/2012_03_28_19_00_1.webm;Seiji MAEHARA.jpg;5949;5997;6153;198;199;1
/net/per920a/export/das14a/satoh-lab/haolin/nhk/excerpts/2012_04_17_19_00_1.webm;Shintaro ISHIHARA.jpg;121;1009;13405;4;33;29
/net/per920a/export/das14a/satoh-lab/haolin/nhk/excerpts/2012_04_17_19_00_1.webm;Shintaro ISHIHARA.jpg;1337;1353;13405;44;45;1
/net/per920a/export/das14a/satoh-lab/haolin/nhk/excerpts/2012_04_17_19_00_1.webm;Shintaro ISHIHARA.jpg;1373;1501;13405;45;50;5
/net/per920a/export/das14a/satoh-lab/haolin/nhk/excerpts/2012_05_28_19_00_3.webm;Naoto KAN.jpg;1001;1141;13965;33;38;5
/net/per920a/export/das14a/satoh-lab/haolin/nhk/excerpts/2012_05_28_19_00_3.webm;Naoto KAN.jpg;1161;1981;13965;38;66;28
/net/per920a/export/das14a/satoh-lab/haolin/nhk/excerpts/2012_05_28_19_00_3.webm;Naoto KAN.jpg;2513;2997;13965;83;100;17
/net/per920a/export/das14a/satoh-lab/haolin/nhk/excerpts/2012_05_28_19_00_3.webm;Naoto KAN.jpg;3013;3033;13965;100;101;1
/net/per920a/export/das14a/satoh-lab/haolin/nhk/excerpts/2012_05_28_19_00_3.webm;Naoto KAN.jpg;4229;4253;13965;141;141;0
/net/per920a/export/das14a/satoh-lab/haolin/nhk/excerpts/2012_05_28_19_00_3.webm;Naoto KAN.jpg;4285;4733;13965;142;157;15
/net/per920a/export/das14a/satoh-lab/haolin/nhk/excerpts/2012_05_28_19_00_3.webm;Naoto KAN.jpg;4745;4745;13965;158;158;0
/net/per920a/export/das14a/satoh-lab/haolin/nhk/excerpts/2012_05_28_19_00_3.webm;Naoto KAN.jpg;4773;5073;13965;159;169;10
/net/per920a/export/das14a/satoh-lab/haolin/nhk/excerpts/2012_05_28_19_00_3.webm;Naoto KAN.jpg;5101;5605;13965;170;187;17
/net/per920a/export/das14a/satoh-lab/haolin/nhk/excerpts/2012_05_28_19_00_3.webm;Naoto KAN.jpg;6285;6293;13965;209;209;0
/net/per920a/export/das14a/satoh-lab/haolin/nhk/excerpts/2012_05_28_19_00_3.webm;Naoto KAN.jpg;6305;6317;13965;210;210;0
/net/per920a/export/das14a/satoh-lab/haolin/nhk/excerpts/2012_05_28_19_00_3.webm;Naoto KAN.jpg;6329;6365;13965;211;212;1
/net/per920a/export/das14a/satoh-lab/haolin/nhk/excerpts/2012_05_28_19_00_3.webm;Naoto KAN.jpg;6377;6389;13965;212;213;1
/net/per920a/export/das14a/satoh-lab/haolin/nhk/excerpts/2012_05_28_19_00_3.webm;Naoto KAN.jpg;6401;6409;13965;213;213;0
/net/per920a/export/das14a/satoh-lab/haolin/nhk/excerpts/2012_05_28_19_00_3.webm;Naoto KAN.jpg;6421;6485;13965;214;216;2
/net/per920a/export/das14a/satoh-lab/haolin/nhk/excerpts/2012_05_28_19_00_3.webm;Naoto KAN.jpg;6501;6613;13965;216;220;4
/net/per920a/export/das14a/satoh-lab/haolin/nhk/excerpts/2012_05_28_19_00_3.webm;Naoto KAN.jpg;6633;6649;13965;221;221;0
/net/per920a/export/das14a/satoh-lab/haolin/nhk/excerpts/2012_05_28_19_00_3.webm;Naoto KAN.jpg;6661;6717;13965;222;224;2
/net/per920a/export/das14a/satoh-lab/haolin/nhk/excerpts/2012_05_28_19_00_3.webm;Naoto KAN.jpg;6729;6781;13965;224;226;2
/net/per920a/export/das14a/satoh-lab/haolin/nhk/excerpts/2012_05_28_19_00_3.webm;Naoto KAN.jpg;6793;6793;13965;226;226;0
/net/per920a/export/das14a/satoh-lab/haolin/nhk/excerpts/2012_05_28_19_00_3.webm;Naoto KAN.jpg;6805;6833;13965;227;228;1
/net/per920a/export/das14a/satoh-lab/haolin/nhk/excerpts/2012_05_28_19_00_3.webm;Naoto KAN.jpg;6849;7013;13965;228;234;6
/net/per920a/export/das14a/satoh-lab/haolin/nhk/excerpts/2012_05_28_19_00_3.webm;Naoto KAN.jpg;7025;7053;13965;234;235;1
/net/per920a/export/das14a/satoh-lab/haolin/nhk/excerpts/2012_05_28_19_00_3.webm;Naoto KAN.jpg;7065;7101;13965;235;236;1
/net/per920a/export/das14a/satoh-lab/haolin/nhk/excerpts/2012_05_28_19_00_3.webm;Naoto KAN.jpg;7937;7949;13965;264;265;1
/net/per920a/export/das14a/satoh-lab/haolin/nhk/excerpts/2012_05_28_19_00_3.webm;Naoto KAN.jpg;7961;7993;13965;265;266;1
/net/per920a/export/das14a/satoh-lab/haolin/nhk/excerpts/2012_05_28_19_00_3.webm;Naoto KAN.jpg;8009;8049;13965;267;268;1
/net/per920a/export/das14a/satoh-lab/haolin/nhk/excerpts/2012_05_28_19_00_3.webm;Naoto KAN.jpg;8081;8313;13965;269;277;8
/net/per920a/export/das14a/satoh-lab/haolin/nhk/excerpts/2012_05_28_19_00_3.webm;Naoto KAN.jpg;8329;8369;13965;277;279;2
/net/per920a/export/das14a/satoh-lab/haolin/nhk/excerpts/2012_05_28_19_00_3.webm;Naoto KAN.jpg;8401;8453;13965;280;282;2
/net/per920a/export/das14a/satoh-lab/haolin/nhk/excerpts/2012_05_28_19_00_3.webm;Naoto KAN.jpg;8469;8497;13965;282;283;1
/net/per920a/export/das14a/satoh-lab/haolin/nhk/excerpts/2012_05_28_19_00_3.webm;Naoto KAN.jpg;8513;8521;13965;284;284;0
/net/per920a/export/das14a/satoh-lab/haolin/nhk/excerpts/2012_05_28_19_00_3.webm;Naoto KAN.jpg;8541;9085;13965;285;303;18
/net/per920a/export/das14a/satoh-lab/haolin/nhk/excerpts/2012_05_28_19_00_3.webm;Naoto KAN.jpg;10169;10773;13965;339;359;20
/net/per920a/export/das14a/satoh-lab/haolin/nhk/excerpts/2012_05_28_19_00_3.webm;Naoto KAN.jpg;11653;11761;13965;388;392;4
/net/per920a/export/das14a/satoh-lab/haolin/nhk/excerpts/2012_05_28_19_00_3.webm;Naoto KAN.jpg;11777;11809;13965;392;394;2
/net/per920a/export/das14a/satoh-lab/haolin/nhk/excerpts/2012_05_28_19_00_3.webm;Naoto KAN.jpg;11821;11865;13965;394;395;1
/net/per920a/export/das14a/satoh-lab/haolin/nhk/excerpts/2012_05_28_19_00_3.webm;Naoto KAN.jpg;11877;11877;13965;396;396;0
/net/per920a/export/das14a/satoh-lab/haolin/nhk/excerpts/2012_05_28_19_00_3.webm;Naoto KAN.jpg;11893;12213;13965;396;407;11
/net/per920a/export/das14a/satoh-lab/haolin/nhk/excerpts/2012_05_28_19_00_3.webm;Naoto KAN.jpg;12225;12229;13965;407;408;1
/net/per920a/export/das14a/satoh-lab/haolin/nhk/excerpts/2012_05_28_19_00_3.webm;Naoto KAN.jpg;12241;12269;13965;408;409;1
/net/per920a/export/das14a/satoh-lab/haolin/nhk/excerpts/2012_05_28_19_00_3.webm;Naoto KAN.jpg;12281;12729;13965;409;424;15
/net/per920a/export/das14a/satoh-lab/haolin/nhk/excerpts/2012_05_28_19_00_3.webm;Naoto KAN.jpg;13069;13185;13965;436;439;3
/net/per920a/export/das14a/satoh-lab/haolin/nhk/excerpts/2012_05_28_19_00_3.webm;Naoto KAN.jpg;13197;13313;13965;440;444;4
/net/per920a/export/das14a/satoh-lab/haolin/nhk/excerpts/2012_05_28_19_00_3.webm;Naoto KAN.jpg;13325;13345;13965;444;445;1
/net/per920a/export/das14a/satoh-lab/haolin/nhk/excerpts/2012_05_28_19_00_3.webm;Naoto KAN.jpg;13357;13449;13965;445;448;3
/net/per920a/export/das14a/satoh-lab/haolin/nhk/excerpts/2012_05_28_19_00_3.webm;Naoto KAN.jpg;13465;13469;13965;449;449;0
/net/per920a/export/das14a/satoh-lab/haolin/nhk/excerpts/2012_05_28_19_00_3.webm;Naoto KAN.jpg;13485;13565;13965;449;452;3
/net/per920a/export/das14a/satoh-lab/haolin/nhk/excerpts/2012_05_28_19_00_3.webm;Naoto KAN.jpg;13577;13577;13965;453;453;0
/net/per920a/export/das14a/satoh-lab/haolin/nhk/excerpts/2012_05_28_19_00_3.webm;Naoto KAN.jpg;13589;13681;13965;453;456;3
/net/per920a/export/das14a/satoh-lab/haolin/nhk/excerpts/2012_05_28_19_00_3.webm;Naoto KAN.jpg;13709;13961;13965;457;465;8
/net/per920a/export/das14a/satoh-lab/haolin/nhk/excerpts/2012_05_30_19_00_1.webm;Ichiro OZAWA.jpg;1293;1321;14149;43;44;1
/net/per920a/export/das14a/satoh-lab/haolin/nhk/excerpts/2012_05_30_19_00_1.webm;Ichiro OZAWA.jpg;1337;1341;14149;44;44;0
/net/per920a/export/das14a/satoh-lab/haolin/nhk/excerpts/2012_05_30_19_00_1.webm;Ichiro OZAWA.jpg;1365;1369;14149;45;45;0
/net/per920a/export/das14a/satoh-lab/haolin/nhk/excerpts/2012_05_30_19_00_1.webm;Ichiro OZAWA.jpg;1381;1381;14149;46;46;0
/net/per920a/export/das14a/satoh-lab/haolin/nhk/excerpts/2012_05_30_19_00_1.webm;Ichiro OZAWA.jpg;1405;1417;14149;46;47;1
/net/per920a/export/das14a/satoh-lab/haolin/nhk/excerpts/2012_05_30_19_00_1.webm;Ichiro OZAWA.jpg;1429;1429;14149;47;47;0
/net/per920a/export/das14a/satoh-lab/haolin/nhk/excerpts/2012_05_30_19_00_1.webm;Ichiro OZAWA.jpg;2125;2145;14149;70;71;1
/net/per920a/export/das14a/satoh-lab/haolin/nhk/excerpts/2012_05_30_19_00_1.webm;Ichiro OZAWA.jpg;2157;2157;14149;71;71;0
/net/per920a/export/das14a/satoh-lab/haolin/nhk/excerpts/2012_05_30_19_00_1.webm;Ichiro OZAWA.jpg;2173;2173;14149;72;72;0
/net/per920a/export/das14a/satoh-lab/haolin/nhk/excerpts/2012_05_30_19_00_1.webm;Ichiro OZAWA.jpg;2185;2185;14149;72;72;0
/net/per920a/export/das14a/satoh-lab/haolin/nhk/excerpts/2012_05_30_19_00_1.webm;Ichiro OZAWA.jpg;2201;2205;14149;73;73;0
/net/per920a/export/das14a/satoh-lab/haolin/nhk/excerpts/2012_05_30_19_00_1.webm;Ichiro OZAWA.jpg;2225;2233;14149;74;74;0
/net/per920a/export/das14a/satoh-lab/haolin/nhk/excerpts/2012_05_30_19_00_1.webm;Ichiro OZAWA.jpg;2249;2457;14149;75;81;6
/net/per920a/export/das14a/satoh-lab/haolin/nhk/excerpts/2012_05_30_19_00_1.webm;Ichiro OZAWA.jpg;2473;2981;14149;82;99;17
/net/per920a/export/das14a/satoh-lab/haolin/nhk/excerpts/2012_05_30_19_00_1.webm;Ichiro OZAWA.jpg;2997;3397;14149;99;113;14
/net/per920a/export/das14a/satoh-lab/haolin/nhk/excerpts/2012_05_30_19_00_1.webm;Ichiro OZAWA.jpg;3609;3613;14149;120;120;0
/net/per920a/export/das14a/satoh-lab/haolin/nhk/excerpts/2012_05_30_19_00_1.webm;Ichiro OZAWA.jpg;3625;3657;14149;120;121;1
/net/per920a/export/das14a/satoh-lab/haolin/nhk/excerpts/2012_05_30_19_00_1.webm;Ichiro OZAWA.jpg;3669;3805;14149;122;126;4
/net/per920a/export/das14a/satoh-lab/haolin/nhk/excerpts/2012_05_30_19_00_1.webm;Ichiro OZAWA.jpg;3825;3841;14149;127;128;1
/net/per920a/export/das14a/satoh-lab/haolin/nhk/excerpts/2012_05_30_19_00_1.webm;Ichiro OZAWA.jpg;3865;3865;14149;128;128;0
/net/per920a/export/das14a/satoh-lab/haolin/nhk/excerpts/2012_05_30_19_00_1.webm;Ichiro OZAWA.jpg;3941;3993;14149;131;133;2
/net/per920a/export/das14a/satoh-lab/haolin/nhk/excerpts/2012_05_30_19_00_1.webm;Ichiro OZAWA.jpg;4009;4133;14149;133;137;4
/net/per920a/export/das14a/satoh-lab/haolin/nhk/excerpts/2012_05_30_19_00_1.webm;Ichiro OZAWA.jpg;4161;4165;14149;138;138;0
/net/per920a/export/das14a/satoh-lab/haolin/nhk/excerpts/2012_05_30_19_00_1.webm;Ichiro OZAWA.jpg;4189;4205;14149;139;140;1
/net/per920a/export/das14a/satoh-lab/haolin/nhk/excerpts/2012_05_30_19_00_1.webm;Ichiro OZAWA.jpg;4221;4225;14149;140;140;0
/net/per920a/export/das14a/satoh-lab/haolin/nhk/excerpts/2012_05_30_19_00_1.webm;Ichiro OZAWA.jpg;5285;5313;14149;176;177;1
/net/per920a/export/das14a/satoh-lab/haolin/nhk/excerpts/2012_05_30_19_00_1.webm;Ichiro OZAWA.jpg;5329;5333;14149;177;177;0
/net/per920a/export/das14a/satoh-lab/haolin/nhk/excerpts/2012_05_30_19_00_1.webm;Ichiro OZAWA.jpg;5369;5385;14149;179;179;0
/net/per920a/export/das14a/satoh-lab/haolin/nhk/excerpts/2012_05_30_19_00_1.webm;Ichiro OZAWA.jpg;5401;5513;14149;180;183;3
/net/per920a/export/das14a/satoh-lab/haolin/nhk/excerpts/2012_05_30_19_00_1.webm;Ichiro OZAWA.jpg;5949;6033;14149;198;201;3
/net/per920a/export/das14a/satoh-lab/haolin/nhk/excerpts/2012_05_30_19_00_1.webm;Ichiro OZAWA.jpg;6117;6117;14149;204;204;0
/net/per920a/export/das14a/satoh-lab/haolin/nhk/excerpts/2012_05_30_19_00_1.webm;Ichiro OZAWA.jpg;6129;6137;14149;204;204;0
/net/per920a/export/das14a/satoh-lab/haolin/nhk/excerpts/2012_05_30_19_00_1.webm;Ichiro OZAWA.jpg;6153;6161;14149;205;205;0
/net/per920a/export/das14a/satoh-lab/haolin/nhk/excerpts/2012_05_30_19_00_1.webm;Ichiro OZAWA.jpg;6201;6201;14149;206;206;0
/net/per920a/export/das14a/satoh-lab/haolin/nhk/excerpts/2012_05_30_19_00_1.webm;Ichiro OZAWA.jpg;6241;6245;14149;208;208;0
/net/per920a/export/das14a/satoh-lab/haolin/nhk/excerpts/2012_05_30_19_00_1.webm;Ichiro OZAWA.jpg;6261;6453;14149;208;215;7
/net/per920a/export/das14a/satoh-lab/haolin/nhk/excerpts/2012_05_30_19_00_1.webm;Ichiro OZAWA.jpg;6473;6585;14149;215;219;4
/net/per920a/export/das14a/satoh-lab/haolin/nhk/excerpts/2012_05_30_19_00_1.webm;Ichiro OZAWA.jpg;11329;11373;14149;377;379;2
/net/per920a/export/das14a/satoh-lab/haolin/nhk/excerpts/2012_05_30_19_00_1.webm;Ichiro OZAWA.jpg;11389;11613;14149;379;387;8
/net/per920a/export/das14a/satoh-lab/haolin/nhk/excerpts/2012_05_30_19_00_1.webm;Ichiro OZAWA.jpg;11625;11633;14149;387;388;1
/net/per920a/export/das14a/satoh-lab/haolin/nhk/excerpts/2012_05_30_19_00_1.webm;Ichiro OZAWA.jpg;11645;11645;14149;388;388;0
/net/per920a/export/das14a/satoh-lab/haolin/nhk/excerpts/2012_05_30_19_00_1.webm;Ichiro OZAWA.jpg;11661;11685;14149;389;389;0
/net/per920a/export/das14a/satoh-lab/haolin/nhk/excerpts/2012_05_30_19_00_1.webm;Ichiro OZAWA.jpg;11741;11753;14149;391;392;1
/net/per920a/export/das14a/satoh-lab/haolin/nhk/excerpts/2012_05_30_19_00_1.webm;Ichiro OZAWA.jpg;11765;11797;14149;392;393;1
/net/per920a/export/das14a/satoh-lab/haolin/nhk/excerpts/2012_05_30_19_00_1.webm;Ichiro OZAWA.jpg;11813;11853;14149;394;395;1
/net/per920a/export/das14a/satoh-lab/haolin/nhk/excerpts/2012_05_30_19_00_1.webm;Ichiro OZAWA.jpg;11893;11897;14149;396;396;0
/net/per920a/export/das14a/satoh-lab/haolin/nhk/excerpts/2012_05_30_19_00_1.webm;Ichiro OZAWA.jpg;13153;13341;14149;438;445;7
/net/per920a/export/das14a/satoh-lab/haolin/nhk/excerpts/2012_05_30_19_00_1.webm;Ichiro OZAWA.jpg;13365;13373;14149;445;446;1
/net/per920a/export/das14a/satoh-lab/haolin/nhk/excerpts/2012_05_30_19_00_1.webm;Ichiro OZAWA.jpg;13389;13409;14149;446;447;1
/net/per920a/export/das14a/satoh-lab/haolin/nhk/excerpts/2012_05_30_19_00_1.webm;Ichiro OZAWA.jpg;13425;13429;14149;447;447;0
/net/per920a/export/das14a/satoh-lab/haolin/nhk/excerpts/2012_05_30_19_00_1.webm;Ichiro OZAWA.jpg;13445;13561;14149;448;452;4
/net/per920a/export/das14a/satoh-lab/haolin/nhk/excerpts/2012_05_30_19_00_1.webm;Yoshihiko Noda.jpg;1293;1321;14149;43;44;1
/net/per920a/export/das14a/satoh-lab/haolin/nhk/excerpts/2012_05_30_19_00_1.webm;Yoshihiko Noda.jpg;1337;1341;14149;44;44;0
/net/per920a/export/das14a/satoh-lab/haolin/nhk/excerpts/2012_05_30_19_00_1.webm;Yoshihiko Noda.jpg;1365;1369;14149;45;45;0
/net/per920a/export/das14a/satoh-lab/haolin/nhk/excerpts/2012_05_30_19_00_1.webm;Yoshihiko Noda.jpg;1381;1381;14149;46;46;0
/net/per920a/export/das14a/satoh-lab/haolin/nhk/excerpts/2012_05_30_19_00_1.webm;Yoshihiko Noda.jpg;1405;1417;14149;46;47;1
/net/per920a/export/das14a/satoh-lab/haolin/nhk/excerpts/2012_05_30_19_00_1.webm;Yoshihiko Noda.jpg;1429;1429;14149;47;47;0
/net/per920a/export/das14a/satoh-lab/haolin/nhk/excerpts/2012_05_30_19_00_1.webm;Yoshihiko Noda.jpg;1453;1789;14149;48;59;11
/net/per920a/export/das14a/satoh-lab/haolin/nhk/excerpts/2012_05_30_19_00_1.webm;Yoshihiko Noda.jpg;1801;1877;14149;60;62;2
/net/per920a/export/das14a/satoh-lab/haolin/nhk/excerpts/2012_05_30_19_00_1.webm;Yoshihiko Noda.jpg;1889;1901;14149;63;63;0
/net/per920a/export/das14a/satoh-lab/haolin/nhk/excerpts/2012_05_30_19_00_1.webm;Yoshihiko Noda.jpg;1917;2113;14149;63;70;7
/net/per920a/export/das14a/satoh-lab/haolin/nhk/excerpts/2012_05_30_19_00_1.webm;Yoshihiko Noda.jpg;2125;2145;14149;70;71;1
/net/per920a/export/das14a/satoh-lab/haolin/nhk/excerpts/2012_05_30_19_00_1.webm;Yoshihiko Noda.jpg;2157;2157;14149;71;71;0
/net/per920a/export/das14a/satoh-lab/haolin/nhk/excerpts/2012_05_30_19_00_1.webm;Yoshihiko Noda.jpg;2173;2173;14149;72;72;0
/net/per920a/export/das14a/satoh-lab/haolin/nhk/excerpts/2012_05_30_19_00_1.webm;Yoshihiko Noda.jpg;2185;2185;14149;72;72;0
/net/per920a/export/das14a/satoh-lab/haolin/nhk/excerpts/2012_05_30_19_00_1.webm;Yoshihiko Noda.jpg;2201;2205;14149;73;73;0
/net/per920a/export/das14a/satoh-lab/haolin/nhk/excerpts/2012_05_30_19_00_1.webm;Yoshihiko Noda.jpg;2225;2237;14149;74;74;0
/net/per920a/export/das14a/satoh-lab/haolin/nhk/excerpts/2012_05_30_19_00_1.webm;Yoshihiko Noda.jpg;4277;4329;14149;142;144;2
/net/per920a/export/das14a/satoh-lab/haolin/nhk/excerpts/2012_05_30_19_00_1.webm;Yoshihiko Noda.jpg;4341;4485;14149;144;149;5
/net/per920a/export/das14a/satoh-lab/haolin/nhk/excerpts/2012_05_30_19_00_1.webm;Yoshihiko Noda.jpg;4545;4617;14149;151;154;3
/net/per920a/export/das14a/satoh-lab/haolin/nhk/excerpts/2012_05_30_19_00_1.webm;Yoshihiko Noda.jpg;4629;5101;14149;154;170;16
/net/per920a/export/das14a/satoh-lab/haolin/nhk/excerpts/2012_05_30_19_00_1.webm;Yoshihiko Noda.jpg;5113;5129;14149;170;171;1
/net/per920a/export/das14a/satoh-lab/haolin/nhk/excerpts/2012_05_30_19_00_1.webm;Yoshihiko Noda.jpg;5145;5217;14149;171;174;3
/net/per920a/export/das14a/satoh-lab/haolin/nhk/excerpts/2012_05_30_19_00_1.webm;Yoshihiko Noda.jpg;5285;5313;14149;176;177;1
/net/per920a/export/das14a/satoh-lab/haolin/nhk/excerpts/2012_05_30_19_00_1.webm;Yoshihiko Noda.jpg;5329;5333;14149;177;177;0
/net/per920a/export/das14a/satoh-lab/haolin/nhk/excerpts/2012_05_30_19_00_1.webm;Yoshihiko Noda.jpg;5369;5385;14149;179;179;0
/net/per920a/export/das14a/satoh-lab/haolin/nhk/excerpts/2012_05_30_19_00_1.webm;Yoshihiko Noda.jpg;5401;5513;14149;180;183;3
/net/per920a/export/das14a/satoh-lab/haolin/nhk/excerpts/2012_05_30_19_00_1.webm;Yoshihiko Noda.jpg;5525;5937;14149;184;198;14
/net/per920a/export/das14a/satoh-lab/haolin/nhk/excerpts/2012_05_30_19_00_1.webm;Yoshihiko Noda.jpg;11329;11373;14149;377;379;2
/net/per920a/export/das14a/satoh-lab/haolin/nhk/excerpts/2012_05_30_19_00_1.webm;Yoshihiko Noda.jpg;11389;11613;14149;379;387;8
/net/per920a/export/das14a/satoh-lab/haolin/nhk/excerpts/2012_05_30_19_00_1.webm;Yoshihiko Noda.jpg;11625;11633;14149;387;388;1
/net/per920a/export/das14a/satoh-lab/haolin/nhk/excerpts/2012_05_30_19_00_1.webm;Yoshihiko Noda.jpg;11645;11645;14149;388;388;0
/net/per920a/export/das14a/satoh-lab/haolin/nhk/excerpts/2012_05_30_19_00_1.webm;Yoshihiko Noda.jpg;11661;11685;14149;389;389;0
/net/per920a/export/das14a/satoh-lab/haolin/nhk/excerpts/2012_05_30_19_00_1.webm;Yoshihiko Noda.jpg;11741;11753;14149;391;392;1
/net/per920a/export/das14a/satoh-lab/haolin/nhk/excerpts/2012_05_30_19_00_1.webm;Yoshihiko Noda.jpg;11765;11797;14149;392;393;1
/net/per920a/export/das14a/satoh-lab/haolin/nhk/excerpts/2012_05_30_19_00_1.webm;Yoshihiko Noda.jpg;11813;11853;14149;394;395;1
/net/per920a/export/das14a/satoh-lab/haolin/nhk/excerpts/2012_05_30_19_00_1.webm;Yoshihiko Noda.jpg;11893;11897;14149;396;396;0
/net/per920a/export/das14a/satoh-lab/haolin/nhk/excerpts/2012_05_30_19_00_1.webm;Yoshihiko Noda.jpg;13573;13909;14149;452;463;11
/net/per920a/export/das14a/satoh-lab/haolin/nhk/excerpts/2012_05_30_19_00_1.webm;Seiji MAEHARA.jpg;7321;7321;14149;244;244;0
/net/per920a/export/das14a/satoh-lab/haolin/nhk/excerpts/2012_05_30_19_00_1.webm;Seiji MAEHARA.jpg;7337;7337;14149;244;244;0
/net/per920a/export/das14a/satoh-lab/haolin/nhk/excerpts/2012_05_30_19_00_1.webm;Seiji MAEHARA.jpg;7373;7377;14149;245;246;1
/net/per920a/export/das14a/satoh-lab/haolin/nhk/excerpts/2012_05_30_19_00_1.webm;Seiji MAEHARA.jpg;7393;8801;14149;246;293;47
/net/per920a/export/das14a/satoh-lab/haolin/nhk/excerpts/2012_06_02_19_00_1.webm;Yoshihiko Noda.jpg;2101;2105;5493;69;70;1
/net/per920a/export/das14a/satoh-lab/haolin/nhk/excerpts/2012_06_02_19_00_1.webm;Yoshihiko Noda.jpg;2153;2169;5493;71;72;1
/net/per920a/export/das14a/satoh-lab/haolin/nhk/excerpts/2012_06_02_19_00_1.webm;Yoshihiko Noda.jpg;2185;2201;5493;72;73;1
/net/per920a/export/das14a/satoh-lab/haolin/nhk/excerpts/2012_06_02_19_00_1.webm;Yoshihiko Noda.jpg;2473;2509;5493;82;83;1
/net/per920a/export/das14a/satoh-lab/haolin/nhk/excerpts/2012_06_02_19_00_1.webm;Yoshihiko Noda.jpg;2529;2537;5493;84;84;0
/net/per920a/export/das14a/satoh-lab/haolin/nhk/excerpts/2012_06_02_19_00_1.webm;Yoshihiko Noda.jpg;2553;2737;5493;85;91;6
/net/per920a/export/das14a/satoh-lab/haolin/nhk/excerpts/2012_06_02_19_00_1.webm;Yoshihiko Noda.jpg;2753;2761;5493;91;91;0
/net/per920a/export/das14a/satoh-lab/haolin/nhk/excerpts/2012_06_02_19_00_1.webm;Ichiro OZAWA.jpg;2289;2461;5493;76;81;5
/net/per920a/export/das14a/satoh-lab/haolin/nhk/excerpts/2012_06_02_19_00_1.webm;Ichiro OZAWA.jpg;2473;2509;5493;82;83;1
/net/per920a/export/das14a/satoh-lab/haolin/nhk/excerpts/2012_06_02_19_00_1.webm;Ichiro OZAWA.jpg;2529;2537;5493;84;84;0
/net/per920a/export/das14a/satoh-lab/haolin/nhk/excerpts/2012_06_02_19_00_1.webm;Ichiro OZAWA.jpg;2553;2737;5493;85;91;6
/net/per920a/export/das14a/satoh-lab/haolin/nhk/excerpts/2012_06_02_19_00_1.webm;Ichiro OZAWA.jpg;2753;2761;5493;91;91;0
/net/per920a/export/das14a/satoh-lab/haolin/nhk/excerpts/2012_06_02_19_00_1.webm;Katsuya OKADA.jpg;2773;3353;5493;92;111;19
/net/per920a/export/das14a/satoh-lab/haolin/nhk/excerpts/2012_06_03_19_00_1.webm;Ichiro OZAWA.jpg;121;1001;15289;4;33;29
/net/per920a/export/das14a/satoh-lab/haolin/nhk/excerpts/2012_06_03_19_00_1.webm;Ichiro OZAWA.jpg;1065;1085;15289;35;36;1
/net/per920a/export/das14a/satoh-lab/haolin/nhk/excerpts/2012_06_03_19_00_1.webm;Ichiro OZAWA.jpg;1101;1313;15289;36;43;7
/net/per920a/export/das14a/satoh-lab/haolin/nhk/excerpts/2012_06_03_19_00_1.webm;Ichiro OZAWA.jpg;2105;2121;15289;70;70;0
/net/per920a/export/das14a/satoh-lab/haolin/nhk/excerpts/2012_06_03_19_00_1.webm;Ichiro OZAWA.jpg;2141;2145;15289;71;71;0
/net/per920a/export/das14a/satoh-lab/haolin/nhk/excerpts/2012_06_03_19_00_1.webm;Ichiro OZAWA.jpg;2173;2173;15289;72;72;0
/net/per920a/export/das14a/satoh-lab/haolin/nhk/excerpts/2012_06_03_19_00_1.webm;Ichiro OZAWA.jpg;2205;2209;15289;73;73;0
/net/per920a/export/das14a/satoh-lab/haolin/nhk/excerpts/2012_06_03_19_00_1.webm;Ichiro OZAWA.jpg;2221;2221;15289;74;74;0
/net/per920a/export/das14a/satoh-lab/haolin/nhk/excerpts/2012_06_03_19_00_1.webm;Ichiro OZAWA.jpg;2233;2241;15289;74;74;0
/net/per920a/export/das14a/satoh-lab/haolin/nhk/excerpts/2012_06_03_19_00_1.webm;Ichiro OZAWA.jpg;2253;2253;15289;75;75;0
/net/per920a/export/das14a/satoh-lab/haolin/nhk/excerpts/2012_06_03_19_00_1.webm;Ichiro OZAWA.jpg;2289;2749;15289;76;91;15
/net/per920a/export/das14a/satoh-lab/haolin/nhk/excerpts/2012_06_03_19_00_1.webm;Ichiro OZAWA.jpg;2893;2905;15289;96;96;0
/net/per920a/export/das14a/satoh-lab/haolin/nhk/excerpts/2012_06_03_19_00_1.webm;Ichiro OZAWA.jpg;10077;10105;15289;336;337;1
/net/per920a/export/das14a/satoh-lab/haolin/nhk/excerpts/2012_06_03_19_00_1.webm;Ichiro OZAWA.jpg;10117;10117;15289;337;337;0
/net/per920a/export/das14a/satoh-lab/haolin/nhk/excerpts/2012_06_03_19_00_1.webm;Ichiro OZAWA.jpg;10129;10133;15289;337;338;1
/net/per920a/export/das14a/satoh-lab/haolin/nhk/excerpts/2012_06_03_19_00_1.webm;Yoshihiko Noda.jpg;145;1001;15289;4;33;29
/net/per920a/export/das14a/satoh-lab/haolin/nhk/excerpts/2012_06_03_19_00_1.webm;Yoshihiko Noda.jpg;1325;1397;15289;44;46;2
/net/per920a/export/das14a/satoh-lab/haolin/nhk/excerpts/2012_06_03_19_00_1.webm;Yoshihiko Noda.jpg;1717;1737;15289;57;57;0
/net/per920a/export/das14a/satoh-lab/haolin/nhk/excerpts/2012_06_03_19_00_1.webm;Yoshihiko Noda.jpg;1849;1873;15289;61;62;1
/net/per920a/export/das14a/satoh-lab/haolin/nhk/excerpts/2012_06_03_19_00_1.webm;Yoshihiko Noda.jpg;1889;1893;15289;63;63;0
/net/per920a/export/das14a/satoh-lab/haolin/nhk/excerpts/2012_06_03_19_00_1.webm;Yoshihiko Noda.jpg;2289;2749;15289;76;91;15
/net/per920a/export/das14a/satoh-lab/haolin/nhk/excerpts/2012_06_03_19_00_1.webm;Yoshihiko Noda.jpg;3473;3557;15289;115;118;3
/net/per920a/export/das14a/satoh-lab/haolin/nhk/excerpts/2012_06_03_19_00_1.webm;Yoshihiko Noda.jpg;3569;3597;15289;119;119;0
/net/per920a/export/das14a/satoh-lab/haolin/nhk/excerpts/2012_06_03_19_00_1.webm;Yoshihiko Noda.jpg;3625;3637;15289;120;121;1
/net/per920a/export/das14a/satoh-lab/haolin/nhk/excerpts/2012_06_03_19_00_1.webm;Yoshihiko Noda.jpg;3649;3653;15289;121;121;0
/net/per920a/export/das14a/satoh-lab/haolin/nhk/excerpts/2012_06_03_19_00_1.webm;Yoshihiko Noda.jpg;3665;3693;15289;122;123;1
/net/per920a/export/das14a/satoh-lab/haolin/nhk/excerpts/2012_06_03_19_00_1.webm;Yoshihiko Noda.jpg;3705;4693;15289;123;156;33
/net/per920a/export/das14a/satoh-lab/haolin/nhk/excerpts/2012_06_03_19_00_1.webm;Yoshihiko Noda.jpg;8969;8989;15289;299;299;0
/net/per920a/export/das14a/satoh-lab/haolin/nhk/excerpts/2012_06_03_19_00_1.webm;Yoshihiko Noda.jpg;9005;9081;15289;300;302;2
/net/per920a/export/das14a/satoh-lab/haolin/nhk/excerpts/2012_06_03_19_00_1.webm;Yoshihiko Noda.jpg;9097;9097;15289;303;303;0
/net/per920a/export/das14a/satoh-lab/haolin/nhk/excerpts/2012_06_03_19_00_1.webm;Yoshihiko Noda.jpg;9121;9121;15289;304;304;0
/net/per920a/export/das14a/satoh-lab/haolin/nhk/excerpts/2012_06_03_19_00_1.webm;Yoshihiko Noda.jpg;9133;9133;15289;304;304;0
/net/per920a/export/das14a/satoh-lab/haolin/nhk/excerpts/2012_06_03_19_00_1.webm;Yoshihiko Noda.jpg;9201;9201;15289;306;306;0
/net/per920a/export/das14a/satoh-lab/haolin/nhk/excerpts/2012_06_03_19_00_1.webm;Yoshihiko Noda.jpg;9237;9245;15289;308;308;0
/net/per920a/export/das14a/satoh-lab/haolin/nhk/excerpts/2012_06_03_19_00_1.webm;Yoshihiko Noda.jpg;9261;9293;15289;308;309;1
/net/per920a/export/das14a/satoh-lab/haolin/nhk/excerpts/2012_06_03_19_00_1.webm;Yoshihiko Noda.jpg;9329;9333;15289;311;311;0
/net/per920a/export/das14a/satoh-lab/haolin/nhk/excerpts/2012_06_03_19_00_1.webm;Yoshihiko Noda.jpg;9345;9345;15289;311;311;0
/net/per920a/export/das14a/satoh-lab/haolin/nhk/excerpts/2012_06_03_19_00_1.webm;Yoshihiko Noda.jpg;9361;9361;15289;312;312;0
/net/per920a/export/das14a/satoh-lab/haolin/nhk/excerpts/2012_06_03_19_00_1.webm;Yoshihiko Noda.jpg;9749;9757;15289;325;325;0
/net/per920a/export/das14a/satoh-lab/haolin/nhk/excerpts/2012_06_03_19_00_1.webm;Yoshihiko Noda.jpg;10221;10773;15289;340;359;19
/net/per920a/export/das14a/satoh-lab/haolin/nhk/excerpts/2012_06_03_19_00_1.webm;Yoshihiko Noda.jpg;10785;10797;15289;359;360;1
/net/per920a/export/das14a/satoh-lab/haolin/nhk/excerpts/2012_06_03_19_00_1.webm;Yoshihiko Noda.jpg;10813;10877;15289;360;362;2
/net/per920a/export/das14a/satoh-lab/haolin/nhk/excerpts/2012_06_03_19_00_1.webm;Yoshihiko Noda.jpg;10917;10917;15289;364;364;0
/net/per920a/export/das14a/satoh-lab/haolin/nhk/excerpts/2012_06_03_19_00_1.webm;Yoshihiko Noda.jpg;10949;10949;15289;365;365;0
/net/per920a/export/das14a/satoh-lab/haolin/nhk/excerpts/2012_06_03_19_00_1.webm;Yoshihiko Noda.jpg;10973;10977;15289;366;366;0
/net/per920a/export/das14a/satoh-lab/haolin/nhk/excerpts/2012_06_03_19_00_1.webm;Yoshihiko Noda.jpg;12505;12517;15289;417;417;0
/net/per920a/export/das14a/satoh-lab/haolin/nhk/excerpts/2012_06_03_19_00_1.webm;Yoshihiko Noda.jpg;12541;12641;15289;418;421;3
/net/per920a/export/das14a/satoh-lab/haolin/nhk/excerpts/2012_06_03_19_00_1.webm;Yoshihiko Noda.jpg;12673;12673;15289;422;422;0
/net/per920a/export/das14a/satoh-lab/haolin/nhk/excerpts/2012_06_03_19_00_1.webm;Yoshihiko Noda.jpg;12697;12697;15289;423;423;0
/net/per920a/export/das14a/satoh-lab/haolin/nhk/excerpts/2012_06_03_19_00_1.webm;Yoshihiko Noda.jpg;12717;12725;15289;424;424;0
/net/per920a/export/das14a/satoh-lab/haolin/nhk/excerpts/2012_06_03_19_00_1.webm;Yoshihiko Noda.jpg;12741;12741;15289;425;425;0
/net/per920a/export/das14a/satoh-lab/haolin/nhk/excerpts/2012_06_03_19_00_1.webm;Yoshihiko Noda.jpg;14633;14773;15289;488;492;4
/net/per920a/export/das14a/satoh-lab/haolin/nhk/excerpts/2012_06_03_19_00_1.webm;Yoshihiko Noda.jpg;14833;14841;15289;494;495;1
/net/per920a/export/das14a/satoh-lab/haolin/nhk/excerpts/2012_06_03_19_00_1.webm;Yoshihiko Noda.jpg;14881;14889;15289;496;496;0
/net/per920a/export/das14a/satoh-lab/haolin/nhk/excerpts/2012_06_03_19_00_1.webm;Yoshihiko Noda.jpg;14901;14901;15289;497;497;0
/net/per920a/export/das14a/satoh-lab/haolin/nhk/excerpts/2012_06_03_19_00_1.webm;Yoshihiko Noda.jpg;14913;14913;15289;497;497;0
/net/per920a/export/das14a/satoh-lab/haolin/nhk/excerpts/2012_06_03_19_00_1.webm;Yoshihiko Noda.jpg;14925;14933;15289;497;498;1
/net/per920a/export/das14a/satoh-lab/haolin/nhk/excerpts/2012_06_03_19_00_1.webm;Yoshihiko Noda.jpg;14969;14981;15289;499;499;0
/net/per920a/export/das14a/satoh-lab/haolin/nhk/excerpts/2012_06_03_19_00_1.webm;Yoshihiko Noda.jpg;15009;15089;15289;500;503;3
/net/per920a/export/das14a/satoh-lab/haolin/nhk/excerpts/2012_06_08_19_00_1.webm;Yoshihiko Noda.jpg;9;897;2101;0;29;29
/net/per920a/export/das14a/satoh-lab/haolin/nhk/excerpts/2012_06_08_19_00_1.webm;Yoshihiko Noda.jpg;965;965;2101;32;32;0
/net/per920a/export/das14a/satoh-lab/haolin/nhk/excerpts/2012_06_08_19_00_1.webm;Yoshihiko Noda.jpg;985;2097;2101;32;69;37
/net/per920a/export/das14a/satoh-lab/haolin/nhk/excerpts/2012_06_26_19_00_1.webm;Yoshihiko Noda.jpg;9;797;23805;0;26;26
/net/per920a/export/das14a/satoh-lab/haolin/nhk/excerpts/2012_06_26_19_00_1.webm;Yoshihiko Noda.jpg;1141;1165;23805;38;38;0
/net/per920a/export/das14a/satoh-lab/haolin/nhk/excerpts/2012_06_26_19_00_1.webm;Yoshihiko Noda.jpg;1177;1181;23805;39;39;0
/net/per920a/export/das14a/satoh-lab/haolin/nhk/excerpts/2012_06_26_19_00_1.webm;Yoshihiko Noda.jpg;1193;1209;23805;39;40;1
/net/per920a/export/das14a/satoh-lab/haolin/nhk/excerpts/2012_06_26_19_00_1.webm;Yoshihiko Noda.jpg;1793;2049;23805;59;68;9
/net/per920a/export/das14a/satoh-lab/haolin/nhk/excerpts/2012_06_26_19_00_1.webm;Yoshihiko Noda.jpg;4641;4653;23805;154;155;1
/net/per920a/export/das14a/satoh-lab/haolin/nhk/excerpts/2012_06_26_19_00_1.webm;Yoshihiko Noda.jpg;4681;4717;23805;156;157;1
/net/per920a/export/das14a/satoh-lab/haolin/nhk/excerpts/2012_06_26_19_00_1.webm;Yoshihiko Noda.jpg;6165;6245;23805;205;208;3
/net/per920a/export/das14a/satoh-lab/haolin/nhk/excerpts/2012_06_26_19_00_1.webm;Yoshihiko Noda.jpg;6989;6993;23805;233;233;0
/net/per920a/export/das14a/satoh-lab/haolin/nhk/excerpts/2012_06_26_19_00_1.webm;Yoshihiko Noda.jpg;7009;7017;23805;233;234;1
/net/per920a/export/das14a/satoh-lab/haolin/nhk/excerpts/2012_06_26_19_00_1.webm;Yoshihiko Noda.jpg;7029;7033;23805;234;234;0
/net/per920a/export/das14a/satoh-lab/haolin/nhk/excerpts/2012_06_26_19_00_1.webm;Yoshihiko Noda.jpg;9713;9717;23805;323;324;1
/net/per920a/export/das14a/satoh-lab/haolin/nhk/excerpts/2012_06_26_19_00_1.webm;Yoshihiko Noda.jpg;9737;9737;23805;324;324;0
/net/per920a/export/das14a/satoh-lab/haolin/nhk/excerpts/2012_06_26_19_00_1.webm;Yoshihiko Noda.jpg;9753;9753;23805;325;325;0
/net/per920a/export/das14a/satoh-lab/haolin/nhk/excerpts/2012_06_26_19_00_1.webm;Yoshihiko Noda.jpg;9765;9773;23805;325;325;0
/net/per920a/export/das14a/satoh-lab/haolin/nhk/excerpts/2012_06_26_19_00_1.webm;Yoshihiko Noda.jpg;14737;14737;23805;491;491;0
/net/per920a/export/das14a/satoh-lab/haolin/nhk/excerpts/2012_06_26_19_00_1.webm;Yoshihiko Noda.jpg;14757;14761;23805;492;492;0
/net/per920a/export/das14a/satoh-lab/haolin/nhk/excerpts/2012_06_26_19_00_1.webm;Yoshihiko Noda.jpg;14777;16293;23805;492;543;51
/net/per920a/export/das14a/satoh-lab/haolin/nhk/excerpts/2012_06_26_19_00_1.webm;Yoshihiko Noda.jpg;16313;16373;23805;544;546;2
/net/per920a/export/das14a/satoh-lab/haolin/nhk/excerpts/2012_06_26_19_00_1.webm;Yoshihiko Noda.jpg;16393;18949;23805;546;632;86
/net/per920a/export/das14a/satoh-lab/haolin/nhk/excerpts/2012_06_26_19_00_1.webm;Yoshihiko Noda.jpg;18961;19073;23805;632;636;4
/net/per920a/export/das14a/satoh-lab/haolin/nhk/excerpts/2012_06_26_19_00_1.webm;Yoshihiko Noda.jpg;19089;19109;23805;636;637;1
/net/per920a/export/das14a/satoh-lab/haolin/nhk/excerpts/2012_06_26_19_00_1.webm;Yoshihiko Noda.jpg;19125;19169;23805;637;639;2
/net/per920a/export/das14a/satoh-lab/haolin/nhk/excerpts/2012_06_26_19_00_1.webm;Yoshihiko Noda.jpg;19193;19201;23805;640;640;0
/net/per920a/export/das14a/satoh-lab/haolin/nhk/excerpts/2012_06_26_19_00_1.webm;Yoshihiko Noda.jpg;19237;19253;23805;641;642;1
/net/per920a/export/das14a/satoh-lab/haolin/nhk/excerpts/2012_06_26_19_00_1.webm;Yoshihiko Noda.jpg;19269;19273;23805;642;642;0
/net/per920a/export/das14a/satoh-lab/haolin/nhk/excerpts/2012_06_26_19_00_1.webm;Yoshihiko Noda.jpg;19289;19345;23805;643;645;2
/net/per920a/export/das14a/satoh-lab/haolin/nhk/excerpts/2012_06_26_19_00_1.webm;Yoshihiko Noda.jpg;19881;19949;23805;663;665;2
/net/per920a/export/das14a/satoh-lab/haolin/nhk/excerpts/2012_06_26_19_00_1.webm;Yoshihiko Noda.jpg;20005;20225;23805;667;674;7
/net/per920a/export/das14a/satoh-lab/haolin/nhk/excerpts/2012_06_26_19_00_1.webm;Yoshihiko Noda.jpg;20661;20669;23805;689;689;0
/net/per920a/export/das14a/satoh-lab/haolin/nhk/excerpts/2012_06_26_19_00_1.webm;Yoshihiko Noda.jpg;20681;20685;23805;689;689;0
/net/per920a/export/das14a/satoh-lab/haolin/nhk/excerpts/2012_06_26_19_00_1.webm;Yoshihiko Noda.jpg;21317;21325;23805;711;711;0
/net/per920a/export/das14a/satoh-lab/haolin/nhk/excerpts/2012_06_26_19_00_1.webm;Yoshihiko Noda.jpg;21337;21417;23805;711;714;3
/net/per920a/export/das14a/satoh-lab/haolin/nhk/excerpts/2012_06_26_19_00_1.webm;Yoshihiko Noda.jpg;21433;21437;23805;714;715;1
/net/per920a/export/das14a/satoh-lab/haolin/nhk/excerpts/2012_06_26_19_00_1.webm;Yoshihiko Noda.jpg;21453;21485;23805;715;716;1
/net/per920a/export/das14a/satoh-lab/haolin/nhk/excerpts/2012_06_26_19_00_1.webm;Ichiro OZAWA.jpg;9;797;23805;0;26;26
/net/per920a/export/das14a/satoh-lab/haolin/nhk/excerpts/2012_06_26_19_00_1.webm;Ichiro OZAWA.jpg;4613;4613;23805;153;153;0
/net/per920a/export/das14a/satoh-lab/haolin/nhk/excerpts/2012_06_26_19_00_1.webm;Ichiro OZAWA.jpg;9013;9013;23805;300;300;0
/net/per920a/export/das14a/satoh-lab/haolin/nhk/excerpts/2012_06_26_19_00_1.webm;Ichiro OZAWA.jpg;9057;9189;23805;302;306;4
/net/per920a/export/das14a/satoh-lab/haolin/nhk/excerpts/2012_06_26_19_00_1.webm;Ichiro OZAWA.jpg;9229;9337;23805;307;311;4
/net/per920a/export/das14a/satoh-lab/haolin/nhk/excerpts/2012_06_26_19_00_1.webm;Ichiro OZAWA.jpg;10449;12057;23805;348;402;54
/net/per920a/export/das14a/satoh-lab/haolin/nhk/excerpts/2012_06_26_19_00_1.webm;Ichiro OZAWA.jpg;12073;14433;23805;402;481;79
/net/per920a/export/das14a/satoh-lab/haolin/nhk/excerpts/2012_06_26_19_00_1.webm;Ichiro OZAWA.jpg;14449;14681;23805;481;489;8
/net/per920a/export/das14a/satoh-lab/haolin/nhk/excerpts/2012_06_26_19_00_1.webm;Ichiro OZAWA.jpg;18961;19073;23805;632;636;4
/net/per920a/export/das14a/satoh-lab/haolin/nhk/excerpts/2012_06_26_19_00_1.webm;Ichiro OZAWA.jpg;19089;19109;23805;636;637;1
/net/per920a/export/das14a/satoh-lab/haolin/nhk/excerpts/2012_06_26_19_00_1.webm;Ichiro OZAWA.jpg;19125;19169;23805;637;639;2
/net/per920a/export/das14a/satoh-lab/haolin/nhk/excerpts/2012_06_26_19_00_1.webm;Ichiro OZAWA.jpg;19193;19201;23805;640;640;0
/net/per920a/export/das14a/satoh-lab/haolin/nhk/excerpts/2012_06_26_19_00_1.webm;Ichiro OZAWA.jpg;19237;19253;23805;641;642;1
/net/per920a/export/das14a/satoh-lab/haolin/nhk/excerpts/2012_06_26_19_00_1.webm;Ichiro OZAWA.jpg;19269;19273;23805;642;642;0
/net/per920a/export/das14a/satoh-lab/haolin/nhk/excerpts/2012_06_26_19_00_1.webm;Ichiro OZAWA.jpg;19289;19345;23805;643;645;2
/net/per920a/export/das14a/satoh-lab/haolin/nhk/excerpts/2012_06_26_19_00_1.webm;Ichiro OZAWA.jpg;21317;21325;23805;711;711;0
/net/per920a/export/das14a/satoh-lab/haolin/nhk/excerpts/2012_06_26_19_00_1.webm;Ichiro OZAWA.jpg;21337;21417;23805;711;714;3
/net/per920a/export/das14a/satoh-lab/haolin/nhk/excerpts/2012_06_26_19_00_1.webm;Ichiro OZAWA.jpg;21433;21437;23805;714;715;1
/net/per920a/export/das14a/satoh-lab/haolin/nhk/excerpts/2012_06_26_19_00_1.webm;Ichiro OZAWA.jpg;21453;21485;23805;715;716;1
/net/per920a/export/das14a/satoh-lab/haolin/nhk/excerpts/2012_06_26_19_00_1.webm;Ichiro OZAWA.jpg;21709;21709;23805;724;724;0
/net/per920a/export/das14a/satoh-lab/haolin/nhk/excerpts/2012_06_26_19_00_1.webm;Ichiro OZAWA.jpg;22105;22105;23805;737;737;0
/net/per920a/export/das14a/satoh-lab/haolin/nhk/excerpts/2012_06_26_19_00_1.webm;Ichiro OZAWA.jpg;22117;22117;23805;737;737;0
/net/per920a/export/das14a/satoh-lab/haolin/nhk/excerpts/2012_06_26_19_00_1.webm;Ichiro OZAWA.jpg;22165;22169;23805;739;739;0
/net/per920a/export/das14a/satoh-lab/haolin/nhk/excerpts/2012_06_26_19_00_1.webm;Ichiro OZAWA.jpg;22185;22185;23805;739;739;0
/net/per920a/export/das14a/satoh-lab/haolin/nhk/excerpts/2012_06_26_19_00_1.webm;Ichiro OZAWA.jpg;22209;22209;23805;740;740;0
/net/per920a/export/das14a/satoh-lab/haolin/nhk/excerpts/2012_06_26_19_00_1.webm;Ichiro OZAWA.jpg;22261;22273;23805;742;742;0
/net/per920a/export/das14a/satoh-lab/haolin/nhk/excerpts/2012_06_26_19_00_1.webm;Ichiro OZAWA.jpg;22289;22289;23805;743;743;0
/net/per920a/export/das14a/satoh-lab/haolin/nhk/excerpts/2012_06_26_19_00_1.webm;Ichiro OZAWA.jpg;22361;22385;23805;745;746;1
/net/per920a/export/das14a/satoh-lab/haolin/nhk/excerpts/2012_06_26_19_00_1.webm;Ichiro OZAWA.jpg;22569;22573;23805;752;752;0
/net/per920a/export/das14a/satoh-lab/haolin/nhk/excerpts/2012_06_26_19_00_1.webm;Yukio HATOYAMA.jpg;7109;7113;23805;237;237;0
/net/per920a/export/das14a/satoh-lab/haolin/nhk/excerpts/2012_06_26_19_00_1.webm;Yukio HATOYAMA.jpg;7237;7241;23805;241;241;0
/net/per920a/export/das14a/satoh-lab/haolin/nhk/excerpts/2012_06_26_19_00_1.webm;Yukio HATOYAMA.jpg;7253;7261;23805;241;242;1
/net/per920a/export/das14a/satoh-lab/haolin/nhk/excerpts/2012_06_26_19_00_1.webm;Yukio HATOYAMA.jpg;7293;7317;23805;243;244;1
/net/per920a/export/das14a/satoh-lab/haolin/nhk/excerpts/2012_06_26_19_00_1.webm;Seiji MAEHARA.jpg;21177;21189;23805;706;706;0
/net/per920a/export/das14a/satoh-lab/haolin/nhk/excerpts/2012_06_26_19_00_1.webm;Seiji MAEHARA.jpg;21201;21201;23805;707;707;0
/net/per920a/export/das14a/satoh-lab/haolin/nhk/excerpts/2012_06_30_19_00_1.webm;Ichiro OZAWA.jpg;1013;2541;8573;33;84;51
/net/per920a/export/das14a/satoh-lab/haolin/nhk/excerpts/2012_06_30_19_00_1.webm;Ichiro OZAWA.jpg;2613;2613;8573;87;87;0
/net/per920a/export/das14a/satoh-lab/haolin/nhk/excerpts/2012_06_30_19_00_1.webm;Ichiro OZAWA.jpg;2629;2641;8573;87;88;1
/net/per920a/export/das14a/satoh-lab/haolin/nhk/excerpts/2012_06_30_19_00_1.webm;Yoshihiko Noda.jpg;6585;8569;8573;219;285;66
/net/per920a/export/das14a/satoh-lab/haolin/nhk/excerpts/2012_07_03_19_00_3.webm;Ichiro OZAWA.jpg;9;805;10257;0;26;26
/net/per920a/export/das14a/satoh-lab/haolin/nhk/excerpts/2012_07_03_19_00_3.webm;Ichiro OZAWA.jpg;2117;2165;10257;70;72;2
/net/per920a/export/das14a/satoh-lab/haolin/nhk/excerpts/2012_07_03_19_00_3.webm;Ichiro OZAWA.jpg;2177;2189;10257;72;72;0
/net/per920a/export/das14a/satoh-lab/haolin/nhk/excerpts/2012_07_03_19_00_3.webm;Ichiro OZAWA.jpg;2201;2257;10257;73;75;2
/net/per920a/export/das14a/satoh-lab/haolin/nhk/excerpts/2012_07_03_19_00_3.webm;Ichiro OZAWA.jpg;2817;3201;10257;93;106;13
/net/per920a/export/das14a/satoh-lab/haolin/nhk/excerpts/2012_07_03_19_00_3.webm;Ichiro OZAWA.jpg;5709;5725;10257;190;190;0
/net/per920a/export/das14a/satoh-lab/haolin/nhk/excerpts/2012_07_03_19_00_3.webm;Ichiro OZAWA.jpg;5745;5745;10257;191;191;0
/net/per920a/export/das14a/satoh-lab/haolin/nhk/excerpts/2012_07_03_19_00_3.webm;Ichiro OZAWA.jpg;5861;5873;10257;195;195;0
/net/per920a/export/das14a/satoh-lab/haolin/nhk/excerpts/2012_07_03_19_00_3.webm;Ichiro OZAWA.jpg;5889;5893;10257;196;196;0
/net/per920a/export/das14a/satoh-lab/haolin/nhk/excerpts/2012_07_03_19_00_3.webm;Ichiro OZAWA.jpg;6105;6185;10257;203;206;3
/net/per920a/export/das14a/satoh-lab/haolin/nhk/excerpts/2012_07_03_19_00_3.webm;Ichiro OZAWA.jpg;6217;6237;10257;207;207;0
/net/per920a/export/das14a/satoh-lab/haolin/nhk/excerpts/2012_07_03_19_00_3.webm;Ichiro OZAWA.jpg;6637;6673;10257;221;222;1
/net/per920a/export/das14a/satoh-lab/haolin/nhk/excerpts/2012_07_03_19_00_3.webm;Yoshihiko Noda.jpg;965;1073;10257;32;35;3
/net/per920a/export/das14a/satoh-lab/haolin/nhk/excerpts/2012_07_03_19_00_3.webm;Yoshihiko Noda.jpg;1241;1473;10257;41;49;8
/net/per920a/export/das14a/satoh-lab/haolin/nhk/excerpts/2012_07_03_19_00_3.webm;Yoshihiko Noda.jpg;10173;10253;10257;339;341;2
/net/per920a/export/das14a/satoh-lab/haolin/nhk/excerpts/2012_07_03_19_00_3.webm;Kazuo SHII.jpg;3525;3601;10257;117;120;3
/net/per920a/export/das14a/satoh-lab/haolin/nhk/excerpts/2012_07_03_19_00_3.webm;Kazuo SHII.jpg;4069;4145;10257;135;138;3
/net/per920a/export/das14a/satoh-lab/haolin/nhk/excerpts/2012_07_03_19_00_3.webm;Kazuo SHII.jpg;5693;5725;10257;189;190;1
/net/per920a/export/das14a/satoh-lab/haolin/nhk/excerpts/2012_07_03_19_00_3.webm;Kazuo SHII.jpg;5809;5829;10257;193;194;1
/net/per920a/export/das14a/satoh-lab/haolin/nhk/excerpts/2012_07_03_19_00_3.webm;Kazuo SHII.jpg;5861;5873;10257;195;195;0
/net/per920a/export/das14a/satoh-lab/haolin/nhk/excerpts/2012_07_03_19_00_3.webm;Seiji MAEHARA.jpg;7113;7117;10257;237;237;0
/net/per920a/export/das14a/satoh-lab/haolin/nhk/excerpts/2012_07_03_19_00_3.webm;Seiji MAEHARA.jpg;7129;7137;10257;237;237;0
/net/per920a/export/das14a/satoh-lab/haolin/nhk/excerpts/2012_07_03_19_00_3.webm;Seiji MAEHARA.jpg;7149;7161;10257;238;238;0
/net/per920a/export/das14a/satoh-lab/haolin/nhk/excerpts/2012_07_03_19_00_3.webm;Seiji MAEHARA.jpg;7177;7217;10257;239;240;1
/net/per920a/export/das14a/satoh-lab/haolin/nhk/excerpts/2012_07_10_19_00_2.webm;Yoshihiko Noda.jpg;165;837;849;5;27;22
/net/per920a/export/das14a/satoh-lab/haolin/nhk/excerpts/2012_07_11_19_00_1.webm;Ichiro OZAWA.jpg;121;121;14929;4;4;0
/net/per920a/export/das14a/satoh-lab/haolin/nhk/excerpts/2012_07_11_19_00_1.webm;Ichiro OZAWA.jpg;165;169;14929;5;5;0
/net/per920a/export/das14a/satoh-lab/haolin/nhk/excerpts/2012_07_11_19_00_1.webm;Ichiro OZAWA.jpg;197;205;14929;6;6;0
/net/per920a/export/das14a/satoh-lab/haolin/nhk/excerpts/2012_07_11_19_00_1.webm;Ichiro OZAWA.jpg;221;225;14929;7;7;0
/net/per920a/export/das14a/satoh-lab/haolin/nhk/excerpts/2012_07_11_19_00_1.webm;Ichiro OZAWA.jpg;245;261;14929;8;8;0
/net/per920a/export/das14a/satoh-lab/haolin/nhk/excerpts/2012_07_11_19_00_1.webm;Ichiro OZAWA.jpg;273;273;14929;9;9;0
/net/per920a/export/das14a/satoh-lab/haolin/nhk/excerpts/2012_07_11_19_00_1.webm;Ichiro OZAWA.jpg;285;289;14929;9;9;0
/net/per920a/export/das14a/satoh-lab/haolin/nhk/excerpts/2012_07_11_19_00_1.webm;Ichiro OZAWA.jpg;317;337;14929;10;11;1
/net/per920a/export/das14a/satoh-lab/haolin/nhk/excerpts/2012_07_11_19_00_1.webm;Ichiro OZAWA.jpg;357;365;14929;11;12;1
/net/per920a/export/das14a/satoh-lab/haolin/nhk/excerpts/2012_07_11_19_00_1.webm;Ichiro OZAWA.jpg;377;393;14929;12;13;1
/net/per920a/export/das14a/satoh-lab/haolin/nhk/excerpts/2012_07_11_19_00_1.webm;Ichiro OZAWA.jpg;405;405;14929;13;13;0
/net/per920a/export/das14a/satoh-lab/haolin/nhk/excerpts/2012_07_11_19_00_1.webm;Ichiro OZAWA.jpg;441;441;14929;14;14;0
/net/per920a/export/das14a/satoh-lab/haolin/nhk/excerpts/2012_07_11_19_00_1.webm;Ichiro OZAWA.jpg;521;525;14929;17;17;0
/net/per920a/export/das14a/satoh-lab/haolin/nhk/excerpts/2012_07_11_19_00_1.webm;Ichiro OZAWA.jpg;593;593;14929;19;19;0
/net/per920a/export/das14a/satoh-lab/haolin/nhk/excerpts/2012_07_11_19_00_1.webm;Ichiro OZAWA.jpg;605;609;14929;20;20;0
/net/per920a/export/das14a/satoh-lab/haolin/nhk/excerpts/2012_07_11_19_00_1.webm;Ichiro OZAWA.jpg;669;677;14929;22;22;0
/net/per920a/export/das14a/satoh-lab/haolin/nhk/excerpts/2012_07_11_19_00_1.webm;Ichiro OZAWA.jpg;689;689;14929;22;22;0
/net/per920a/export/das14a/satoh-lab/haolin/nhk/excerpts/2012_07_11_19_00_1.webm;Ichiro OZAWA.jpg;4885;4897;14929;162;163;1
/net/per920a/export/das14a/satoh-lab/haolin/nhk/excerpts/2012_07_11_19_00_1.webm;Ichiro OZAWA.jpg;5093;6057;14929;169;202;33
/net/per920a/export/das14a/satoh-lab/haolin/nhk/excerpts/2012_07_11_19_00_1.webm;Ichiro OZAWA.jpg;6149;8617;14929;205;287;82
/net/per920a/export/das14a/satoh-lab/haolin/nhk/excerpts/2012_07_11_19_00_1.webm;Ichiro OZAWA.jpg;8725;8741;14929;291;291;0
/net/per920a/export/das14a/satoh-lab/haolin/nhk/excerpts/2012_07_11_19_00_1.webm;Ichiro OZAWA.jpg;8933;8997;14929;297;300;3
/net/per920a/export/das14a/satoh-lab/haolin/nhk/excerpts/2012_07_11_19_00_1.webm;Ichiro OZAWA.jpg;10693;10805;14929;356;360;4
/net/per920a/export/das14a/satoh-lab/haolin/nhk/excerpts/2012_07_11_19_00_1.webm;Ichiro OZAWA.jpg;10877;10921;14929;362;364;2
/net/per920a/export/das14a/satoh-lab/haolin/nhk/excerpts/2012_07_11_19_00_1.webm;Ichiro OZAWA.jpg;11197;11953;14929;373;398;25
/net/per920a/export/das14a/satoh-lab/haolin/nhk/excerpts/2012_07_11_19_00_1.webm;Ichiro OZAWA.jpg;13685;14201;14929;456;473;17
/net/per920a/export/das14a/satoh-lab/haolin/nhk/excerpts/2012_07_11_19_00_1.webm;Ichiro OZAWA.jpg;14217;14449;14929;474;481;7
/net/per920a/export/das14a/satoh-lab/haolin/nhk/excerpts/2012_07_11_19_00_1.webm;Yoshihiko Noda.jpg;3229;3285;14929;107;109;2
/net/per920a/export/das14a/satoh-lab/haolin/nhk/excerpts/2012_07_11_19_00_1.webm;Yoshihiko Noda.jpg;3549;3789;14929;118;126;8
/net/per920a/export/das14a/satoh-lab/haolin/nhk/excerpts/2012_07_11_19_00_1.webm;Yoshihiko Noda.jpg;12885;12885;14929;429;429;0
/net/per920a/export/das14a/satoh-lab/haolin/nhk/excerpts/2012_07_11_19_00_1.webm;Yoshihiko Noda.jpg;12901;12901;14929;430;430;0
/net/per920a/export/das14a/satoh-lab/haolin/nhk/excerpts/2012_07_11_19_00_1.webm;Yoshihiko Noda.jpg;12973;13097;14929;432;436;4
/net/per920a/export/das14a/satoh-lab/haolin/nhk/excerpts/2012_07_11_19_00_1.webm;Yoshihiko Noda.jpg;13129;13197;14929;437;440;3
/net/per920a/export/das14a/satoh-lab/haolin/nhk/excerpts/2012_07_11_19_00_1.webm;Yoshihiko Noda.jpg;13213;13269;14929;440;442;2
/net/per920a/export/das14a/satoh-lab/haolin/nhk/excerpts/2012_07_11_19_00_1.webm;Toru Hashimoto.jpg;12041;12453;14929;401;415;14
/net/per920a/export/das14a/satoh-lab/haolin/nhk/excerpts/2012_07_11_19_00_1.webm;Yukio HATOYAMA.jpg;13685;14201;14929;456;473;17
/net/per920a/export/das14a/satoh-lab/haolin/nhk/excerpts/2012_07_11_19_00_1.webm;Yukio HATOYAMA.jpg;14217;14449;14929;474;481;7
/net/per920a/export/das14a/satoh-lab/haolin/nhk/excerpts/2012_08_17_19_00_1.webm;Yoshihiko Noda.jpg;1833;1929;7893;61;64;3
/net/per920a/export/das14a/satoh-lab/haolin/nhk/excerpts/2012_08_17_19_00_1.webm;Yoshihiko Noda.jpg;2209;2269;7893;73;75;2
/net/per920a/export/das14a/satoh-lab/haolin/nhk/excerpts/2012_08_17_19_00_1.webm;Yoshihiko Noda.jpg;2281;2301;7893;76;76;0
/net/per920a/export/das14a/satoh-lab/haolin/nhk/excerpts/2012_08_17_19_00_1.webm;Yoshihiko Noda.jpg;2317;2345;7893;77;78;1
/net/per920a/export/das14a/satoh-lab/haolin/nhk/excerpts/2012_08_22_19_00_1.webm;Yoshihiko Noda.jpg;1021;1021;16073;34;34;0
/net/per920a/export/das14a/satoh-lab/haolin/nhk/excerpts/2012_08_22_19_00_1.webm;Yoshihiko Noda.jpg;1093;1093;16073;36;36;0
/net/per920a/export/das14a/satoh-lab/haolin/nhk/excerpts/2012_08_22_19_00_1.webm;Yoshihiko Noda.jpg;1645;1733;16073;54;57;3
/net/per920a/export/das14a/satoh-lab/haolin/nhk/excerpts/2012_08_22_19_00_1.webm;Yoshihiko Noda.jpg;5225;5229;16073;174;174;0
/net/per920a/export/das14a/satoh-lab/haolin/nhk/excerpts/2012_08_22_19_00_1.webm;Yoshihiko Noda.jpg;5413;5473;16073;180;182;2
/net/per920a/export/das14a/satoh-lab/haolin/nhk/excerpts/2012_08_22_19_00_1.webm;Yoshihiko Noda.jpg;5485;6541;16073;182;218;36
/net/per920a/export/das14a/satoh-lab/haolin/nhk/excerpts/2012_08_22_19_00_1.webm;Yoshihiko Noda.jpg;9429;9525;16073;314;317;3
/net/per920a/export/das14a/satoh-lab/haolin/nhk/excerpts/2012_08_22_19_00_2.webm;Yukio EDANO.jpg;429;433;1205;14;14;0
/net/per920a/export/das14a/satoh-lab/haolin/nhk/excerpts/2012_08_22_19_00_2.webm;Yukio EDANO.jpg;457;461;1205;15;15;0
/net/per920a/export/das14a/satoh-lab/haolin/nhk/excerpts/2012_08_22_19_00_2.webm;Yukio EDANO.jpg;521;525;1205;17;17;0
/net/per920a/export/das14a/satoh-lab/haolin/nhk/excerpts/2012_09_02_19_00_1.webm;Shintaro ISHIHARA.jpg;4665;4709;8993;155;157;2
/net/per920a/export/das14a/satoh-lab/haolin/nhk/excerpts/2012_09_02_19_00_1.webm;Shintaro ISHIHARA.jpg;8185;8989;8993;273;299;26
/net/per920a/export/das14a/satoh-lab/haolin/nhk/excerpts/2012_09_02_19_00_3.webm;Yoshimi WATANABE.jpg;1937;2001;2737;64;66;2
/net/per920a/export/das14a/satoh-lab/haolin/nhk/excerpts/2012_09_02_19_00_3.webm;Yoshimi WATANABE.jpg;2025;2025;2737;67;67;0
/net/per920a/export/das14a/satoh-lab/haolin/nhk/excerpts/2012_09_02_19_00_3.webm;Yoshimi WATANABE.jpg;2037;2265;2737;67;75;8
/net/per920a/export/das14a/satoh-lab/haolin/nhk/excerpts/2012_09_02_19_00_3.webm;Yoshimi WATANABE.jpg;2277;2285;2737;75;75;0
/net/per920a/export/das14a/satoh-lab/haolin/nhk/excerpts/2012_09_02_19_00_3.webm;Yoshimi WATANABE.jpg;2297;2733;2737;76;90;14
/net/per920a/export/das14a/satoh-lab/haolin/nhk/excerpts/2012_09_08_19_00_1.webm;Yoshihiko Noda.jpg;473;849;7705;15;28;13
/net/per920a/export/das14a/satoh-lab/haolin/nhk/excerpts/2012_09_08_19_00_1.webm;Yoshihiko Noda.jpg;1089;1137;7705;36;37;1
/net/per920a/export/das14a/satoh-lab/haolin/nhk/excerpts/2012_09_08_19_00_1.webm;Yoshihiko Noda.jpg;1409;1993;7705;46;66;20
/net/per920a/export/das14a/satoh-lab/haolin/nhk/excerpts/2012_09_08_19_00_1.webm;Yoshihiko Noda.jpg;4349;5201;7705;145;173;28
/net/per920a/export/das14a/satoh-lab/haolin/nhk/excerpts/2012_09_08_19_00_3.webm;Sadakazu TANIGAKI.jpg;9;613;7405;0;20;20
/net/per920a/export/das14a/satoh-lab/haolin/nhk/excerpts/2012_09_08_19_00_3.webm;Sadakazu TANIGAKI.jpg;1349;1809;7405;44;60;16
/net/per920a/export/das14a/satoh-lab/haolin/nhk/excerpts/2012_09_08_19_00_3.webm;Sadakazu TANIGAKI.jpg;1825;2153;7405;60;71;11
/net/per920a/export/das14a/satoh-lab/haolin/nhk/excerpts/2012_09_08_19_00_3.webm;Sadakazu TANIGAKI.jpg;2165;2753;7405;72;91;19
/net/per920a/export/das14a/satoh-lab/haolin/nhk/excerpts/2012_09_08_19_00_3.webm;Shinzo ABE.jpg;3781;3789;7405;126;126;0
/net/per920a/export/das14a/satoh-lab/haolin/nhk/excerpts/2012_09_08_19_00_3.webm;Shinzo ABE.jpg;3805;3913;7405;126;130;4
/net/per920a/export/das14a/satoh-lab/haolin/nhk/excerpts/2012_09_08_19_00_3.webm;Ichiro OZAWA.jpg;6485;6485;7405;216;216;0
/net/per920a/export/das14a/satoh-lab/haolin/nhk/excerpts/2012_09_08_19_00_3.webm;Ichiro OZAWA.jpg;6509;6533;7405;217;217;0
/net/per920a/export/das14a/satoh-lab/haolin/nhk/excerpts/2012_09_08_19_00_3.webm;Ichiro OZAWA.jpg;6561;6569;7405;218;219;1
/net/per920a/export/das14a/satoh-lab/haolin/nhk/excerpts/2012_09_08_19_00_3.webm;Ichiro OZAWA.jpg;6581;6581;7405;219;219;0
/net/per920a/export/das14a/satoh-lab/haolin/nhk/excerpts/2012_09_08_19_00_3.webm;Ichiro OZAWA.jpg;6617;6617;7405;220;220;0
/net/per920a/export/das14a/satoh-lab/haolin/nhk/excerpts/2012_09_10_19_00_1.webm;Shizuka KAMEI.jpg;3245;3377;25185;108;112;4
/net/per920a/export/das14a/satoh-lab/haolin/nhk/excerpts/2012_09_10_19_00_1.webm;Shizuka KAMEI.jpg;3393;3597;25185;113;119;6
/net/per920a/export/das14a/satoh-lab/haolin/nhk/excerpts/2012_09_10_19_00_1.webm;Shizuka KAMEI.jpg;3613;3749;25185;120;125;5
/net/per920a/export/das14a/satoh-lab/haolin/nhk/excerpts/2012_09_10_19_00_1.webm;Shizuka KAMEI.jpg;3765;3789;25185;125;126;1
/net/per920a/export/das14a/satoh-lab/haolin/nhk/excerpts/2012_09_10_19_00_1.webm;Shizuka KAMEI.jpg;3813;4445;25185;127;148;21
/net/per920a/export/das14a/satoh-lab/haolin/nhk/excerpts/2012_09_10_19_00_1.webm;Yoshihiko Noda.jpg;7301;7313;25185;243;243;0
/net/per920a/export/das14a/satoh-lab/haolin/nhk/excerpts/2012_09_10_19_00_1.webm;Yoshihiko Noda.jpg;7329;7349;25185;244;245;1
/net/per920a/export/das14a/satoh-lab/haolin/nhk/excerpts/2012_09_10_19_00_1.webm;Yoshihiko Noda.jpg;7365;7469;25185;245;249;4
/net/per920a/export/das14a/satoh-lab/haolin/nhk/excerpts/2012_09_10_19_00_1.webm;Yoshihiko Noda.jpg;7533;7541;25185;251;251;0
/net/per920a/export/das14a/satoh-lab/haolin/nhk/excerpts/2012_09_10_19_00_1.webm;Yoshihiko Noda.jpg;7553;7553;25185;251;251;0
/net/per920a/export/das14a/satoh-lab/haolin/nhk/excerpts/2012_09_10_19_00_1.webm;Yoshihiko Noda.jpg;7573;7581;25185;252;252;0
/net/per920a/export/das14a/satoh-lab/haolin/nhk/excerpts/2012_09_10_19_00_1.webm;Yoshihiko Noda.jpg;7601;7613;25185;253;253;0
/net/per920a/export/das14a/satoh-lab/haolin/nhk/excerpts/2012_09_10_19_00_1.webm;Yoshihiko Noda.jpg;7629;7629;25185;254;254;0
/net/per920a/export/das14a/satoh-lab/haolin/nhk/excerpts/2012_09_10_19_00_1.webm;Yoshihiko Noda.jpg;10753;10789;25185;358;359;1
/net/per920a/export/das14a/satoh-lab/haolin/nhk/excerpts/2012_09_10_19_00_1.webm;Yoshihiko Noda.jpg;10801;10813;25185;360;360;0
/net/per920a/export/das14a/satoh-lab/haolin/nhk/excerpts/2012_09_10_19_00_1.webm;Yoshihiko Noda.jpg;10845;11873;25185;361;396;35
/net/per920a/export/das14a/satoh-lab/haolin/nhk/excerpts/2012_09_10_19_00_1.webm;Yoshihiko Noda.jpg;15301;18289;25185;510;609;99
/net/per920a/export/das14a/satoh-lab/haolin/nhk/excerpts/2012_09_10_19_00_1.webm;Yoshihiko Noda.jpg;18561;18713;25185;619;624;5
/net/per920a/export/das14a/satoh-lab/haolin/nhk/excerpts/2012_09_10_19_00_1.webm;Yoshihiko Noda.jpg;18729;19077;25185;624;636;12
/net/per920a/export/das14a/satoh-lab/haolin/nhk/excerpts/2012_09_10_19_00_1.webm;Yoshihiko Noda.jpg;22389;22397;25185;746;747;1
/net/per920a/export/das14a/satoh-lab/haolin/nhk/excerpts/2012_09_10_19_00_1.webm;Yoshihiko Noda.jpg;22517;22529;25185;751;751;0
/net/per920a/export/das14a/satoh-lab/haolin/nhk/excerpts/2012_09_10_19_00_1.webm;Yoshihiko Noda.jpg;22541;22541;25185;751;751;0
/net/per920a/export/das14a/satoh-lab/haolin/nhk/excerpts/2012_09_10_19_00_1.webm;Yoshihiko Noda.jpg;22557;22569;25185;752;752;0
/net/per920a/export/das14a/satoh-lab/haolin/nhk/excerpts/2012_09_10_19_00_1.webm;Yoshihiko Noda.jpg;22581;22637;25185;753;755;2
/net/per920a/export/das14a/satoh-lab/haolin/nhk/excerpts/2012_09_10_19_00_1.webm;Yoshihiko Noda.jpg;23169;23177;25185;772;773;1
/net/per920a/export/das14a/satoh-lab/haolin/nhk/excerpts/2012_09_10_19_00_1.webm;Yoshihiko Noda.jpg;23197;23209;25185;773;774;1
/net/per920a/export/das14a/satoh-lab/haolin/nhk/excerpts/2012_09_10_19_00_1.webm;Yukio HATOYAMA.jpg;7489;7497;25185;249;250;1
/net/per920a/export/das14a/satoh-lab/haolin/nhk/excerpts/2012_09_10_19_00_1.webm;Katsuya OKADA.jpg;7673;7713;25185;255;257;2
/net/per920a/export/das14a/satoh-lab/haolin/nhk/excerpts/2012_09_10_19_00_1.webm;Katsuya OKADA.jpg;23297;23381;25185;777;779;2
/net/per920a/export/das14a/satoh-lab/haolin/nhk/excerpts/2012_09_10_19_00_1.webm;Sadakazu TANIGAKI.jpg;24961;25181;25185;832;839;7
/net/per920a/export/das14a/satoh-lab/haolin/nhk/excerpts/2012_10_01_19_00_1.webm;Yoshihiko Noda.jpg;33;157;3457;1;5;4
/net/per920a/export/das14a/satoh-lab/haolin/nhk/excerpts/2012_10_01_19_00_1.webm;Yoshihiko Noda.jpg;173;677;3457;5;22;17
/net/per920a/export/das14a/satoh-lab/haolin/nhk/excerpts/2012_10_01_19_00_1.webm;Yoshihiko Noda.jpg;1053;1053;3457;35;35;0
/net/per920a/export/das14a/satoh-lab/haolin/nhk/excerpts/2012_10_01_19_00_1.webm;Yoshihiko Noda.jpg;1069;1101;3457;35;36;1
/net/per920a/export/das14a/satoh-lab/haolin/nhk/excerpts/2012_10_01_19_00_1.webm;Yoshihiko Noda.jpg;1121;1125;3457;37;37;0
/net/per920a/export/das14a/satoh-lab/haolin/nhk/excerpts/2012_10_01_19_00_1.webm;Yoshihiko Noda.jpg;1141;1161;3457;37;38;1
/net/per920a/export/das14a/satoh-lab/haolin/nhk/excerpts/2012_10_01_19_00_1.webm;Yoshihiko Noda.jpg;1181;1789;3457;39;59;20
/net/per920a/export/das14a/satoh-lab/haolin/nhk/excerpts/2012_10_01_19_00_1.webm;Seiji MAEHARA.jpg;185;677;3457;6;22;16
/net/per920a/export/das14a/satoh-lab/haolin/nhk/excerpts/2012_10_01_19_00_2.webm;Yukio EDANO.jpg;1189;1213;2253;39;40;1
/net/per920a/export/das14a/satoh-lab/haolin/nhk/excerpts/2012_10_01_19_00_2.webm;Yukio EDANO.jpg;1225;1233;2253;40;41;1
/net/per920a/export/das14a/satoh-lab/haolin/nhk/excerpts/2012_10_01_19_00_3.webm;Yoshihiko Noda.jpg;805;805;17357;26;26;0
/net/per920a/export/das14a/satoh-lab/haolin/nhk/excerpts/2012_10_01_19_00_3.webm;Yoshihiko Noda.jpg;837;1237;17357;27;41;14
/net/per920a/export/das14a/satoh-lab/haolin/nhk/excerpts/2012_10_01_19_00_3.webm;Yoshihiko Noda.jpg;1253;1265;17357;41;42;1
/net/per920a/export/das14a/satoh-lab/haolin/nhk/excerpts/2012_10_01_19_00_3.webm;Yoshihiko Noda.jpg;1281;1297;17357;42;43;1
/net/per920a/export/das14a/satoh-lab/haolin/nhk/excerpts/2012_10_01_19_00_3.webm;Yoshihiko Noda.jpg;1337;1453;17357;44;48;4
/net/per920a/export/das14a/satoh-lab/haolin/nhk/excerpts/2012_10_01_19_00_3.webm;Yoshihiko Noda.jpg;1513;1541;17357;50;51;1
/net/per920a/export/das14a/satoh-lab/haolin/nhk/excerpts/2012_10_01_19_00_3.webm;Yoshihiko Noda.jpg;1557;2193;17357;51;73;22
/net/per920a/export/das14a/satoh-lab/haolin/nhk/excerpts/2012_10_01_19_00_3.webm;Yoshihiko Noda.jpg;2209;2229;17357;73;74;1
/net/per920a/export/das14a/satoh-lab/haolin/nhk/excerpts/2012_10_01_19_00_3.webm;Yoshihiko Noda.jpg;14113;14869;17357;470;496;26
/net/per920a/export/das14a/satoh-lab/haolin/nhk/excerpts/2012_10_01_19_00_3.webm;Yoshihiko Noda.jpg;14881;15741;17357;496;525;29
/net/per920a/export/das14a/satoh-lab/haolin/nhk/excerpts/2012_10_01_19_00_3.webm;Yoshihiko Noda.jpg;15905;15941;17357;530;531;1
/net/per920a/export/das14a/satoh-lab/haolin/nhk/excerpts/2012_10_01_19_00_3.webm;Yoshihiko Noda.jpg;15953;15965;17357;532;532;0
/net/per920a/export/das14a/satoh-lab/haolin/nhk/excerpts/2012_10_01_19_00_3.webm;Yoshihiko Noda.jpg;15977;15997;17357;532;533;1
/net/per920a/export/das14a/satoh-lab/haolin/nhk/excerpts/2012_10_01_19_00_3.webm;Yoshihiko Noda.jpg;16009;16013;17357;534;534;0
/net/per920a/export/das14a/satoh-lab/haolin/nhk/excerpts/2012_10_01_19_00_3.webm;Yoshihiko Noda.jpg;16025;16117;17357;534;537;3
/net/per920a/export/das14a/satoh-lab/haolin/nhk/excerpts/2012_10_01_19_00_3.webm;Natsuo YAMAGUCHI.jpg;9637;9665;17357;321;322;1
/net/per920a/export/das14a/satoh-lab/haolin/nhk/excerpts/2012_10_01_19_00_3.webm;Natsuo YAMAGUCHI.jpg;9689;9689;17357;323;323;0
/net/per920a/export/das14a/satoh-lab/haolin/nhk/excerpts/2012_10_01_19_00_3.webm;Natsuo YAMAGUCHI.jpg;13957;13973;17357;465;466;1
/net/per920a/export/das14a/satoh-lab/haolin/nhk/excerpts/2012_10_01_19_00_3.webm;Natsuo YAMAGUCHI.jpg;13989;14069;17357;466;469;3
/net/per920a/export/das14a/satoh-lab/haolin/nhk/excerpts/2012_10_01_19_00_3.webm;Natsuo YAMAGUCHI.jpg;14085;14101;17357;469;470;1
/net/per920a/export/das14a/satoh-lab/haolin/nhk/excerpts/2012_10_01_19_00_3.webm;Natsuo YAMAGUCHI.jpg;14113;14869;17357;470;496;26
/net/per920a/export/das14a/satoh-lab/haolin/nhk/excerpts/2012_10_01_19_00_3.webm;Shinzo ABE.jpg;9857;11997;17357;328;400;72
/net/per920a/export/das14a/satoh-lab/haolin/nhk/excerpts/2012_10_01_19_00_3.webm;Shinzo ABE.jpg;14113;14869;17357;470;496;26
/net/per920a/export/das14a/satoh-lab/haolin/nhk/excerpts/2012_10_01_19_00_3.webm;Shinzo ABE.jpg;16353;16389;17357;545;546;1
/net/per920a/export/das14a/satoh-lab/haolin/nhk/excerpts/2012_10_01_19_00_3.webm;Yoshimi WATANABE.jpg;12013;12057;17357;400;402;2
/net/per920a/export/das14a/satoh-lab/haolin/nhk/excerpts/2012_10_01_19_00_3.webm;Yoshimi WATANABE.jpg;12073;12073;17357;402;402;0
/net/per920a/export/das14a/satoh-lab/haolin/nhk/excerpts/2012_10_01_19_00_3.webm;Yoshimi WATANABE.jpg;12093;12201;17357;403;407;4
/net/per920a/export/das14a/satoh-lab/haolin/nhk/excerpts/2012_10_01_19_00_3.webm;Yoshimi WATANABE.jpg;12217;12381;17357;407;413;6
/net/per920a/export/das14a/satoh-lab/haolin/nhk/excerpts/2012_10_01_19_00_3.webm;Yoshimi WATANABE.jpg;12397;12941;17357;413;431;18
/net/per920a/export/das14a/satoh-lab/haolin/nhk/excerpts/2012_10_01_19_00_3.webm;Mizuho FUKUSHIMA.jpg;12957;12997;17357;432;433;1
/net/per920a/export/das14a/satoh-lab/haolin/nhk/excerpts/2012_10_01_19_00_3.webm;Mizuho FUKUSHIMA.jpg;13013;13089;17357;434;436;2
/net/per920a/export/das14a/satoh-lab/haolin/nhk/excerpts/2012_10_01_19_00_3.webm;Mizuho FUKUSHIMA.jpg;13105;13109;17357;437;437;0
/net/per920a/export/das14a/satoh-lab/haolin/nhk/excerpts/2012_10_01_19_00_3.webm;Mizuho FUKUSHIMA.jpg;13137;13193;17357;438;440;2
/net/per920a/export/das14a/satoh-lab/haolin/nhk/excerpts/2012_10_01_19_00_3.webm;Mizuho FUKUSHIMA.jpg;13209;13253;17357;440;442;2
/net/per920a/export/das14a/satoh-lab/haolin/nhk/excerpts/2012_10_01_19_00_3.webm;Mizuho FUKUSHIMA.jpg;13269;13613;17357;442;454;12
/net/per920a/export/das14a/satoh-lab/haolin/nhk/excerpts/2012_10_01_19_00_3.webm;Taro ASO.jpg;13629;13777;17357;454;459;5
/net/per920a/export/das14a/satoh-lab/haolin/nhk/excerpts/2012_10_05_19_00_1.webm;Shinzo ABE.jpg;157;181;5825;5;6;1
/net/per920a/export/das14a/satoh-lab/haolin/nhk/excerpts/2012_10_05_19_00_1.webm;Shinzo ABE.jpg;193;885;5825;6;29;23
/net/per920a/export/das14a/satoh-lab/haolin/nhk/excerpts/2012_10_05_19_00_1.webm;Shinzo ABE.jpg;901;941;5825;30;31;1
/net/per920a/export/das14a/satoh-lab/haolin/nhk/excerpts/2012_10_05_19_00_1.webm;Shinzo ABE.jpg;957;977;5825;31;32;1
/net/per920a/export/das14a/satoh-lab/haolin/nhk/excerpts/2012_10_05_19_00_1.webm;Shinzo ABE.jpg;1761;1769;5825;58;58;0
/net/per920a/export/das14a/satoh-lab/haolin/nhk/excerpts/2012_10_05_19_00_1.webm;Shinzo ABE.jpg;1793;1809;5825;59;60;1
/net/per920a/export/das14a/satoh-lab/haolin/nhk/excerpts/2012_10_05_19_00_1.webm;Shinzo ABE.jpg;1821;1833;5825;60;61;1
/net/per920a/export/das14a/satoh-lab/haolin/nhk/excerpts/2012_10_05_19_00_1.webm;Shinzo ABE.jpg;2281;2473;5825;75;82;7
/net/per920a/export/das14a/satoh-lab/haolin/nhk/excerpts/2012_10_05_19_00_1.webm;Shinzo ABE.jpg;2669;2749;5825;88;91;3
/net/per920a/export/das14a/satoh-lab/haolin/nhk/excerpts/2012_10_05_19_00_1.webm;Shinzo ABE.jpg;2765;2773;5825;92;92;0
/net/per920a/export/das14a/satoh-lab/haolin/nhk/excerpts/2012_10_05_19_00_1.webm;Shinzo ABE.jpg;2797;2801;5825;93;93;0
/net/per920a/export/das14a/satoh-lab/haolin/nhk/excerpts/2012_10_05_19_00_1.webm;Shinzo ABE.jpg;2865;2865;5825;95;95;0
/net/per920a/export/das14a/satoh-lab/haolin/nhk/excerpts/2012_10_05_19_00_1.webm;Shinzo ABE.jpg;2881;2893;5825;95;96;1
/net/per920a/export/das14a/satoh-lab/haolin/nhk/excerpts/2012_10_05_19_00_1.webm;Shinzo ABE.jpg;2905;2905;5825;96;96;0
/net/per920a/export/das14a/satoh-lab/haolin/nhk/excerpts/2012_10_05_19_00_1.webm;Shinzo ABE.jpg;2929;2933;5825;97;97;0
/net/per920a/export/das14a/satoh-lab/haolin/nhk/excerpts/2012_10_05_19_00_1.webm;Yoshihiko Noda.jpg;157;181;5825;5;6;1
/net/per920a/export/das14a/satoh-lab/haolin/nhk/excerpts/2012_10_05_19_00_1.webm;Yoshihiko Noda.jpg;193;885;5825;6;29;23
/net/per920a/export/das14a/satoh-lab/haolin/nhk/excerpts/2012_10_05_19_00_1.webm;Yoshihiko Noda.jpg;901;941;5825;30;31;1
/net/per920a/export/das14a/satoh-lab/haolin/nhk/excerpts/2012_10_05_19_00_1.webm;Yoshihiko Noda.jpg;957;977;5825;31;32;1
/net/per920a/export/das14a/satoh-lab/haolin/nhk/excerpts/2012_10_05_19_00_1.webm;Yoshihiko Noda.jpg;1257;1721;5825;41;57;16
/net/per920a/export/das14a/satoh-lab/haolin/nhk/excerpts/2012_10_05_19_00_1.webm;Natsuo YAMAGUCHI.jpg;193;885;5825;6;29;23
/net/per920a/export/das14a/satoh-lab/haolin/nhk/excerpts/2012_10_05_19_00_1.webm;Natsuo YAMAGUCHI.jpg;901;941;5825;30;31;1
/net/per920a/export/das14a/satoh-lab/haolin/nhk/excerpts/2012_10_05_19_00_1.webm;Natsuo YAMAGUCHI.jpg;957;977;5825;31;32;1
/net/per920a/export/das14a/satoh-lab/haolin/nhk/excerpts/2012_10_05_19_00_1.webm;Natsuo YAMAGUCHI.jpg;1969;1969;5825;65;65;0
/net/per920a/export/das14a/satoh-lab/haolin/nhk/excerpts/2012_10_05_19_00_1.webm;Natsuo YAMAGUCHI.jpg;1985;1985;5825;66;66;0
/net/per920a/export/das14a/satoh-lab/haolin/nhk/excerpts/2012_10_05_19_00_1.webm;Natsuo YAMAGUCHI.jpg;1997;2005;5825;66;66;0
/net/per920a/export/das14a/satoh-lab/haolin/nhk/excerpts/2012_10_05_19_00_1.webm;Natsuo YAMAGUCHI.jpg;2949;3165;5825;98;105;7
/net/per920a/export/das14a/satoh-lab/haolin/nhk/excerpts/2012_10_07_19_00_3.webm;Yoshihiko Noda.jpg;9;837;6481;0;27;27
/net/per920a/export/das14a/satoh-lab/haolin/nhk/excerpts/2012_10_07_19_00_3.webm;Yoshihiko Noda.jpg;4697;4829;6481;156;160;4
/net/per920a/export/das14a/satoh-lab/haolin/nhk/excerpts/2012_10_07_19_00_3.webm;Yoshihiko Noda.jpg;4845;4921;6481;161;164;3
/net/per920a/export/das14a/satoh-lab/haolin/nhk/excerpts/2012_10_07_19_00_3.webm;Yoshihiko Noda.jpg;5445;6357;6481;181;211;30
/net/per920a/export/das14a/satoh-lab/haolin/nhk/excerpts/2012_10_07_19_00_3.webm;Yoshihiko Noda.jpg;6373;6477;6481;212;215;3
/net/per920a/export/das14a/satoh-lab/haolin/nhk/excerpts/2012_10_18_19_00_1.webm;Yoshihiko Noda.jpg;121;141;12717;4;4;0
/net/per920a/export/das14a/satoh-lab/haolin/nhk/excerpts/2012_10_18_19_00_1.webm;Yoshihiko Noda.jpg;153;153;12717;5;5;0
/net/per920a/export/das14a/satoh-lab/haolin/nhk/excerpts/2012_10_18_19_00_1.webm;Yoshihiko Noda.jpg;169;825;12717;5;27;22
/net/per920a/export/das14a/satoh-lab/haolin/nhk/excerpts/2012_10_18_19_00_1.webm;Yoshihiko Noda.jpg;5553;5553;12717;185;185;0
/net/per920a/export/das14a/satoh-lab/haolin/nhk/excerpts/2012_10_18_19_00_1.webm;Yoshihiko Noda.jpg;5593;5593;12717;186;186;0
/net/per920a/export/das14a/satoh-lab/haolin/nhk/excerpts/2012_10_18_19_00_1.webm;Yoshihiko Noda.jpg;5977;6013;12717;199;200;1
/net/per920a/export/das14a/satoh-lab/haolin/nhk/excerpts/2012_10_18_19_00_1.webm;Yoshihiko Noda.jpg;8949;9849;12717;298;328;30
/net/per920a/export/das14a/satoh-lab/haolin/nhk/excerpts/2012_10_18_19_00_1.webm;Yoshihiko Noda.jpg;10377;10377;12717;345;345;0
/net/per920a/export/das14a/satoh-lab/haolin/nhk/excerpts/2012_10_18_19_00_1.webm;Yoshihiko Noda.jpg;10393;10537;12717;346;351;5
/net/per920a/export/das14a/satoh-lab/haolin/nhk/excerpts/2012_10_18_19_00_1.webm;Yoshihiko Noda.jpg;10761;10777;12717;358;359;1
/net/per920a/export/das14a/satoh-lab/haolin/nhk/excerpts/2012_10_18_19_00_1.webm;Yoshihiko Noda.jpg;10797;10809;12717;359;360;1
/net/per920a/export/das14a/satoh-lab/haolin/nhk/excerpts/2012_10_18_19_00_1.webm;Yoshihiko Noda.jpg;10853;10861;12717;361;362;1
/net/per920a/export/das14a/satoh-lab/haolin/nhk/excerpts/2012_10_18_19_00_1.webm;Shinzo ABE.jpg;121;141;12717;4;4;0
/net/per920a/export/das14a/satoh-lab/haolin/nhk/excerpts/2012_10_18_19_00_1.webm;Shinzo ABE.jpg;153;153;12717;5;5;0
/net/per920a/export/das14a/satoh-lab/haolin/nhk/excerpts/2012_10_18_19_00_1.webm;Shinzo ABE.jpg;169;825;12717;5;27;22
/net/per920a/export/das14a/satoh-lab/haolin/nhk/excerpts/2012_10_18_19_00_1.webm;Shinzo ABE.jpg;3993;4737;12717;133;157;24
/net/per920a/export/das14a/satoh-lab/haolin/nhk/excerpts/2012_10_18_19_00_1.webm;Shinzo ABE.jpg;8949;9849;12717;298;328;30
/net/per920a/export/das14a/satoh-lab/haolin/nhk/excerpts/2012_10_18_19_00_1.webm;Shinzo ABE.jpg;11761;12437;12717;392;414;22
/net/per920a/export/das14a/satoh-lab/haolin/nhk/excerpts/2012_10_18_19_00_1.webm;Natsuo YAMAGUCHI.jpg;153;153;12717;5;5;0
/net/per920a/export/das14a/satoh-lab/haolin/nhk/excerpts/2012_10_18_19_00_1.webm;Natsuo YAMAGUCHI.jpg;169;825;12717;5;27;22
/net/per920a/export/das14a/satoh-lab/haolin/nhk/excerpts/2012_10_18_19_00_1.webm;Natsuo YAMAGUCHI.jpg;4765;4773;12717;158;159;1
/net/per920a/export/das14a/satoh-lab/haolin/nhk/excerpts/2012_10_18_19_00_1.webm;Natsuo YAMAGUCHI.jpg;4785;5389;12717;159;179;20
/net/per920a/export/das14a/satoh-lab/haolin/nhk/excerpts/2012_10_18_19_00_1.webm;Natsuo YAMAGUCHI.jpg;5405;5533;12717;180;184;4
/net/per920a/export/das14a/satoh-lab/haolin/nhk/excerpts/2012_10_18_19_00_1.webm;Natsuo YAMAGUCHI.jpg;8949;9849;12717;298;328;30
/net/per920a/export/das14a/satoh-lab/haolin/nhk/excerpts/2012_10_18_19_00_1.webm;Natsuo YAMAGUCHI.jpg;11761;12437;12717;392;414;22
/net/per920a/export/das14a/satoh-lab/haolin/nhk/excerpts/2012_10_19_19_00_1.webm;Yoshihiko Noda.jpg;645;1017;12649;21;33;12
/net/per920a/export/das14a/satoh-lab/haolin/nhk/excerpts/2012_10_19_19_00_1.webm;Yoshihiko Noda.jpg;1493;1597;12649;49;53;4
/net/per920a/export/das14a/satoh-lab/haolin/nhk/excerpts/2012_10_19_19_00_1.webm;Yoshihiko Noda.jpg;2285;2497;12649;76;83;7
/net/per920a/export/das14a/satoh-lab/haolin/nhk/excerpts/2012_10_19_19_00_1.webm;Yoshihiko Noda.jpg;2677;2921;12649;89;97;8
/net/per920a/export/das14a/satoh-lab/haolin/nhk/excerpts/2012_10_19_19_00_1.webm;Yoshihiko Noda.jpg;2933;4217;12649;97;140;43
/net/per920a/export/das14a/satoh-lab/haolin/nhk/excerpts/2012_10_19_19_00_1.webm;Yoshihiko Noda.jpg;4273;5377;12649;142;179;37
/net/per920a/export/das14a/satoh-lab/haolin/nhk/excerpts/2012_10_19_19_00_1.webm;Yoshihiko Noda.jpg;5449;5877;12649;181;196;15
/net/per920a/export/das14a/satoh-lab/haolin/nhk/excerpts/2012_10_19_19_00_1.webm;Yoshihiko Noda.jpg;7797;7809;12649;260;260;0
/net/per920a/export/das14a/satoh-lab/haolin/nhk/excerpts/2012_10_19_19_00_1.webm;Yoshihiko Noda.jpg;7829;7837;12649;261;261;0
/net/per920a/export/das14a/satoh-lab/haolin/nhk/excerpts/2012_10_19_19_00_1.webm;Yoshihiko Noda.jpg;7849;7849;12649;261;261;0
/net/per920a/export/das14a/satoh-lab/haolin/nhk/excerpts/2012_10_19_19_00_1.webm;Yoshihiko Noda.jpg;7865;7877;12649;262;262;0
/net/per920a/export/das14a/satoh-lab/haolin/nhk/excerpts/2012_10_19_19_00_1.webm;Yoshihiko Noda.jpg;7901;7909;12649;263;263;0
/net/per920a/export/das14a/satoh-lab/haolin/nhk/excerpts/2012_10_19_19_00_1.webm;Yoshihiko Noda.jpg;7933;7941;12649;264;264;0
/net/per920a/export/das14a/satoh-lab/haolin/nhk/excerpts/2012_10_19_19_00_1.webm;Yoshihiko Noda.jpg;9689;9745;12649;323;325;2
/net/per920a/export/das14a/satoh-lab/haolin/nhk/excerpts/2012_10_19_19_00_1.webm;Yoshihiko Noda.jpg;10065;10253;12649;335;342;7
/net/per920a/export/das14a/satoh-lab/haolin/nhk/excerpts/2012_10_19_19_00_1.webm;Yoshihiko Noda.jpg;10665;10677;12649;355;356;1
/net/per920a/export/das14a/satoh-lab/haolin/nhk/excerpts/2012_10_19_19_00_1.webm;Yoshihiko Noda.jpg;10689;10697;12649;356;356;0
/net/per920a/export/das14a/satoh-lab/haolin/nhk/excerpts/2012_10_19_19_00_1.webm;Yoshihiko Noda.jpg;10709;10733;12649;357;358;1
/net/per920a/export/das14a/satoh-lab/haolin/nhk/excerpts/2012_10_19_19_00_1.webm;Yoshihiko Noda.jpg;10897;10981;12649;363;366;3
/net/per920a/export/das14a/satoh-lab/haolin/nhk/excerpts/2012_10_19_19_00_1.webm;Yoshihiko Noda.jpg;11581;11613;12649;386;387;1
/net/per920a/export/das14a/satoh-lab/haolin/nhk/excerpts/2012_10_19_19_00_1.webm;Yoshihiko Noda.jpg;11625;11633;12649;387;388;1
/net/per920a/export/das14a/satoh-lab/haolin/nhk/excerpts/2012_10_19_19_00_1.webm;Yoshihiko Noda.jpg;11645;11645;12649;388;388;0
/net/per920a/export/das14a/satoh-lab/haolin/nhk/excerpts/2012_10_19_19_00_1.webm;Yoshihiko Noda.jpg;11657;11665;12649;388;389;1
/net/per920a/export/das14a/satoh-lab/haolin/nhk/excerpts/2012_10_19_19_00_1.webm;Yoshihiko Noda.jpg;11721;11733;12649;391;391;0
/net/per920a/export/das14a/satoh-lab/haolin/nhk/excerpts/2012_10_19_19_00_1.webm;Yoshihiko Noda.jpg;11745;11753;12649;391;392;1
/net/per920a/export/das14a/satoh-lab/haolin/nhk/excerpts/2012_10_19_19_00_1.webm;Yoshihiko Noda.jpg;11765;11789;12649;392;393;1
/net/per920a/export/das14a/satoh-lab/haolin/nhk/excerpts/2012_10_19_19_00_1.webm;Yoshihiko Noda.jpg;11817;11841;12649;394;395;1
/net/per920a/export/das14a/satoh-lab/haolin/nhk/excerpts/2012_10_19_19_00_1.webm;Yoshihiko Noda.jpg;11853;11933;12649;395;398;3
/net/per920a/export/das14a/satoh-lab/haolin/nhk/excerpts/2012_10_19_19_00_1.webm;Yoshihiko Noda.jpg;11953;12605;12649;398;420;22
/net/per920a/export/das14a/satoh-lab/haolin/nhk/excerpts/2012_10_19_19_00_1.webm;Shinzo ABE.jpg;1137;1157;12649;37;38;1
/net/per920a/export/das14a/satoh-lab/haolin/nhk/excerpts/2012_10_19_19_00_1.webm;Shinzo ABE.jpg;1173;1173;12649;39;39;0
/net/per920a/export/das14a/satoh-lab/haolin/nhk/excerpts/2012_10_19_19_00_1.webm;Shinzo ABE.jpg;1185;1205;12649;39;40;1
/net/per920a/export/das14a/satoh-lab/haolin/nhk/excerpts/2012_10_19_19_00_1.webm;Shinzo ABE.jpg;1625;1801;12649;54;60;6
/net/per920a/export/das14a/satoh-lab/haolin/nhk/excerpts/2012_10_19_19_00_1.webm;Shinzo ABE.jpg;2509;2645;12649;83;88;5
/net/per920a/export/das14a/satoh-lab/haolin/nhk/excerpts/2012_10_19_19_00_1.webm;Shinzo ABE.jpg;2933;3109;12649;97;103;6
/net/per920a/export/das14a/satoh-lab/haolin/nhk/excerpts/2012_10_19_19_00_1.webm;Shinzo ABE.jpg;5893;6801;12649;196;226;30
/net/per920a/export/das14a/satoh-lab/haolin/nhk/excerpts/2012_10_19_19_00_1.webm;Shinzo ABE.jpg;6817;7785;12649;227;259;32
/net/per920a/export/das14a/satoh-lab/haolin/nhk/excerpts/2012_10_19_19_00_1.webm;Shinzo ABE.jpg;9769;9873;12649;325;329;4
/net/per920a/export/das14a/satoh-lab/haolin/nhk/excerpts/2012_10_19_19_00_1.webm;Shinzo ABE.jpg;10009;10033;12649;333;334;1
/net/per920a/export/das14a/satoh-lab/haolin/nhk/excerpts/2012_10_19_19_00_1.webm;Shinzo ABE.jpg;10993;11321;12649;366;377;11
/net/per920a/export/das14a/satoh-lab/haolin/nhk/excerpts/2012_10_19_19_00_1.webm;Shinzo ABE.jpg;11337;11469;12649;378;382;4
/net/per920a/export/das14a/satoh-lab/haolin/nhk/excerpts/2012_10_19_19_00_1.webm;Natsuo YAMAGUCHI.jpg;1257;1261;12649;41;42;1
/net/per920a/export/das14a/satoh-lab/haolin/nhk/excerpts/2012_10_19_19_00_1.webm;Natsuo YAMAGUCHI.jpg;1273;1301;12649;42;43;1
/net/per920a/export/das14a/satoh-lab/haolin/nhk/excerpts/2012_10_19_19_00_1.webm;Natsuo YAMAGUCHI.jpg;1825;1853;12649;60;61;1
/net/per920a/export/das14a/satoh-lab/haolin/nhk/excerpts/2012_10_19_19_00_1.webm;Natsuo YAMAGUCHI.jpg;2509;2645;12649;83;88;5
/net/per920a/export/das14a/satoh-lab/haolin/nhk/excerpts/2012_10_19_19_00_1.webm;Natsuo YAMAGUCHI.jpg;2933;4217;12649;97;140;43
/net/per920a/export/das14a/satoh-lab/haolin/nhk/excerpts/2012_10_19_19_00_1.webm;Natsuo YAMAGUCHI.jpg;9913;9929;12649;330;331;1
/net/per920a/export/das14a/satoh-lab/haolin/nhk/excerpts/2012_10_19_19_00_1.webm;Natsuo YAMAGUCHI.jpg;10993;11321;12649;366;377;11
/net/per920a/export/das14a/satoh-lab/haolin/nhk/excerpts/2012_10_19_19_00_1.webm;Natsuo YAMAGUCHI.jpg;11337;11473;12649;378;382;4
/net/per920a/export/das14a/satoh-lab/haolin/nhk/excerpts/2012_10_31_19_00_2.webm;Shinzo ABE.jpg;9;849;6781;0;28;28
/net/per920a/export/das14a/satoh-lab/haolin/nhk/excerpts/2012_10_31_19_00_2.webm;Shinzo ABE.jpg;1185;1229;6781;39;40;1
/net/per920a/export/das14a/satoh-lab/haolin/nhk/excerpts/2012_10_31_19_00_2.webm;Shinzo ABE.jpg;1241;1325;6781;41;44;3
/net/per920a/export/das14a/satoh-lab/haolin/nhk/excerpts/2012_10_31_19_00_2.webm;Shinzo ABE.jpg;2757;2913;6781;91;97;6
/net/per920a/export/das14a/satoh-lab/haolin/nhk/excerpts/2012_10_31_19_00_2.webm;Shinzo ABE.jpg;2929;3001;6781;97;100;3
/net/per920a/export/das14a/satoh-lab/haolin/nhk/excerpts/2012_10_31_19_00_2.webm;Yoshihiko Noda.jpg;9;849;6781;0;28;28
/net/per920a/export/das14a/satoh-lab/haolin/nhk/excerpts/2012_10_31_19_00_2.webm;Yoshihiko Noda.jpg;2181;2205;6781;72;73;1
/net/per920a/export/das14a/satoh-lab/haolin/nhk/excerpts/2012_10_31_19_00_2.webm;Yoshihiko Noda.jpg;2221;2221;6781;74;74;0
/net/per920a/export/das14a/satoh-lab/haolin/nhk/excerpts/2012_10_31_19_00_2.webm;Yoshihiko Noda.jpg;2249;2481;6781;74;82;8
/net/per920a/export/das14a/satoh-lab/haolin/nhk/excerpts/2012_10_31_19_00_2.webm;Yoshihiko Noda.jpg;3053;3053;6781;101;101;0
/net/per920a/export/das14a/satoh-lab/haolin/nhk/excerpts/2012_10_31_19_00_2.webm;Yoshihiko Noda.jpg;3105;3177;6781;103;105;2
/net/per920a/export/das14a/satoh-lab/haolin/nhk/excerpts/2012_10_31_19_00_2.webm;Yoshihiko Noda.jpg;3237;4937;6781;107;164;57
/net/per920a/export/das14a/satoh-lab/haolin/nhk/excerpts/2012_11_14_19_00_1.webm;Yoshihiko Noda.jpg;9;17;50569;0;0;0
/net/per920a/export/das14a/satoh-lab/haolin/nhk/excerpts/2012_11_14_19_00_1.webm;Yoshihiko Noda.jpg;49;69;50569;1;2;1
/net/per920a/export/das14a/satoh-lab/haolin/nhk/excerpts/2012_11_14_19_00_1.webm;Yoshihiko Noda.jpg;221;493;50569;7;16;9
/net/per920a/export/das14a/satoh-lab/haolin/nhk/excerpts/2012_11_14_19_00_1.webm;Yoshihiko Noda.jpg;757;785;50569;25;26;1
/net/per920a/export/das14a/satoh-lab/haolin/nhk/excerpts/2012_11_14_19_00_1.webm;Yoshihiko Noda.jpg;797;845;50569;26;28;2
/net/per920a/export/das14a/satoh-lab/haolin/nhk/excerpts/2012_11_14_19_00_1.webm;Yoshihiko Noda.jpg;1241;1241;50569;41;41;0
/net/per920a/export/das14a/satoh-lab/haolin/nhk/excerpts/2012_11_14_19_00_1.webm;Yoshihiko Noda.jpg;1253;1293;50569;41;43;2
/net/per920a/export/das14a/satoh-lab/haolin/nhk/excerpts/2012_11_14_19_00_1.webm;Yoshihiko Noda.jpg;1309;1401;50569;43;46;3
/net/per920a/export/das14a/satoh-lab/haolin/nhk/excerpts/2012_11_14_19_00_1.webm;Yoshihiko Noda.jpg;4105;4105;50569;136;136;0
/net/per920a/export/das14a/satoh-lab/haolin/nhk/excerpts/2012_11_14_19_00_1.webm;Yoshihiko Noda.jpg;4117;4117;50569;137;137;0
/net/per920a/export/das14a/satoh-lab/haolin/nhk/excerpts/2012_11_14_19_00_1.webm;Yoshihiko Noda.jpg;4137;4165;50569;138;138;0
/net/per920a/export/das14a/satoh-lab/haolin/nhk/excerpts/2012_11_14_19_00_1.webm;Yoshihiko Noda.jpg;4193;4193;50569;139;139;0
/net/per920a/export/das14a/satoh-lab/haolin/nhk/excerpts/2012_11_14_19_00_1.webm;Yoshihiko Noda.jpg;4217;4217;50569;140;140;0
/net/per920a/export/das14a/satoh-lab/haolin/nhk/excerpts/2012_11_14_19_00_1.webm;Yoshihiko Noda.jpg;4333;4393;50569;144;146;2
/net/per920a/export/das14a/satoh-lab/haolin/nhk/excerpts/2012_11_14_19_00_1.webm;Yoshihiko Noda.jpg;5813;6353;50569;193;211;18
/net/per920a/export/das14a/satoh-lab/haolin/nhk/excerpts/2012_11_14_19_00_1.webm;Yoshihiko Noda.jpg;6365;6365;50569;212;212;0
/net/per920a/export/das14a/satoh-lab/haolin/nhk/excerpts/2012_11_14_19_00_1.webm;Yoshihiko Noda.jpg;6377;6773;50569;212;225;13
/net/per920a/export/das14a/satoh-lab/haolin/nhk/excerpts/2012_11_14_19_00_1.webm;Yoshihiko Noda.jpg;6785;6793;50569;226;226;0
/net/per920a/export/das14a/satoh-lab/haolin/nhk/excerpts/2012_11_14_19_00_1.webm;Yoshihiko Noda.jpg;6805;6809;50569;227;227;0
/net/per920a/export/das14a/satoh-lab/haolin/nhk/excerpts/2012_11_14_19_00_1.webm;Yoshihiko Noda.jpg;6821;7273;50569;227;242;15
/net/per920a/export/das14a/satoh-lab/haolin/nhk/excerpts/2012_11_14_19_00_1.webm;Yoshihiko Noda.jpg;7289;7301;50569;243;243;0
/net/per920a/export/das14a/satoh-lab/haolin/nhk/excerpts/2012_11_14_19_00_1.webm;Yoshihiko Noda.jpg;7313;7313;50569;243;243;0
/net/per920a/export/das14a/satoh-lab/haolin/nhk/excerpts/2012_11_14_19_00_1.webm;Yoshihiko Noda.jpg;7357;7357;50569;245;245;0
/net/per920a/export/das14a/satoh-lab/haolin/nhk/excerpts/2012_11_14_19_00_1.webm;Yoshihiko Noda.jpg;7369;7385;50569;245;246;1
/net/per920a/export/das14a/satoh-lab/haolin/nhk/excerpts/2012_11_14_19_00_1.webm;Yoshihiko Noda.jpg;7401;7569;50569;246;252;6
/net/per920a/export/das14a/satoh-lab/haolin/nhk/excerpts/2012_11_14_19_00_1.webm;Yoshihiko Noda.jpg;8053;8201;50569;268;273;5
/net/per920a/export/das14a/satoh-lab/haolin/nhk/excerpts/2012_11_14_19_00_1.webm;Yoshihiko Noda.jpg;8213;8213;50569;273;273;0
/net/per920a/export/das14a/satoh-lab/haolin/nhk/excerpts/2012_11_14_19_00_1.webm;Yoshihiko Noda.jpg;8225;8225;50569;274;274;0
/net/per920a/export/das14a/satoh-lab/haolin/nhk/excerpts/2012_11_14_19_00_1.webm;Yoshihiko Noda.jpg;8241;8245;50569;274;275;1
/net/per920a/export/das14a/satoh-lab/haolin/nhk/excerpts/2012_11_14_19_00_1.webm;Yoshihiko Noda.jpg;8261;8265;50569;275;275;0
/net/per920a/export/das14a/satoh-lab/haolin/nhk/excerpts/2012_11_14_19_00_1.webm;Yoshihiko Noda.jpg;8277;8281;50569;276;276;0
/net/per920a/export/das14a/satoh-lab/haolin/nhk/excerpts/2012_11_14_19_00_1.webm;Yoshihiko Noda.jpg;8321;8321;50569;277;277;0
/net/per920a/export/das14a/satoh-lab/haolin/nhk/excerpts/2012_11_14_19_00_1.webm;Yoshihiko Noda.jpg;8369;8373;50569;279;279;0
/net/per920a/export/das14a/satoh-lab/haolin/nhk/excerpts/2012_11_14_19_00_1.webm;Yoshihiko Noda.jpg;8401;8409;50569;280;280;0
/net/per920a/export/das14a/satoh-lab/haolin/nhk/excerpts/2012_11_14_19_00_1.webm;Yoshihiko Noda.jpg;8445;8625;50569;281;287;6
/net/per920a/export/das14a/satoh-lab/haolin/nhk/excerpts/2012_11_14_19_00_1.webm;Yoshihiko Noda.jpg;8665;8665;50569;289;289;0
/net/per920a/export/das14a/satoh-lab/haolin/nhk/excerpts/2012_11_14_19_00_1.webm;Yoshihiko Noda.jpg;8677;8833;50569;289;294;5
/net/per920a/export/das14a/satoh-lab/haolin/nhk/excerpts/2012_11_14_19_00_1.webm;Yoshihiko Noda.jpg;8853;8853;50569;295;295;0
/net/per920a/export/das14a/satoh-lab/haolin/nhk/excerpts/2012_11_14_19_00_1.webm;Yoshihiko Noda.jpg;8869;8909;50569;295;297;2
/net/per920a/export/das14a/satoh-lab/haolin/nhk/excerpts/2012_11_14_19_00_1.webm;Yoshihiko Noda.jpg;8925;8969;50569;297;299;2
/net/per920a/export/das14a/satoh-lab/haolin/nhk/excerpts/2012_11_14_19_00_1.webm;Yoshihiko Noda.jpg;8981;9073;50569;299;302;3
/net/per920a/export/das14a/satoh-lab/haolin/nhk/excerpts/2012_11_14_19_00_1.webm;Yoshihiko Noda.jpg;9089;9177;50569;303;306;3
/net/per920a/export/das14a/satoh-lab/haolin/nhk/excerpts/2012_11_14_19_00_1.webm;Yoshihiko Noda.jpg;9189;9193;50569;306;306;0
/net/per920a/export/das14a/satoh-lab/haolin/nhk/excerpts/2012_11_14_19_00_1.webm;Yoshihiko Noda.jpg;9265;9293;50569;309;310;1
/net/per920a/export/das14a/satoh-lab/haolin/nhk/excerpts/2012_11_14_19_00_1.webm;Yoshihiko Noda.jpg;9317;9317;50569;310;310;0
/net/per920a/export/das14a/satoh-lab/haolin/nhk/excerpts/2012_11_14_19_00_1.webm;Yoshihiko Noda.jpg;9369;9369;50569;312;312;0
/net/per920a/export/das14a/satoh-lab/haolin/nhk/excerpts/2012_11_14_19_00_1.webm;Yoshihiko Noda.jpg;9857;10229;50569;328;341;13
/net/per920a/export/das14a/satoh-lab/haolin/nhk/excerpts/2012_11_14_19_00_1.webm;Yoshihiko Noda.jpg;11297;11317;50569;376;377;1
/net/per920a/export/das14a/satoh-lab/haolin/nhk/excerpts/2012_11_14_19_00_1.webm;Yoshihiko Noda.jpg;11341;11817;50569;378;394;16
/net/per920a/export/das14a/satoh-lab/haolin/nhk/excerpts/2012_11_14_19_00_1.webm;Yoshihiko Noda.jpg;11849;11921;50569;395;397;2
/net/per920a/export/das14a/satoh-lab/haolin/nhk/excerpts/2012_11_14_19_00_1.webm;Yoshihiko Noda.jpg;11969;11985;50569;399;399;0
/net/per920a/export/das14a/satoh-lab/haolin/nhk/excerpts/2012_11_14_19_00_1.webm;Yoshihiko Noda.jpg;12001;12013;50569;400;400;0
/net/per920a/export/das14a/satoh-lab/haolin/nhk/excerpts/2012_11_14_19_00_1.webm;Yoshihiko Noda.jpg;12025;12025;50569;401;401;0
/net/per920a/export/das14a/satoh-lab/haolin/nhk/excerpts/2012_11_14_19_00_1.webm;Yoshihiko Noda.jpg;12049;12053;50569;401;402;1
/net/per920a/export/das14a/satoh-lab/haolin/nhk/excerpts/2012_11_14_19_00_1.webm;Yoshihiko Noda.jpg;12089;12137;50569;403;404;1
/net/per920a/export/das14a/satoh-lab/haolin/nhk/excerpts/2012_11_14_19_00_1.webm;Yoshihiko Noda.jpg;13113;13157;50569;437;438;1
/net/per920a/export/das14a/satoh-lab/haolin/nhk/excerpts/2012_11_14_19_00_1.webm;Yoshihiko Noda.jpg;13173;13177;50569;439;439;0
/net/per920a/export/das14a/satoh-lab/haolin/nhk/excerpts/2012_11_14_19_00_1.webm;Yoshihiko Noda.jpg;13193;13225;50569;440;441;1
/net/per920a/export/das14a/satoh-lab/haolin/nhk/excerpts/2012_11_14_19_00_1.webm;Yoshihiko Noda.jpg;13253;13257;50569;442;442;0
/net/per920a/export/das14a/satoh-lab/haolin/nhk/excerpts/2012_11_14_19_00_1.webm;Yoshihiko Noda.jpg;13277;13277;50569;442;442;0
/net/per920a/export/das14a/satoh-lab/haolin/nhk/excerpts/2012_11_14_19_00_1.webm;Yoshihiko Noda.jpg;13301;13377;50569;443;446;3
/net/per920a/export/das14a/satoh-lab/haolin/nhk/excerpts/2012_11_14_19_00_1.webm;Yoshihiko Noda.jpg;13389;13389;50569;446;446;0
/net/per920a/export/das14a/satoh-lab/haolin/nhk/excerpts/2012_11_14_19_00_1.webm;Yoshihiko Noda.jpg;13401;13581;50569;447;453;6
/net/per920a/export/das14a/satoh-lab/haolin/nhk/excerpts/2012_11_14_19_00_1.webm;Yoshihiko Noda.jpg;13597;13753;50569;453;458;5
/net/per920a/export/das14a/satoh-lab/haolin/nhk/excerpts/2012_11_14_19_00_1.webm;Yoshihiko Noda.jpg;20041;20153;50569;668;672;4
/net/per920a/export/das14a/satoh-lab/haolin/nhk/excerpts/2012_11_14_19_00_1.webm;Yoshihiko Noda.jpg;20973;21001;50569;699;700;1
/net/per920a/export/das14a/satoh-lab/haolin/nhk/excerpts/2012_11_14_19_00_1.webm;Yoshihiko Noda.jpg;21021;21029;50569;701;701;0
/net/per920a/export/das14a/satoh-lab/haolin/nhk/excerpts/2012_11_14_19_00_1.webm;Yoshihiko Noda.jpg;21041;21133;50569;701;705;4
/net/per920a/export/das14a/satoh-lab/haolin/nhk/excerpts/2012_11_14_19_00_1.webm;Yoshihiko Noda.jpg;21729;21789;50569;724;726;2
/net/per920a/export/das14a/satoh-lab/haolin/nhk/excerpts/2012_11_14_19_00_1.webm;Yoshihiko Noda.jpg;21829;21829;50569;728;728;0
/net/per920a/export/das14a/satoh-lab/haolin/nhk/excerpts/2012_11_14_19_00_1.webm;Yoshihiko Noda.jpg;21889;21901;50569;730;730;0
/net/per920a/export/das14a/satoh-lab/haolin/nhk/excerpts/2012_11_14_19_00_1.webm;Shinzo ABE.jpg;525;525;50569;17;17;0
/net/per920a/export/das14a/satoh-lab/haolin/nhk/excerpts/2012_11_14_19_00_1.webm;Shinzo ABE.jpg;537;645;50569;17;21;4
/net/per920a/export/das14a/satoh-lab/haolin/nhk/excerpts/2012_11_14_19_00_1.webm;Shinzo ABE.jpg;4493;4525;50569;149;150;1
/net/per920a/export/das14a/satoh-lab/haolin/nhk/excerpts/2012_11_14_19_00_1.webm;Shinzo ABE.jpg;4781;4781;50569;159;159;0
/net/per920a/export/das14a/satoh-lab/haolin/nhk/excerpts/2012_11_14_19_00_1.webm;Shinzo ABE.jpg;4845;4877;50569;161;162;1
/net/per920a/export/das14a/satoh-lab/haolin/nhk/excerpts/2012_11_14_19_00_1.webm;Shinzo ABE.jpg;4893;4909;50569;163;163;0
/net/per920a/export/das14a/satoh-lab/haolin/nhk/excerpts/2012_11_14_19_00_1.webm;Shinzo ABE.jpg;5193;5213;50569;173;173;0
/net/per920a/export/das14a/satoh-lab/haolin/nhk/excerpts/2012_11_14_19_00_1.webm;Shinzo ABE.jpg;5225;5241;50569;174;174;0
/net/per920a/export/das14a/satoh-lab/haolin/nhk/excerpts/2012_11_14_19_00_1.webm;Shinzo ABE.jpg;7585;7597;50569;253;253;0
/net/per920a/export/das14a/satoh-lab/haolin/nhk/excerpts/2012_11_14_19_00_1.webm;Shinzo ABE.jpg;7613;7697;50569;253;256;3
/net/per920a/export/das14a/satoh-lab/haolin/nhk/excerpts/2012_11_14_19_00_1.webm;Shinzo ABE.jpg;7725;7749;50569;257;258;1
/net/per920a/export/das14a/satoh-lab/haolin/nhk/excerpts/2012_11_14_19_00_1.webm;Shinzo ABE.jpg;7789;7821;50569;259;260;1
/net/per920a/export/das14a/satoh-lab/haolin/nhk/excerpts/2012_11_14_19_00_1.webm;Shinzo ABE.jpg;7837;7837;50569;261;261;0
/net/per920a/export/das14a/satoh-lab/haolin/nhk/excerpts/2012_11_14_19_00_1.webm;Shinzo ABE.jpg;7865;7897;50569;262;263;1
/net/per920a/export/das14a/satoh-lab/haolin/nhk/excerpts/2012_11_14_19_00_1.webm;Shinzo ABE.jpg;9449;9489;50569;315;316;1
/net/per920a/export/das14a/satoh-lab/haolin/nhk/excerpts/2012_11_14_19_00_1.webm;Shinzo ABE.jpg;9525;9549;50569;317;318;1
/net/per920a/export/das14a/satoh-lab/haolin/nhk/excerpts/2012_11_14_19_00_1.webm;Shinzo ABE.jpg;9569;9585;50569;319;319;0
/net/per920a/export/das14a/satoh-lab/haolin/nhk/excerpts/2012_11_14_19_00_1.webm;Shinzo ABE.jpg;9785;9845;50569;326;328;2
/net/per920a/export/das14a/satoh-lab/haolin/nhk/excerpts/2012_11_14_19_00_1.webm;Shinzo ABE.jpg;10241;10277;50569;341;342;1
/net/per920a/export/das14a/satoh-lab/haolin/nhk/excerpts/2012_11_14_19_00_1.webm;Shinzo ABE.jpg;10329;10337;50569;344;344;0
/net/per920a/export/das14a/satoh-lab/haolin/nhk/excerpts/2012_11_14_19_00_1.webm;Shinzo ABE.jpg;14349;16357;50569;478;545;67
/net/per920a/export/das14a/satoh-lab/haolin/nhk/excerpts/2012_11_14_19_00_1.webm;Ichiro OZAWA.jpg;10521;10533;50569;350;351;1
/net/per920a/export/das14a/satoh-lab/haolin/nhk/excerpts/2012_11_14_19_00_1.webm;Ichiro OZAWA.jpg;10553;10565;50569;352;352;0
/net/per920a/export/das14a/satoh-lab/haolin/nhk/excerpts/2012_11_14_19_00_1.webm;Ichiro OZAWA.jpg;10585;10593;50569;353;353;0
/net/per920a/export/das14a/satoh-lab/haolin/nhk/excerpts/2012_11_14_19_00_1.webm;Ichiro OZAWA.jpg;10613;10677;50569;354;356;2
/net/per920a/export/das14a/satoh-lab/haolin/nhk/excerpts/2012_11_14_19_00_1.webm;Ichiro OZAWA.jpg;10705;10733;50569;357;358;1
/net/per920a/export/das14a/satoh-lab/haolin/nhk/excerpts/2012_11_14_19_00_1.webm;Ichiro OZAWA.jpg;10825;10869;50569;361;362;1
/net/per920a/export/das14a/satoh-lab/haolin/nhk/excerpts/2012_11_14_19_00_1.webm;Ichiro OZAWA.jpg;10881;10885;50569;362;363;1
/net/per920a/export/das14a/satoh-lab/haolin/nhk/excerpts/2012_11_14_19_00_1.webm;Ichiro OZAWA.jpg;10897;10897;50569;363;363;0
/net/per920a/export/das14a/satoh-lab/haolin/nhk/excerpts/2012_11_14_19_00_1.webm;Ichiro OZAWA.jpg;10929;10969;50569;364;365;1
/net/per920a/export/das14a/satoh-lab/haolin/nhk/excerpts/2012_11_14_19_00_1.webm;Ichiro OZAWA.jpg;10985;10985;50569;366;366;0
/net/per920a/export/das14a/satoh-lab/haolin/nhk/excerpts/2012_11_14_19_00_1.webm;Ichiro OZAWA.jpg;11001;11001;50569;366;366;0
/net/per920a/export/das14a/satoh-lab/haolin/nhk/excerpts/2012_11_14_19_00_1.webm;Ichiro OZAWA.jpg;11029;11077;50569;367;369;2
/net/per920a/export/das14a/satoh-lab/haolin/nhk/excerpts/2012_11_14_19_00_1.webm;Ichiro OZAWA.jpg;11113;11113;50569;370;370;0
/net/per920a/export/das14a/satoh-lab/haolin/nhk/excerpts/2012_11_14_19_00_1.webm;Ichiro OZAWA.jpg;11137;11137;50569;371;371;0
/net/per920a/export/das14a/satoh-lab/haolin/nhk/excerpts/2012_11_14_19_00_1.webm;Ichiro OZAWA.jpg;11149;11153;50569;371;372;1
/net/per920a/export/das14a/satoh-lab/haolin/nhk/excerpts/2012_11_14_19_00_1.webm;Ichiro OZAWA.jpg;11197;11197;50569;373;373;0
/net/per920a/export/das14a/satoh-lab/haolin/nhk/excerpts/2012_11_14_19_00_1.webm;Ichiro OZAWA.jpg;11209;11209;50569;373;373;0
/net/per920a/export/das14a/satoh-lab/haolin/nhk/excerpts/2012_11_14_19_00_1.webm;Ichiro OZAWA.jpg;11225;11225;50569;374;374;0
/net/per920a/export/das14a/satoh-lab/haolin/nhk/excerpts/2012_11_14_19_00_1.webm;Natsuo YAMAGUCHI.jpg;12729;12821;50569;424;427;3
/net/per920a/export/das14a/satoh-lab/haolin/nhk/excerpts/2012_11_14_19_00_1.webm;Natsuo YAMAGUCHI.jpg;12849;12885;50569;428;429;1
/net/per920a/export/das14a/satoh-lab/haolin/nhk/excerpts/2012_11_14_19_00_1.webm;Natsuo YAMAGUCHI.jpg;12897;12905;50569;430;430;0
/net/per920a/export/das14a/satoh-lab/haolin/nhk/excerpts/2012_11_14_19_00_1.webm;Natsuo YAMAGUCHI.jpg;12921;12969;50569;431;432;1
/net/per920a/export/das14a/satoh-lab/haolin/nhk/excerpts/2012_11_14_19_00_1.webm;Natsuo YAMAGUCHI.jpg;12985;13001;50569;433;433;0
/net/per920a/export/das14a/satoh-lab/haolin/nhk/excerpts/2012_11_14_19_00_1.webm;Seiji MAEHARA.jpg;17853;18141;50569;595;605;10
/net/per920a/export/das14a/satoh-lab/haolin/nhk/excerpts/2012_11_14_19_00_1.webm;Seiji MAEHARA.jpg;18157;18305;50569;605;610;5
/net/per920a/export/das14a/satoh-lab/haolin/nhk/excerpts/2012_11_14_19_00_1.webm;Seiji MAEHARA.jpg;18337;20029;50569;611;668;57
/net/per920a/export/das14a/satoh-lab/haolin/nhk/excerpts/2012_11_25_19_00_2.webm;Toru Hashimoto.jpg;9;13;2433;0;0;0
/net/per920a/export/das14a/satoh-lab/haolin/nhk/excerpts/2012_11_25_19_00_2.webm;Mizuho FUKUSHIMA.jpg;653;665;2433;21;22;1
/net/per920a/export/das14a/satoh-lab/haolin/nhk/excerpts/2012_11_25_19_00_2.webm;Mizuho FUKUSHIMA.jpg;681;713;2433;22;23;1
/net/per920a/export/das14a/satoh-lab/haolin/nhk/excerpts/2012_11_25_19_00_2.webm;Mizuho FUKUSHIMA.jpg;1025;1229;2433;34;40;6
/net/per920a/export/das14a/satoh-lab/haolin/nhk/excerpts/2012_11_25_19_00_2.webm;Mizuho FUKUSHIMA.jpg;1285;1297;2433;42;43;1
/net/per920a/export/das14a/satoh-lab/haolin/nhk/excerpts/2012_11_25_19_00_2.webm;Mizuho FUKUSHIMA.jpg;1313;1825;2433;43;60;17
/net/per920a/export/das14a/satoh-lab/haolin/nhk/excerpts/2012_11_27_19_00_3.webm;Yoshihiko Noda.jpg;13;85;6205;0;2;2
/net/per920a/export/das14a/satoh-lab/haolin/nhk/excerpts/2012_11_27_19_00_3.webm;Yoshihiko Noda.jpg;101;145;6205;3;4;1
/net/per920a/export/das14a/satoh-lab/haolin/nhk/excerpts/2012_11_27_19_00_3.webm;Yoshihiko Noda.jpg;157;201;6205;5;6;1
/net/per920a/export/das14a/satoh-lab/haolin/nhk/excerpts/2012_11_27_19_00_3.webm;Yoshihiko Noda.jpg;233;241;6205;7;8;1
/net/per920a/export/das14a/satoh-lab/haolin/nhk/excerpts/2012_11_27_19_00_3.webm;Yoshihiko Noda.jpg;253;253;6205;8;8;0
/net/per920a/export/das14a/satoh-lab/haolin/nhk/excerpts/2012_11_27_19_00_3.webm;Yoshihiko Noda.jpg;293;309;6205;9;10;1
/net/per920a/export/das14a/satoh-lab/haolin/nhk/excerpts/2012_11_27_19_00_3.webm;Yoshihiko Noda.jpg;333;337;6205;11;11;0
/net/per920a/export/das14a/satoh-lab/haolin/nhk/excerpts/2012_11_27_19_00_3.webm;Yoshihiko Noda.jpg;373;405;6205;12;13;1
/net/per920a/export/das14a/satoh-lab/haolin/nhk/excerpts/2012_11_27_19_00_3.webm;Yoshihiko Noda.jpg;421;441;6205;14;14;0
/net/per920a/export/das14a/satoh-lab/haolin/nhk/excerpts/2012_11_27_19_00_3.webm;Yoshihiko Noda.jpg;457;489;6205;15;16;1
/net/per920a/export/das14a/satoh-lab/haolin/nhk/excerpts/2012_11_27_19_00_3.webm;Yoshihiko Noda.jpg;517;529;6205;17;17;0
/net/per920a/export/das14a/satoh-lab/haolin/nhk/excerpts/2012_11_27_19_00_3.webm;Yoshihiko Noda.jpg;553;553;6205;18;18;0
/net/per920a/export/das14a/satoh-lab/haolin/nhk/excerpts/2012_11_27_19_00_3.webm;Yoshihiko Noda.jpg;577;589;6205;19;19;0
/net/per920a/export/das14a/satoh-lab/haolin/nhk/excerpts/2012_11_27_19_00_3.webm;Yoshihiko Noda.jpg;613;613;6205;20;20;0
/net/per920a/export/das14a/satoh-lab/haolin/nhk/excerpts/2012_11_27_19_00_3.webm;Yoshihiko Noda.jpg;629;629;6205;20;20;0
/net/per920a/export/das14a/satoh-lab/haolin/nhk/excerpts/2012_11_27_19_00_3.webm;Yoshihiko Noda.jpg;641;649;6205;21;21;0
/net/per920a/export/das14a/satoh-lab/haolin/nhk/excerpts/2012_11_27_19_00_3.webm;Yoshihiko Noda.jpg;693;693;6205;23;23;0
/net/per920a/export/das14a/satoh-lab/haolin/nhk/excerpts/2012_11_27_19_00_3.webm;Yoshihiko Noda.jpg;745;745;6205;24;24;0
/net/per920a/export/das14a/satoh-lab/haolin/nhk/excerpts/2012_11_27_19_00_3.webm;Yoshihiko Noda.jpg;761;761;6205;25;25;0
/net/per920a/export/das14a/satoh-lab/haolin/nhk/excerpts/2012_11_27_19_00_3.webm;Yoshihiko Noda.jpg;773;789;6205;25;26;1
/net/per920a/export/das14a/satoh-lab/haolin/nhk/excerpts/2012_11_27_19_00_3.webm;Yoshihiko Noda.jpg;805;813;6205;26;27;1
/net/per920a/export/das14a/satoh-lab/haolin/nhk/excerpts/2012_11_27_19_00_3.webm;Yoshihiko Noda.jpg;845;845;6205;28;28;0
/net/per920a/export/das14a/satoh-lab/haolin/nhk/excerpts/2012_11_27_19_00_3.webm;Yoshihiko Noda.jpg;873;873;6205;29;29;0
/net/per920a/export/das14a/satoh-lab/haolin/nhk/excerpts/2012_11_27_19_00_3.webm;Yoshihiko Noda.jpg;885;889;6205;29;29;0
/net/per920a/export/das14a/satoh-lab/haolin/nhk/excerpts/2012_11_27_19_00_3.webm;Yoshihiko Noda.jpg;905;905;6205;30;30;0
/net/per920a/export/das14a/satoh-lab/haolin/nhk/excerpts/2012_11_27_19_00_3.webm;Yoshihiko Noda.jpg;917;933;6205;30;31;1
/net/per920a/export/das14a/satoh-lab/haolin/nhk/excerpts/2012_11_27_19_00_3.webm;Yoshihiko Noda.jpg;961;965;6205;32;32;0
/net/per920a/export/das14a/satoh-lab/haolin/nhk/excerpts/2012_11_27_19_00_3.webm;Yoshihiko Noda.jpg;985;1029;6205;32;34;2
/net/per920a/export/das14a/satoh-lab/haolin/nhk/excerpts/2012_11_27_19_00_3.webm;Yoshihiko Noda.jpg;1045;1061;6205;34;35;1
/net/per920a/export/das14a/satoh-lab/haolin/nhk/excerpts/2012_11_27_19_00_3.webm;Yoshihiko Noda.jpg;1077;1141;6205;35;38;3
/net/per920a/export/das14a/satoh-lab/haolin/nhk/excerpts/2012_11_27_19_00_3.webm;Yoshihiko Noda.jpg;1173;1193;6205;39;39;0
/net/per920a/export/das14a/satoh-lab/haolin/nhk/excerpts/2012_11_27_19_00_3.webm;Yoshihiko Noda.jpg;1225;1225;6205;40;40;0
/net/per920a/export/das14a/satoh-lab/haolin/nhk/excerpts/2012_11_27_19_00_3.webm;Yoshihiko Noda.jpg;1237;1237;6205;41;41;0
/net/per920a/export/das14a/satoh-lab/haolin/nhk/excerpts/2012_11_27_19_00_3.webm;Yoshihiko Noda.jpg;1253;1277;6205;41;42;1
/net/per920a/export/das14a/satoh-lab/haolin/nhk/excerpts/2012_11_27_19_00_3.webm;Yoshihiko Noda.jpg;1293;1301;6205;43;43;0
/net/per920a/export/das14a/satoh-lab/haolin/nhk/excerpts/2012_11_27_19_00_3.webm;Yoshihiko Noda.jpg;1321;1329;6205;44;44;0
/net/per920a/export/das14a/satoh-lab/haolin/nhk/excerpts/2012_11_27_19_00_3.webm;Yoshihiko Noda.jpg;1349;1353;6205;45;45;0
/net/per920a/export/das14a/satoh-lab/haolin/nhk/excerpts/2012_11_27_19_00_3.webm;Yoshihiko Noda.jpg;1369;1385;6205;45;46;1
/net/per920a/export/das14a/satoh-lab/haolin/nhk/excerpts/2012_11_27_19_00_3.webm;Yoshihiko Noda.jpg;1413;1413;6205;47;47;0
/net/per920a/export/das14a/satoh-lab/haolin/nhk/excerpts/2012_11_27_19_00_3.webm;Yoshihiko Noda.jpg;1473;1481;6205;49;49;0
/net/per920a/export/das14a/satoh-lab/haolin/nhk/excerpts/2012_11_27_19_00_3.webm;Yoshihiko Noda.jpg;1505;1513;6205;50;50;0
/net/per920a/export/das14a/satoh-lab/haolin/nhk/excerpts/2012_11_27_19_00_3.webm;Yoshihiko Noda.jpg;1525;1533;6205;50;51;1
/net/per920a/export/das14a/satoh-lab/haolin/nhk/excerpts/2012_11_27_19_00_3.webm;Yoshihiko Noda.jpg;1549;1553;6205;51;51;0
/net/per920a/export/das14a/satoh-lab/haolin/nhk/excerpts/2012_11_27_19_00_3.webm;Yoshihiko Noda.jpg;1569;1597;6205;52;53;1
/net/per920a/export/das14a/satoh-lab/haolin/nhk/excerpts/2012_11_27_19_00_3.webm;Yoshihiko Noda.jpg;1609;1613;6205;53;53;0
/net/per920a/export/das14a/satoh-lab/haolin/nhk/excerpts/2012_11_27_19_00_3.webm;Yoshihiko Noda.jpg;1625;1629;6205;54;54;0
/net/per920a/export/das14a/satoh-lab/haolin/nhk/excerpts/2012_11_27_19_00_3.webm;Yoshihiko Noda.jpg;1653;1657;6205;55;55;0
/net/per920a/export/das14a/satoh-lab/haolin/nhk/excerpts/2012_11_27_19_00_3.webm;Yoshihiko Noda.jpg;1929;1933;6205;64;64;0
/net/per920a/export/das14a/satoh-lab/haolin/nhk/excerpts/2012_11_27_19_00_3.webm;Yoshihiko Noda.jpg;1973;1981;6205;65;66;1
/net/per920a/export/das14a/satoh-lab/haolin/nhk/excerpts/2012_11_27_19_00_3.webm;Yoshihiko Noda.jpg;2021;2037;6205;67;67;0
/net/per920a/export/das14a/satoh-lab/haolin/nhk/excerpts/2012_11_27_19_00_3.webm;Yoshihiko Noda.jpg;2049;2461;6205;68;82;14
/net/per920a/export/das14a/satoh-lab/haolin/nhk/excerpts/2012_11_27_19_00_3.webm;Yoshihiko Noda.jpg;2473;2473;6205;82;82;0
/net/per920a/export/das14a/satoh-lab/haolin/nhk/excerpts/2012_11_27_19_00_3.webm;Yoshihiko Noda.jpg;2489;2505;6205;83;83;0
/net/per920a/export/das14a/satoh-lab/haolin/nhk/excerpts/2012_11_27_19_00_3.webm;Yoshihiko Noda.jpg;2529;2565;6205;84;85;1
/net/per920a/export/das14a/satoh-lab/haolin/nhk/excerpts/2012_11_27_19_00_3.webm;Yoshihiko Noda.jpg;2589;2593;6205;86;86;0
/net/per920a/export/das14a/satoh-lab/haolin/nhk/excerpts/2012_11_27_19_00_3.webm;Yoshihiko Noda.jpg;2761;2765;6205;92;92;0
/net/per920a/export/das14a/satoh-lab/haolin/nhk/excerpts/2012_11_27_19_00_3.webm;Yoshihiko Noda.jpg;2801;2801;6205;93;93;0
/net/per920a/export/das14a/satoh-lab/haolin/nhk/excerpts/2012_11_27_19_00_3.webm;Yoshihiko Noda.jpg;2837;2837;6205;94;94;0
/net/per920a/export/das14a/satoh-lab/haolin/nhk/excerpts/2012_11_27_19_00_3.webm;Yoshihiko Noda.jpg;2869;2869;6205;95;95;0
/net/per920a/export/das14a/satoh-lab/haolin/nhk/excerpts/2012_11_27_19_00_3.webm;Yoshihiko Noda.jpg;2901;3421;6205;96;114;18
/net/per920a/export/das14a/satoh-lab/haolin/nhk/excerpts/2012_11_27_19_00_3.webm;Yoshihiko Noda.jpg;3433;3445;6205;114;114;0
/net/per920a/export/das14a/satoh-lab/haolin/nhk/excerpts/2012_11_27_19_00_3.webm;Yoshihiko Noda.jpg;3473;3473;6205;115;115;0
/net/per920a/export/das14a/satoh-lab/haolin/nhk/excerpts/2012_11_27_19_00_3.webm;Yoshihiko Noda.jpg;3545;3553;6205;118;118;0
/net/per920a/export/das14a/satoh-lab/haolin/nhk/excerpts/2012_11_27_19_00_3.webm;Yoshihiko Noda.jpg;3589;3605;6205;119;120;1
/net/per920a/export/das14a/satoh-lab/haolin/nhk/excerpts/2012_11_27_19_00_3.webm;Yoshihiko Noda.jpg;3657;3665;6205;121;122;1
/net/per920a/export/das14a/satoh-lab/haolin/nhk/excerpts/2012_11_27_19_00_3.webm;Yoshihiko Noda.jpg;3697;3705;6205;123;123;0
/net/per920a/export/das14a/satoh-lab/haolin/nhk/excerpts/2012_11_27_19_00_3.webm;Yoshihiko Noda.jpg;3753;3753;6205;125;125;0
/net/per920a/export/das14a/satoh-lab/haolin/nhk/excerpts/2012_11_27_19_00_3.webm;Yoshihiko Noda.jpg;3777;3785;6205;126;126;0
/net/per920a/export/das14a/satoh-lab/haolin/nhk/excerpts/2012_11_27_19_00_3.webm;Yoshihiko Noda.jpg;4633;4649;6205;154;155;1
/net/per920a/export/das14a/satoh-lab/haolin/nhk/excerpts/2012_11_27_19_00_3.webm;Yoshihiko Noda.jpg;4669;4741;6205;155;158;3
/net/per920a/export/das14a/satoh-lab/haolin/nhk/excerpts/2012_11_27_19_00_3.webm;Yoshihiko Noda.jpg;4761;4765;6205;158;158;0
/net/per920a/export/das14a/satoh-lab/haolin/nhk/excerpts/2012_11_27_19_00_3.webm;Yoshihiko Noda.jpg;4777;4777;6205;159;159;0
/net/per920a/export/das14a/satoh-lab/haolin/nhk/excerpts/2012_11_27_19_00_3.webm;Yoshihiko Noda.jpg;4937;4953;6205;164;165;1
/net/per920a/export/das14a/satoh-lab/haolin/nhk/excerpts/2012_11_27_19_00_3.webm;Yoshihiko Noda.jpg;4965;5157;6205;165;172;7
/net/per920a/export/das14a/satoh-lab/haolin/nhk/excerpts/2012_11_28_19_00_1.webm;Yoshihiko Noda.jpg;805;941;16217;26;31;5
/net/per920a/export/das14a/satoh-lab/haolin/nhk/excerpts/2012_11_28_19_00_1.webm;Yoshihiko Noda.jpg;965;993;16217;32;33;1
/net/per920a/export/das14a/satoh-lab/haolin/nhk/excerpts/2012_11_28_19_00_1.webm;Yoshihiko Noda.jpg;1005;1149;16217;33;38;5
/net/per920a/export/das14a/satoh-lab/haolin/nhk/excerpts/2012_11_28_19_00_1.webm;Yoshihiko Noda.jpg;1165;1269;16217;38;42;4
/net/per920a/export/das14a/satoh-lab/haolin/nhk/excerpts/2012_11_28_19_00_1.webm;Yoshihiko Noda.jpg;1281;1305;16217;42;43;1
/net/per920a/export/das14a/satoh-lab/haolin/nhk/excerpts/2012_11_28_19_00_1.webm;Yoshihiko Noda.jpg;1329;1405;16217;44;46;2
/net/per920a/export/das14a/satoh-lab/haolin/nhk/excerpts/2012_11_28_19_00_1.webm;Yoshihiko Noda.jpg;1421;1605;16217;47;53;6
/net/per920a/export/das14a/satoh-lab/haolin/nhk/excerpts/2012_11_28_19_00_1.webm;Yoshihiko Noda.jpg;2109;2125;16217;70;70;0
/net/per920a/export/das14a/satoh-lab/haolin/nhk/excerpts/2012_11_28_19_00_1.webm;Yoshihiko Noda.jpg;2141;2165;16217;71;72;1
/net/per920a/export/das14a/satoh-lab/haolin/nhk/excerpts/2012_11_28_19_00_1.webm;Yoshihiko Noda.jpg;2181;2329;16217;72;77;5
/net/per920a/export/das14a/satoh-lab/haolin/nhk/excerpts/2012_11_28_19_00_1.webm;Yoshihiko Noda.jpg;2345;2829;16217;78;94;16
/net/per920a/export/das14a/satoh-lab/haolin/nhk/excerpts/2012_11_28_19_00_1.webm;Yoshihiko Noda.jpg;2845;2865;16217;94;95;1
/net/per920a/export/das14a/satoh-lab/haolin/nhk/excerpts/2012_11_28_19_00_1.webm;Shinzo ABE.jpg;1789;1797;16217;59;59;0
/net/per920a/export/das14a/satoh-lab/haolin/nhk/excerpts/2012_11_28_19_00_1.webm;Shinzo ABE.jpg;1817;1849;16217;60;61;1
/net/per920a/export/das14a/satoh-lab/haolin/nhk/excerpts/2012_11_28_19_00_1.webm;Shinzo ABE.jpg;1865;1885;16217;62;62;0
/net/per920a/export/das14a/satoh-lab/haolin/nhk/excerpts/2012_11_28_19_00_1.webm;Shinzo ABE.jpg;1933;1961;16217;64;65;1
/net/per920a/export/das14a/satoh-lab/haolin/nhk/excerpts/2012_11_28_19_00_1.webm;Shinzo ABE.jpg;1997;2097;16217;66;69;3
/net/per920a/export/das14a/satoh-lab/haolin/nhk/excerpts/2012_11_28_19_00_1.webm;Shinzo ABE.jpg;2109;2125;16217;70;70;0
/net/per920a/export/das14a/satoh-lab/haolin/nhk/excerpts/2012_11_28_19_00_1.webm;Shinzo ABE.jpg;2141;2165;16217;71;72;1
/net/per920a/export/das14a/satoh-lab/haolin/nhk/excerpts/2012_11_28_19_00_1.webm;Shinzo ABE.jpg;2181;2329;16217;72;77;5
/net/per920a/export/das14a/satoh-lab/haolin/nhk/excerpts/2012_11_28_19_00_1.webm;Shinzo ABE.jpg;2345;2829;16217;78;94;16
/net/per920a/export/das14a/satoh-lab/haolin/nhk/excerpts/2012_11_28_19_00_1.webm;Shinzo ABE.jpg;2845;2865;16217;94;95;1
/net/per920a/export/das14a/satoh-lab/haolin/nhk/excerpts/2012_11_28_19_00_1.webm;Ichiro OZAWA.jpg;3913;3933;16217;130;131;1
/net/per920a/export/das14a/satoh-lab/haolin/nhk/excerpts/2012_11_28_19_00_1.webm;Ichiro OZAWA.jpg;3945;3961;16217;131;132;1
/net/per920a/export/das14a/satoh-lab/haolin/nhk/excerpts/2012_11_28_19_00_1.webm;Ichiro OZAWA.jpg;3977;4009;16217;132;133;1
/net/per920a/export/das14a/satoh-lab/haolin/nhk/excerpts/2012_11_28_19_00_1.webm;Ichiro OZAWA.jpg;4021;4021;16217;134;134;0
/net/per920a/export/das14a/satoh-lab/haolin/nhk/excerpts/2012_11_28_19_00_1.webm;Ichiro OZAWA.jpg;4033;4041;16217;134;134;0
/net/per920a/export/das14a/satoh-lab/haolin/nhk/excerpts/2012_11_28_19_00_1.webm;Ichiro OZAWA.jpg;4053;4069;16217;135;135;0
/net/per920a/export/das14a/satoh-lab/haolin/nhk/excerpts/2012_11_28_19_00_1.webm;Ichiro OZAWA.jpg;4081;4149;16217;136;138;2
/net/per920a/export/das14a/satoh-lab/haolin/nhk/excerpts/2012_11_28_19_00_1.webm;Shizuka KAMEI.jpg;5149;5165;16217;171;172;1
/net/per920a/export/das14a/satoh-lab/haolin/nhk/excerpts/2012_11_28_19_00_1.webm;Shizuka KAMEI.jpg;5181;5625;16217;172;187;15
/net/per920a/export/das14a/satoh-lab/haolin/nhk/excerpts/2012_11_28_19_00_1.webm;Mizuho FUKUSHIMA.jpg;12617;12993;16217;420;433;13
/net/per920a/export/das14a/satoh-lab/haolin/nhk/excerpts/2012_11_28_19_00_1.webm;Yoshimi WATANABE.jpg;13641;13837;16217;455;461;6
/net/per920a/export/das14a/satoh-lab/haolin/nhk/excerpts/2012_11_28_19_00_1.webm;Yoshimi WATANABE.jpg;13857;13933;16217;462;464;2
/net/per920a/export/das14a/satoh-lab/haolin/nhk/excerpts/2012_11_28_19_00_1.webm;Yoshimi WATANABE.jpg;13949;13957;16217;465;465;0
/net/per920a/export/das14a/satoh-lab/haolin/nhk/excerpts/2012_11_28_19_00_1.webm;Yoshimi WATANABE.jpg;13969;13997;16217;466;466;0
/net/per920a/export/das14a/satoh-lab/haolin/nhk/excerpts/2012_11_28_19_00_1.webm;Yoshimi WATANABE.jpg;14013;14025;16217;467;467;0
/net/per920a/export/das14a/satoh-lab/haolin/nhk/excerpts/2012_11_28_19_00_1.webm;Yoshimi WATANABE.jpg;14049;14077;16217;468;469;1
/net/per920a/export/das14a/satoh-lab/haolin/nhk/excerpts/2012_11_28_19_00_1.webm;Yoshimi WATANABE.jpg;14089;14189;16217;470;473;3
/net/per920a/export/das14a/satoh-lab/haolin/nhk/excerpts/2012_11_28_19_00_1.webm;Yoshimi WATANABE.jpg;14289;14353;16217;476;478;2
/net/per920a/export/das14a/satoh-lab/haolin/nhk/excerpts/2012_11_28_19_00_1.webm;Yoshimi WATANABE.jpg;14369;14445;16217;479;481;2
/net/per920a/export/das14a/satoh-lab/haolin/nhk/excerpts/2012_11_28_19_00_1.webm;Yoshimi WATANABE.jpg;14465;14481;16217;482;483;1
/net/per920a/export/das14a/satoh-lab/haolin/nhk/excerpts/2012_11_28_19_00_1.webm;Yoshimi WATANABE.jpg;14501;14505;16217;483;483;0
/net/per920a/export/das14a/satoh-lab/haolin/nhk/excerpts/2012_11_28_19_00_1.webm;Yoshimi WATANABE.jpg;14517;14577;16217;484;486;2
/net/per920a/export/das14a/satoh-lab/haolin/nhk/excerpts/2012_11_28_19_00_1.webm;Yoshimi WATANABE.jpg;14593;14593;16217;486;486;0
/net/per920a/export/das14a/satoh-lab/haolin/nhk/excerpts/2012_11_28_19_00_1.webm;Yoshimi WATANABE.jpg;14605;14605;16217;487;487;0
/net/per920a/export/das14a/satoh-lab/haolin/nhk/excerpts/2012_11_28_19_00_1.webm;Yoshimi WATANABE.jpg;14617;14625;16217;487;487;0
/net/per920a/export/das14a/satoh-lab/haolin/nhk/excerpts/2012_11_28_19_00_1.webm;Yoshimi WATANABE.jpg;14637;14641;16217;488;488;0
/net/per920a/export/das14a/satoh-lab/haolin/nhk/excerpts/2012_11_28_19_00_1.webm;Yoshimi WATANABE.jpg;14657;14661;16217;488;489;1
/net/per920a/export/das14a/satoh-lab/haolin/nhk/excerpts/2012_11_28_19_00_1.webm;Yoshimi WATANABE.jpg;14677;14821;16217;489;494;5
/net/per920a/export/das14a/satoh-lab/haolin/nhk/excerpts/2012_11_28_19_00_1.webm;Yoshimi WATANABE.jpg;14849;14949;16217;495;498;3
/net/per920a/export/das14a/satoh-lab/haolin/nhk/excerpts/2012_11_29_19_00_1.webm;Yoshihiko Noda.jpg;637;753;18409;21;25;4
/net/per920a/export/das14a/satoh-lab/haolin/nhk/excerpts/2012_11_29_19_00_1.webm;Yoshihiko Noda.jpg;769;869;18409;25;28;3
/net/per920a/export/das14a/satoh-lab/haolin/nhk/excerpts/2012_11_29_19_00_1.webm;Yoshihiko Noda.jpg;885;1905;18409;29;63;34
/net/per920a/export/das14a/satoh-lab/haolin/nhk/excerpts/2012_11_29_19_00_1.webm;Yoshihiko Noda.jpg;1921;2165;18409;64;72;8
/net/per920a/export/das14a/satoh-lab/haolin/nhk/excerpts/2012_11_29_19_00_1.webm;Yoshihiko Noda.jpg;2181;2205;18409;72;73;1
/net/per920a/export/das14a/satoh-lab/haolin/nhk/excerpts/2012_11_29_19_00_1.webm;Yoshihiko Noda.jpg;2221;2237;18409;74;74;0
/net/per920a/export/das14a/satoh-lab/haolin/nhk/excerpts/2012_11_29_19_00_1.webm;Yoshihiko Noda.jpg;2253;2277;18409;75;75;0
/net/per920a/export/das14a/satoh-lab/haolin/nhk/excerpts/2012_11_29_19_00_1.webm;Shinzo ABE.jpg;2293;2329;18409;76;77;1
/net/per920a/export/das14a/satoh-lab/haolin/nhk/excerpts/2012_11_29_19_00_1.webm;Shinzo ABE.jpg;2381;2409;18409;79;80;1
/net/per920a/export/das14a/satoh-lab/haolin/nhk/excerpts/2012_11_29_19_00_1.webm;Shinzo ABE.jpg;2521;2525;18409;84;84;0
/net/per920a/export/das14a/satoh-lab/haolin/nhk/excerpts/2012_11_29_19_00_1.webm;Shinzo ABE.jpg;2605;2609;18409;86;87;1
/net/per920a/export/das14a/satoh-lab/haolin/nhk/excerpts/2012_11_29_19_00_1.webm;Shinzo ABE.jpg;2657;2741;18409;88;91;3
/net/per920a/export/das14a/satoh-lab/haolin/nhk/excerpts/2012_11_29_19_00_1.webm;Shinzo ABE.jpg;2757;2833;18409;91;94;3
/net/per920a/export/das14a/satoh-lab/haolin/nhk/excerpts/2012_11_29_19_00_1.webm;Shinzo ABE.jpg;2849;2857;18409;95;95;0
/net/per920a/export/das14a/satoh-lab/haolin/nhk/excerpts/2012_11_29_19_00_1.webm;Shinzo ABE.jpg;2873;2953;18409;95;98;3
/net/per920a/export/das14a/satoh-lab/haolin/nhk/excerpts/2012_11_29_19_00_1.webm;Shinzo ABE.jpg;2977;3321;18409;99;110;11
/net/per920a/export/das14a/satoh-lab/haolin/nhk/excerpts/2012_11_29_19_00_1.webm;Shinzo ABE.jpg;3337;3345;18409;111;111;0
/net/per920a/export/das14a/satoh-lab/haolin/nhk/excerpts/2012_11_29_19_00_1.webm;Shinzo ABE.jpg;3365;3369;18409;112;112;0
/net/per920a/export/das14a/satoh-lab/haolin/nhk/excerpts/2012_11_29_19_00_1.webm;Shinzo ABE.jpg;3389;3405;18409;113;113;0
/net/per920a/export/das14a/satoh-lab/haolin/nhk/excerpts/2012_11_29_19_00_1.webm;Shinzo ABE.jpg;3421;3421;18409;114;114;0
/net/per920a/export/das14a/satoh-lab/haolin/nhk/excerpts/2012_11_29_19_00_1.webm;Shinzo ABE.jpg;3481;3489;18409;116;116;0
/net/per920a/export/das14a/satoh-lab/haolin/nhk/excerpts/2012_11_29_19_00_1.webm;Shintaro ISHIHARA.jpg;7437;7477;18409;248;249;1
/net/per920a/export/das14a/satoh-lab/haolin/nhk/excerpts/2012_11_29_19_00_1.webm;Shintaro ISHIHARA.jpg;7497;7497;18409;250;250;0
/net/per920a/export/das14a/satoh-lab/haolin/nhk/excerpts/2012_11_29_19_00_1.webm;Shintaro ISHIHARA.jpg;7513;7521;18409;250;250;0
/net/per920a/export/das14a/satoh-lab/haolin/nhk/excerpts/2012_11_29_19_00_1.webm;Shintaro ISHIHARA.jpg;7537;7797;18409;251;260;9
/net/per920a/export/das14a/satoh-lab/haolin/nhk/excerpts/2012_11_29_19_00_1.webm;Shintaro ISHIHARA.jpg;7953;7953;18409;265;265;0
/net/per920a/export/das14a/satoh-lab/haolin/nhk/excerpts/2012_11_29_19_00_1.webm;Shintaro ISHIHARA.jpg;7965;8029;18409;265;267;2
/net/per920a/export/das14a/satoh-lab/haolin/nhk/excerpts/2012_11_29_19_00_1.webm;Shintaro ISHIHARA.jpg;8137;8241;18409;271;274;3
/net/per920a/export/das14a/satoh-lab/haolin/nhk/excerpts/2012_11_29_19_00_1.webm;Shintaro ISHIHARA.jpg;8253;8977;18409;275;299;24
/net/per920a/export/das14a/satoh-lab/haolin/nhk/excerpts/2012_11_29_19_00_1.webm;Shintaro ISHIHARA.jpg;8989;9149;18409;299;305;6
/net/per920a/export/das14a/satoh-lab/haolin/nhk/excerpts/2012_11_29_19_00_1.webm;Shintaro ISHIHARA.jpg;11649;11921;18409;388;397;9
/net/per920a/export/das14a/satoh-lab/haolin/nhk/excerpts/2012_11_29_19_00_1.webm;Shintaro ISHIHARA.jpg;11933;12037;18409;398;401;3
/net/per920a/export/das14a/satoh-lab/haolin/nhk/excerpts/2012_11_29_19_00_1.webm;Shintaro ISHIHARA.jpg;12245;12425;18409;408;414;6
/net/per920a/export/das14a/satoh-lab/haolin/nhk/excerpts/2012_11_29_19_00_1.webm;Shintaro ISHIHARA.jpg;12853;12949;18409;428;431;3
/net/per920a/export/das14a/satoh-lab/haolin/nhk/excerpts/2012_11_29_19_00_1.webm;Shintaro ISHIHARA.jpg;12965;12989;18409;432;433;1
/net/per920a/export/das14a/satoh-lab/haolin/nhk/excerpts/2012_11_29_19_00_1.webm;Shintaro ISHIHARA.jpg;13005;13049;18409;433;435;2
/net/per920a/export/das14a/satoh-lab/haolin/nhk/excerpts/2012_11_29_19_00_1.webm;Shintaro ISHIHARA.jpg;13073;13097;18409;436;436;0
/net/per920a/export/das14a/satoh-lab/haolin/nhk/excerpts/2012_11_29_19_00_1.webm;Shintaro ISHIHARA.jpg;13117;13117;18409;437;437;0
/net/per920a/export/das14a/satoh-lab/haolin/nhk/excerpts/2012_11_29_19_00_1.webm;Shintaro ISHIHARA.jpg;13133;13157;18409;438;438;0
/net/per920a/export/das14a/satoh-lab/haolin/nhk/excerpts/2012_11_29_19_00_1.webm;Shintaro ISHIHARA.jpg;13169;13173;18409;439;439;0
/net/per920a/export/das14a/satoh-lab/haolin/nhk/excerpts/2012_11_29_19_00_1.webm;Shintaro ISHIHARA.jpg;13213;13241;18409;440;441;1
/net/per920a/export/das14a/satoh-lab/haolin/nhk/excerpts/2012_11_29_19_00_1.webm;Shintaro ISHIHARA.jpg;13261;13265;18409;442;442;0
/net/per920a/export/das14a/satoh-lab/haolin/nhk/excerpts/2012_11_29_19_00_1.webm;Shintaro ISHIHARA.jpg;13297;13297;18409;443;443;0
/net/per920a/export/das14a/satoh-lab/haolin/nhk/excerpts/2012_11_29_19_00_1.webm;Shintaro ISHIHARA.jpg;13313;13313;18409;444;444;0
/net/per920a/export/das14a/satoh-lab/haolin/nhk/excerpts/2012_11_29_19_00_1.webm;Shintaro ISHIHARA.jpg;13333;13337;18409;444;444;0
/net/per920a/export/das14a/satoh-lab/haolin/nhk/excerpts/2012_11_29_19_00_1.webm;Shintaro ISHIHARA.jpg;13349;13349;18409;445;445;0
/net/per920a/export/das14a/satoh-lab/haolin/nhk/excerpts/2012_11_29_19_00_1.webm;Shintaro ISHIHARA.jpg;13365;13369;18409;445;445;0
/net/per920a/export/das14a/satoh-lab/haolin/nhk/excerpts/2012_11_29_19_00_1.webm;Shintaro ISHIHARA.jpg;13381;13401;18409;446;446;0
/net/per920a/export/das14a/satoh-lab/haolin/nhk/excerpts/2012_11_29_19_00_1.webm;Shintaro ISHIHARA.jpg;13417;13425;18409;447;447;0
/net/per920a/export/das14a/satoh-lab/haolin/nhk/excerpts/2012_11_29_19_00_1.webm;Shintaro ISHIHARA.jpg;13441;13441;18409;448;448;0
/net/per920a/export/das14a/satoh-lab/haolin/nhk/excerpts/2012_11_29_19_00_1.webm;Shintaro ISHIHARA.jpg;13453;13457;18409;448;448;0
/net/per920a/export/das14a/satoh-lab/haolin/nhk/excerpts/2012_11_29_19_00_1.webm;Shintaro ISHIHARA.jpg;13481;13497;18409;449;450;1
/net/per920a/export/das14a/satoh-lab/haolin/nhk/excerpts/2012_11_29_19_00_1.webm;Shintaro ISHIHARA.jpg;13513;13521;18409;450;450;0
/net/per920a/export/das14a/satoh-lab/haolin/nhk/excerpts/2012_11_29_19_00_1.webm;Shintaro ISHIHARA.jpg;13537;13541;18409;451;451;0
/net/per920a/export/das14a/satoh-lab/haolin/nhk/excerpts/2012_11_29_19_00_1.webm;Shintaro ISHIHARA.jpg;13553;13557;18409;452;452;0
/net/per920a/export/das14a/satoh-lab/haolin/nhk/excerpts/2012_11_29_19_00_1.webm;Shintaro ISHIHARA.jpg;13569;13601;18409;452;453;1
/net/per920a/export/das14a/satoh-lab/haolin/nhk/excerpts/2012_11_29_19_00_1.webm;Shintaro ISHIHARA.jpg;13625;13637;18409;454;454;0
/net/per920a/export/das14a/satoh-lab/haolin/nhk/excerpts/2012_11_29_19_00_1.webm;Shintaro ISHIHARA.jpg;13653;13657;18409;455;455;0
/net/per920a/export/das14a/satoh-lab/haolin/nhk/excerpts/2012_11_29_19_00_1.webm;Shintaro ISHIHARA.jpg;13681;13681;18409;456;456;0
/net/per920a/export/das14a/satoh-lab/haolin/nhk/excerpts/2012_11_29_19_00_1.webm;Shintaro ISHIHARA.jpg;13693;13693;18409;456;456;0
/net/per920a/export/das14a/satoh-lab/haolin/nhk/excerpts/2012_11_29_19_00_1.webm;Shintaro ISHIHARA.jpg;13705;13721;18409;457;457;0
/net/per920a/export/das14a/satoh-lab/haolin/nhk/excerpts/2012_11_29_19_00_1.webm;Shintaro ISHIHARA.jpg;13733;13737;18409;458;458;0
/net/per920a/export/das14a/satoh-lab/haolin/nhk/excerpts/2012_11_29_19_00_1.webm;Shintaro ISHIHARA.jpg;13789;13793;18409;459;460;1
/net/per920a/export/das14a/satoh-lab/haolin/nhk/excerpts/2012_11_29_19_00_1.webm;Shintaro ISHIHARA.jpg;13809;13813;18409;460;460;0
/net/per920a/export/das14a/satoh-lab/haolin/nhk/excerpts/2012_11_29_19_00_1.webm;Shintaro ISHIHARA.jpg;13841;13869;18409;461;462;1
/net/per920a/export/das14a/satoh-lab/haolin/nhk/excerpts/2012_11_29_19_00_1.webm;Shintaro ISHIHARA.jpg;13905;13913;18409;463;464;1
/net/per920a/export/das14a/satoh-lab/haolin/nhk/excerpts/2012_11_29_19_00_1.webm;Shintaro ISHIHARA.jpg;13925;14037;18409;464;468;4
/net/per920a/export/das14a/satoh-lab/haolin/nhk/excerpts/2012_11_29_19_00_1.webm;Shintaro ISHIHARA.jpg;14049;14053;18409;468;468;0
/net/per920a/export/das14a/satoh-lab/haolin/nhk/excerpts/2012_11_29_19_00_1.webm;Shintaro ISHIHARA.jpg;14069;14081;18409;469;469;0
/net/per920a/export/das14a/satoh-lab/haolin/nhk/excerpts/2012_11_29_19_00_1.webm;Shintaro ISHIHARA.jpg;14097;14105;18409;470;470;0
/net/per920a/export/das14a/satoh-lab/haolin/nhk/excerpts/2012_11_29_19_00_1.webm;Shintaro ISHIHARA.jpg;14129;14137;18409;471;471;0
/net/per920a/export/das14a/satoh-lab/haolin/nhk/excerpts/2012_11_29_19_00_1.webm;Shintaro ISHIHARA.jpg;14173;14185;18409;472;473;1
/net/per920a/export/das14a/satoh-lab/haolin/nhk/excerpts/2012_11_29_19_00_1.webm;Shintaro ISHIHARA.jpg;14201;14221;18409;473;474;1
/net/per920a/export/das14a/satoh-lab/haolin/nhk/excerpts/2012_11_29_19_00_1.webm;Shintaro ISHIHARA.jpg;14237;14301;18409;474;476;2
/net/per920a/export/das14a/satoh-lab/haolin/nhk/excerpts/2012_11_29_19_00_1.webm;Shintaro ISHIHARA.jpg;14321;14329;18409;477;477;0
/net/per920a/export/das14a/satoh-lab/haolin/nhk/excerpts/2012_11_29_19_00_1.webm;Shintaro ISHIHARA.jpg;14357;14449;18409;478;481;3
/net/per920a/export/das14a/satoh-lab/haolin/nhk/excerpts/2012_11_29_19_00_1.webm;Shintaro ISHIHARA.jpg;14465;14469;18409;482;482;0
/net/per920a/export/das14a/satoh-lab/haolin/nhk/excerpts/2012_11_29_19_00_1.webm;Shintaro ISHIHARA.jpg;14481;14541;18409;482;484;2
/net/per920a/export/das14a/satoh-lab/haolin/nhk/excerpts/2012_11_29_19_00_1.webm;Shintaro ISHIHARA.jpg;14553;14725;18409;485;491;6
/net/per920a/export/das14a/satoh-lab/haolin/nhk/excerpts/2012_11_29_19_00_1.webm;Shintaro ISHIHARA.jpg;14741;14953;18409;491;498;7
/net/per920a/export/das14a/satoh-lab/haolin/nhk/excerpts/2012_11_29_19_00_1.webm;Shintaro ISHIHARA.jpg;14969;15005;18409;499;500;1
/net/per920a/export/das14a/satoh-lab/haolin/nhk/excerpts/2012_11_29_19_00_1.webm;Shintaro ISHIHARA.jpg;15985;16593;18409;533;553;20
/net/per920a/export/das14a/satoh-lab/haolin/nhk/excerpts/2012_11_29_19_00_1.webm;Shintaro ISHIHARA.jpg;16605;16605;18409;553;553;0
/net/per920a/export/das14a/satoh-lab/haolin/nhk/excerpts/2012_11_29_19_00_1.webm;Shintaro ISHIHARA.jpg;16621;16621;18409;554;554;0
/net/per920a/export/das14a/satoh-lab/haolin/nhk/excerpts/2012_11_29_19_00_1.webm;Shintaro ISHIHARA.jpg;16677;16741;18409;556;558;2
/net/per920a/export/das14a/satoh-lab/haolin/nhk/excerpts/2012_11_29_19_00_1.webm;Shintaro ISHIHARA.jpg;17077;17193;18409;569;573;4
/net/per920a/export/das14a/satoh-lab/haolin/nhk/excerpts/2012_11_29_19_00_1.webm;Shintaro ISHIHARA.jpg;17205;17737;18409;573;591;18
/net/per920a/export/das14a/satoh-lab/haolin/nhk/excerpts/2012_11_29_19_00_1.webm;Shintaro ISHIHARA.jpg;17749;18129;18409;591;604;13
/net/per920a/export/das14a/satoh-lab/haolin/nhk/excerpts/2012_11_29_19_00_1.webm;Toru Hashimoto.jpg;8065;8125;18409;268;270;2
/net/per920a/export/das14a/satoh-lab/haolin/nhk/excerpts/2012_11_29_19_00_1.webm;Toru Hashimoto.jpg;8137;8241;18409;271;274;3
/net/per920a/export/das14a/satoh-lab/haolin/nhk/excerpts/2012_11_29_19_00_1.webm;Toru Hashimoto.jpg;8989;9149;18409;299;305;6
/net/per920a/export/das14a/satoh-lab/haolin/nhk/excerpts/2012_11_29_19_00_1.webm;Toru Hashimoto.jpg;9161;9785;18409;305;326;21
/net/per920a/export/das14a/satoh-lab/haolin/nhk/excerpts/2012_11_29_19_00_1.webm;Toru Hashimoto.jpg;11649;11921;18409;388;397;9
/net/per920a/export/das14a/satoh-lab/haolin/nhk/excerpts/2012_11_29_19_00_1.webm;Toru Hashimoto.jpg;12245;12425;18409;408;414;6
/net/per920a/export/das14a/satoh-lab/haolin/nhk/excerpts/2012_11_29_19_00_1.webm;Toru Hashimoto.jpg;12437;12529;18409;414;417;3
/net/per920a/export/das14a/satoh-lab/haolin/nhk/excerpts/2012_11_29_19_00_1.webm;Toru Hashimoto.jpg;12545;12841;18409;418;428;10
/net/per920a/export/das14a/satoh-lab/haolin/nhk/excerpts/2012_11_29_19_00_1.webm;Toru Hashimoto.jpg;12853;12949;18409;428;431;3
/net/per920a/export/das14a/satoh-lab/haolin/nhk/excerpts/2012_11_29_19_00_1.webm;Toru Hashimoto.jpg;12965;12989;18409;432;433;1
/net/per920a/export/das14a/satoh-lab/haolin/nhk/excerpts/2012_11_29_19_00_1.webm;Toru Hashimoto.jpg;13005;13049;18409;433;435;2
/net/per920a/export/das14a/satoh-lab/haolin/nhk/excerpts/2012_11_29_19_00_1.webm;Toru Hashimoto.jpg;13073;13097;18409;436;436;0
/net/per920a/export/das14a/satoh-lab/haolin/nhk/excerpts/2012_11_29_19_00_1.webm;Toru Hashimoto.jpg;13117;13117;18409;437;437;0
/net/per920a/export/das14a/satoh-lab/haolin/nhk/excerpts/2012_11_29_19_00_1.webm;Toru Hashimoto.jpg;13133;13157;18409;438;438;0
/net/per920a/export/das14a/satoh-lab/haolin/nhk/excerpts/2012_11_29_19_00_1.webm;Toru Hashimoto.jpg;13169;13173;18409;439;439;0
/net/per920a/export/das14a/satoh-lab/haolin/nhk/excerpts/2012_11_29_19_00_1.webm;Toru Hashimoto.jpg;13213;13241;18409;440;441;1
/net/per920a/export/das14a/satoh-lab/haolin/nhk/excerpts/2012_11_29_19_00_1.webm;Toru Hashimoto.jpg;13261;13265;18409;442;442;0
/net/per920a/export/das14a/satoh-lab/haolin/nhk/excerpts/2012_11_29_19_00_1.webm;Toru Hashimoto.jpg;13297;13297;18409;443;443;0
/net/per920a/export/das14a/satoh-lab/haolin/nhk/excerpts/2012_11_29_19_00_1.webm;Toru Hashimoto.jpg;13313;13313;18409;444;444;0
/net/per920a/export/das14a/satoh-lab/haolin/nhk/excerpts/2012_11_29_19_00_1.webm;Toru Hashimoto.jpg;13333;13337;18409;444;444;0
/net/per920a/export/das14a/satoh-lab/haolin/nhk/excerpts/2012_11_29_19_00_1.webm;Toru Hashimoto.jpg;13349;13349;18409;445;445;0
/net/per920a/export/das14a/satoh-lab/haolin/nhk/excerpts/2012_11_29_19_00_1.webm;Toru Hashimoto.jpg;13365;13369;18409;445;445;0
/net/per920a/export/das14a/satoh-lab/haolin/nhk/excerpts/2012_11_29_19_00_1.webm;Toru Hashimoto.jpg;13381;13401;18409;446;446;0
/net/per920a/export/das14a/satoh-lab/haolin/nhk/excerpts/2012_11_29_19_00_1.webm;Toru Hashimoto.jpg;13417;13425;18409;447;447;0
/net/per920a/export/das14a/satoh-lab/haolin/nhk/excerpts/2012_11_29_19_00_1.webm;Toru Hashimoto.jpg;13441;13441;18409;448;448;0
/net/per920a/export/das14a/satoh-lab/haolin/nhk/excerpts/2012_11_29_19_00_1.webm;Toru Hashimoto.jpg;13453;13457;18409;448;448;0
/net/per920a/export/das14a/satoh-lab/haolin/nhk/excerpts/2012_11_29_19_00_1.webm;Toru Hashimoto.jpg;13481;13497;18409;449;450;1
/net/per920a/export/das14a/satoh-lab/haolin/nhk/excerpts/2012_11_29_19_00_1.webm;Toru Hashimoto.jpg;13513;13521;18409;450;450;0
/net/per920a/export/das14a/satoh-lab/haolin/nhk/excerpts/2012_11_29_19_00_1.webm;Toru Hashimoto.jpg;13537;13541;18409;451;451;0
/net/per920a/export/das14a/satoh-lab/haolin/nhk/excerpts/2012_11_29_19_00_1.webm;Toru Hashimoto.jpg;13553;13557;18409;452;452;0
/net/per920a/export/das14a/satoh-lab/haolin/nhk/excerpts/2012_11_29_19_00_1.webm;Toru Hashimoto.jpg;13569;13601;18409;452;453;1
/net/per920a/export/das14a/satoh-lab/haolin/nhk/excerpts/2012_11_29_19_00_1.webm;Toru Hashimoto.jpg;13625;13637;18409;454;454;0
/net/per920a/export/das14a/satoh-lab/haolin/nhk/excerpts/2012_11_29_19_00_1.webm;Toru Hashimoto.jpg;13653;13657;18409;455;455;0
/net/per920a/export/das14a/satoh-lab/haolin/nhk/excerpts/2012_11_29_19_00_1.webm;Toru Hashimoto.jpg;13681;13681;18409;456;456;0
/net/per920a/export/das14a/satoh-lab/haolin/nhk/excerpts/2012_11_29_19_00_1.webm;Toru Hashimoto.jpg;13693;13693;18409;456;456;0
/net/per920a/export/das14a/satoh-lab/haolin/nhk/excerpts/2012_11_29_19_00_1.webm;Toru Hashimoto.jpg;13705;13721;18409;457;457;0
/net/per920a/export/das14a/satoh-lab/haolin/nhk/excerpts/2012_11_29_19_00_1.webm;Toru Hashimoto.jpg;13733;13737;18409;458;458;0
/net/per920a/export/das14a/satoh-lab/haolin/nhk/excerpts/2012_11_29_19_00_1.webm;Toru Hashimoto.jpg;13789;13793;18409;459;460;1
/net/per920a/export/das14a/satoh-lab/haolin/nhk/excerpts/2012_11_29_19_00_1.webm;Toru Hashimoto.jpg;13809;13813;18409;460;460;0
/net/per920a/export/das14a/satoh-lab/haolin/nhk/excerpts/2012_11_29_19_00_1.webm;Toru Hashimoto.jpg;13841;13869;18409;461;462;1
/net/per920a/export/das14a/satoh-lab/haolin/nhk/excerpts/2012_11_29_19_00_1.webm;Toru Hashimoto.jpg;13905;13913;18409;463;464;1
/net/per920a/export/das14a/satoh-lab/haolin/nhk/excerpts/2012_11_29_19_00_1.webm;Toru Hashimoto.jpg;13925;14037;18409;464;468;4
/net/per920a/export/das14a/satoh-lab/haolin/nhk/excerpts/2012_11_29_19_00_1.webm;Toru Hashimoto.jpg;14049;14053;18409;468;468;0
/net/per920a/export/das14a/satoh-lab/haolin/nhk/excerpts/2012_11_29_19_00_1.webm;Toru Hashimoto.jpg;14069;14081;18409;469;469;0
/net/per920a/export/das14a/satoh-lab/haolin/nhk/excerpts/2012_11_29_19_00_1.webm;Toru Hashimoto.jpg;14097;14105;18409;470;470;0
/net/per920a/export/das14a/satoh-lab/haolin/nhk/excerpts/2012_11_29_19_00_1.webm;Toru Hashimoto.jpg;14129;14137;18409;471;471;0
/net/per920a/export/das14a/satoh-lab/haolin/nhk/excerpts/2012_11_29_19_00_1.webm;Toru Hashimoto.jpg;14173;14185;18409;472;473;1
/net/per920a/export/das14a/satoh-lab/haolin/nhk/excerpts/2012_11_29_19_00_1.webm;Toru Hashimoto.jpg;14201;14221;18409;473;474;1
/net/per920a/export/das14a/satoh-lab/haolin/nhk/excerpts/2012_11_29_19_00_1.webm;Toru Hashimoto.jpg;14237;14301;18409;474;476;2
/net/per920a/export/das14a/satoh-lab/haolin/nhk/excerpts/2012_11_29_19_00_1.webm;Toru Hashimoto.jpg;14321;14329;18409;477;477;0
/net/per920a/export/das14a/satoh-lab/haolin/nhk/excerpts/2012_11_29_19_00_1.webm;Toru Hashimoto.jpg;14357;14449;18409;478;481;3
/net/per920a/export/das14a/satoh-lab/haolin/nhk/excerpts/2012_11_29_19_00_1.webm;Toru Hashimoto.jpg;14465;14469;18409;482;482;0
/net/per920a/export/das14a/satoh-lab/haolin/nhk/excerpts/2012_11_29_19_00_1.webm;Toru Hashimoto.jpg;14481;14541;18409;482;484;2
/net/per920a/export/das14a/satoh-lab/haolin/nhk/excerpts/2012_11_29_19_00_1.webm;Toru Hashimoto.jpg;14553;14725;18409;485;491;6
/net/per920a/export/das14a/satoh-lab/haolin/nhk/excerpts/2012_11_29_19_00_1.webm;Toru Hashimoto.jpg;14741;14953;18409;491;498;7
/net/per920a/export/das14a/satoh-lab/haolin/nhk/excerpts/2012_11_29_19_00_1.webm;Toru Hashimoto.jpg;14969;15005;18409;499;500;1
/net/per920a/export/das14a/satoh-lab/haolin/nhk/excerpts/2012_11_29_19_00_1.webm;Toru Hashimoto.jpg;15553;15973;18409;518;532;14
/net/per920a/export/das14a/satoh-lab/haolin/nhk/excerpts/2012_11_29_19_00_1.webm;Toru Hashimoto.jpg;15985;16593;18409;533;553;20
/net/per920a/export/das14a/satoh-lab/haolin/nhk/excerpts/2012_11_29_19_00_1.webm;Toru Hashimoto.jpg;16605;16605;18409;553;553;0
/net/per920a/export/das14a/satoh-lab/haolin/nhk/excerpts/2012_11_29_19_00_1.webm;Toru Hashimoto.jpg;16621;16621;18409;554;554;0
/net/per920a/export/das14a/satoh-lab/haolin/nhk/excerpts/2012_11_29_19_00_1.webm;Toru Hashimoto.jpg;16677;16741;18409;556;558;2
/net/per920a/export/das14a/satoh-lab/haolin/nhk/excerpts/2012_11_29_19_00_1.webm;Toru Hashimoto.jpg;17749;18129;18409;591;604;13
/net/per920a/export/das14a/satoh-lab/haolin/nhk/excerpts/2012_12_03_19_00_2.webm;Yoshihiko Noda.jpg;29;273;15681;0;9;9
/net/per920a/export/das14a/satoh-lab/haolin/nhk/excerpts/2012_12_03_19_00_2.webm;Yoshihiko Noda.jpg;285;497;15681;9;16;7
/net/per920a/export/das14a/satoh-lab/haolin/nhk/excerpts/2012_12_03_19_00_2.webm;Yoshihiko Noda.jpg;509;533;15681;16;17;1
/net/per920a/export/das14a/satoh-lab/haolin/nhk/excerpts/2012_12_03_19_00_2.webm;Yoshihiko Noda.jpg;553;557;15681;18;18;0
/net/per920a/export/das14a/satoh-lab/haolin/nhk/excerpts/2012_12_03_19_00_2.webm;Yoshihiko Noda.jpg;581;581;15681;19;19;0
/net/per920a/export/das14a/satoh-lab/haolin/nhk/excerpts/2012_12_03_19_00_2.webm;Yoshihiko Noda.jpg;625;661;15681;20;22;2
/net/per920a/export/das14a/satoh-lab/haolin/nhk/excerpts/2012_12_03_19_00_2.webm;Yoshihiko Noda.jpg;677;693;15681;22;23;1
/net/per920a/export/das14a/satoh-lab/haolin/nhk/excerpts/2012_12_03_19_00_2.webm;Yoshihiko Noda.jpg;725;729;15681;24;24;0
/net/per920a/export/das14a/satoh-lab/haolin/nhk/excerpts/2012_12_03_19_00_2.webm;Yoshihiko Noda.jpg;741;753;15681;24;25;1
/net/per920a/export/das14a/satoh-lab/haolin/nhk/excerpts/2012_12_03_19_00_2.webm;Yoshihiko Noda.jpg;769;773;15681;25;25;0
/net/per920a/export/das14a/satoh-lab/haolin/nhk/excerpts/2012_12_03_19_00_2.webm;Yoshihiko Noda.jpg;785;845;15681;26;28;2
/net/per920a/export/das14a/satoh-lab/haolin/nhk/excerpts/2012_12_03_19_00_2.webm;Yoshihiko Noda.jpg;857;913;15681;28;30;2
/net/per920a/export/das14a/satoh-lab/haolin/nhk/excerpts/2012_12_03_19_00_2.webm;Yoshihiko Noda.jpg;929;1093;15681;30;36;6
/net/per920a/export/das14a/satoh-lab/haolin/nhk/excerpts/2012_12_03_19_00_2.webm;Yoshihiko Noda.jpg;1109;1149;15681;36;38;2
/net/per920a/export/das14a/satoh-lab/haolin/nhk/excerpts/2012_12_03_19_00_2.webm;Yoshihiko Noda.jpg;1177;1181;15681;39;39;0
/net/per920a/export/das14a/satoh-lab/haolin/nhk/excerpts/2012_12_03_19_00_2.webm;Yoshihiko Noda.jpg;1193;1237;15681;39;41;2
/net/per920a/export/das14a/satoh-lab/haolin/nhk/excerpts/2012_12_03_19_00_2.webm;Yoshihiko Noda.jpg;1249;1317;15681;41;43;2
/net/per920a/export/das14a/satoh-lab/haolin/nhk/excerpts/2012_12_03_19_00_2.webm;Yoshihiko Noda.jpg;1333;1405;15681;44;46;2
/net/per920a/export/das14a/satoh-lab/haolin/nhk/excerpts/2012_12_03_19_00_2.webm;Yoshihiko Noda.jpg;1417;1569;15681;47;52;5
/net/per920a/export/das14a/satoh-lab/haolin/nhk/excerpts/2012_12_03_19_00_2.webm;Yoshihiko Noda.jpg;1585;1941;15681;52;64;12
/net/per920a/export/das14a/satoh-lab/haolin/nhk/excerpts/2012_12_03_19_00_2.webm;Yoshihiko Noda.jpg;15125;15433;15681;504;514;10
/net/per920a/export/das14a/satoh-lab/haolin/nhk/excerpts/2012_12_03_19_00_2.webm;Yoshihiko Noda.jpg;15449;15677;15681;515;522;7
/net/per920a/export/das14a/satoh-lab/haolin/nhk/excerpts/2012_12_03_19_00_2.webm;Toru Hashimoto.jpg;5705;6177;15681;190;206;16
/net/per920a/export/das14a/satoh-lab/haolin/nhk/excerpts/2012_12_03_19_00_2.webm;Shinzo ABE.jpg;15125;15433;15681;504;514;10
/net/per920a/export/das14a/satoh-lab/haolin/nhk/excerpts/2012_12_03_19_00_2.webm;Shinzo ABE.jpg;15449;15677;15681;515;522;7
/net/per920a/export/das14a/satoh-lab/haolin/nhk/excerpts/2012_12_04_19_00_3.webm;Yoshihiko Noda.jpg;117;129;6925;3;4;1
/net/per920a/export/das14a/satoh-lab/haolin/nhk/excerpts/2012_12_04_19_00_3.webm;Yoshihiko Noda.jpg;277;281;6925;9;9;0
/net/per920a/export/das14a/satoh-lab/haolin/nhk/excerpts/2012_12_04_19_00_3.webm;Yoshihiko Noda.jpg;425;429;6925;14;14;0
/net/per920a/export/das14a/satoh-lab/haolin/nhk/excerpts/2012_12_04_19_00_3.webm;Yoshihiko Noda.jpg;445;477;6925;14;15;1
/net/per920a/export/das14a/satoh-lab/haolin/nhk/excerpts/2012_12_04_19_00_3.webm;Yoshihiko Noda.jpg;489;509;6925;16;16;0
/net/per920a/export/das14a/satoh-lab/haolin/nhk/excerpts/2012_12_04_19_00_3.webm;Yoshihiko Noda.jpg;545;705;6925;18;23;5
/net/per920a/export/das14a/satoh-lab/haolin/nhk/excerpts/2012_12_04_19_00_3.webm;Yoshihiko Noda.jpg;721;825;6925;24;27;3
/net/per920a/export/das14a/satoh-lab/haolin/nhk/excerpts/2012_12_04_19_00_3.webm;Yoshihiko Noda.jpg;837;1045;6925;27;34;7
/net/per920a/export/das14a/satoh-lab/haolin/nhk/excerpts/2012_12_04_19_00_3.webm;Yoshihiko Noda.jpg;1061;1073;6925;35;35;0
/net/per920a/export/das14a/satoh-lab/haolin/nhk/excerpts/2012_12_04_19_00_3.webm;Yoshihiko Noda.jpg;1101;1105;6925;36;36;0
/net/per920a/export/das14a/satoh-lab/haolin/nhk/excerpts/2012_12_04_19_00_3.webm;Yoshihiko Noda.jpg;1117;1269;6925;37;42;5
/net/per920a/export/das14a/satoh-lab/haolin/nhk/excerpts/2012_12_04_19_00_3.webm;Yoshihiko Noda.jpg;1285;1305;6925;42;43;1
/net/per920a/export/das14a/satoh-lab/haolin/nhk/excerpts/2012_12_04_19_00_3.webm;Yoshihiko Noda.jpg;1321;1369;6925;44;45;1
/net/per920a/export/das14a/satoh-lab/haolin/nhk/excerpts/2012_12_04_19_00_3.webm;Yoshihiko Noda.jpg;1381;1405;6925;46;46;0
/net/per920a/export/das14a/satoh-lab/haolin/nhk/excerpts/2012_12_04_19_00_3.webm;Yoshihiko Noda.jpg;1425;1497;6925;47;49;2
/net/per920a/export/das14a/satoh-lab/haolin/nhk/excerpts/2012_12_04_19_00_3.webm;Yoshihiko Noda.jpg;1529;1537;6925;51;51;0
/net/per920a/export/das14a/satoh-lab/haolin/nhk/excerpts/2012_12_04_19_00_3.webm;Yoshihiko Noda.jpg;1549;1605;6925;51;53;2
/net/per920a/export/das14a/satoh-lab/haolin/nhk/excerpts/2012_12_04_19_00_3.webm;Yoshihiko Noda.jpg;1617;1637;6925;53;54;1
/net/per920a/export/das14a/satoh-lab/haolin/nhk/excerpts/2012_12_04_19_00_3.webm;Yoshihiko Noda.jpg;1653;1661;6925;55;55;0
/net/per920a/export/das14a/satoh-lab/haolin/nhk/excerpts/2012_12_04_19_00_3.webm;Yoshihiko Noda.jpg;1677;1697;6925;55;56;1
/net/per920a/export/das14a/satoh-lab/haolin/nhk/excerpts/2012_12_04_19_00_3.webm;Yoshihiko Noda.jpg;1713;1733;6925;57;57;0
/net/per920a/export/das14a/satoh-lab/haolin/nhk/excerpts/2012_12_04_19_00_3.webm;Yoshihiko Noda.jpg;1745;1797;6925;58;59;1
/net/per920a/export/das14a/satoh-lab/haolin/nhk/excerpts/2012_12_04_19_00_3.webm;Yoshihiko Noda.jpg;1809;1861;6925;60;62;2
/net/per920a/export/das14a/satoh-lab/haolin/nhk/excerpts/2012_12_04_19_00_3.webm;Yoshihiko Noda.jpg;1881;1913;6925;62;63;1
/net/per920a/export/das14a/satoh-lab/haolin/nhk/excerpts/2012_12_04_19_00_3.webm;Yoshihiko Noda.jpg;1925;1937;6925;64;64;0
/net/per920a/export/das14a/satoh-lab/haolin/nhk/excerpts/2012_12_04_19_00_3.webm;Yoshihiko Noda.jpg;1953;2037;6925;65;67;2
/net/per920a/export/das14a/satoh-lab/haolin/nhk/excerpts/2012_12_04_19_00_3.webm;Yoshihiko Noda.jpg;2049;2209;6925;68;73;5
/net/per920a/export/das14a/satoh-lab/haolin/nhk/excerpts/2012_12_04_19_00_3.webm;Yoshihiko Noda.jpg;2245;2245;6925;74;74;0
/net/per920a/export/das14a/satoh-lab/haolin/nhk/excerpts/2012_12_04_19_00_3.webm;Shinzo ABE.jpg;2325;2337;6925;77;77;0
/net/per920a/export/das14a/satoh-lab/haolin/nhk/excerpts/2012_12_04_19_00_3.webm;Shinzo ABE.jpg;2357;2361;6925;78;78;0
/net/per920a/export/das14a/satoh-lab/haolin/nhk/excerpts/2012_12_04_19_00_3.webm;Shinzo ABE.jpg;2433;2437;6925;81;81;0
/net/per920a/export/das14a/satoh-lab/haolin/nhk/excerpts/2012_12_04_19_00_3.webm;Shinzo ABE.jpg;2457;2461;6925;81;82;1
/net/per920a/export/das14a/satoh-lab/haolin/nhk/excerpts/2012_12_04_19_00_3.webm;Shinzo ABE.jpg;2473;2497;6925;82;83;1
/net/per920a/export/das14a/satoh-lab/haolin/nhk/excerpts/2012_12_04_19_00_3.webm;Shinzo ABE.jpg;2517;2529;6925;83;84;1
/net/per920a/export/das14a/satoh-lab/haolin/nhk/excerpts/2012_12_04_19_00_3.webm;Shinzo ABE.jpg;2561;2717;6925;85;90;5
/net/per920a/export/das14a/satoh-lab/haolin/nhk/excerpts/2012_12_04_19_00_3.webm;Shinzo ABE.jpg;2729;2753;6925;91;91;0
/net/per920a/export/das14a/satoh-lab/haolin/nhk/excerpts/2012_12_04_19_00_3.webm;Shinzo ABE.jpg;2765;2805;6925;92;93;1
/net/per920a/export/das14a/satoh-lab/haolin/nhk/excerpts/2012_12_04_19_00_3.webm;Shinzo ABE.jpg;2817;2825;6925;93;94;1
/net/per920a/export/das14a/satoh-lab/haolin/nhk/excerpts/2012_12_04_19_00_3.webm;Shinzo ABE.jpg;2837;2893;6925;94;96;2
/net/per920a/export/das14a/satoh-lab/haolin/nhk/excerpts/2012_12_04_19_00_3.webm;Shinzo ABE.jpg;2909;2917;6925;97;97;0
/net/per920a/export/das14a/satoh-lab/haolin/nhk/excerpts/2012_12_04_19_00_3.webm;Shinzo ABE.jpg;2933;2989;6925;97;99;2
/net/per920a/export/das14a/satoh-lab/haolin/nhk/excerpts/2012_12_04_19_00_3.webm;Shinzo ABE.jpg;3001;3117;6925;100;103;3
/net/per920a/export/das14a/satoh-lab/haolin/nhk/excerpts/2012_12_04_19_00_3.webm;Shinzo ABE.jpg;3129;3177;6925;104;105;1
/net/per920a/export/das14a/satoh-lab/haolin/nhk/excerpts/2012_12_04_19_00_3.webm;Shinzo ABE.jpg;3193;3249;6925;106;108;2
/net/per920a/export/das14a/satoh-lab/haolin/nhk/excerpts/2012_12_04_19_00_3.webm;Shinzo ABE.jpg;3265;3341;6925;108;111;3
/net/per920a/export/das14a/satoh-lab/haolin/nhk/excerpts/2012_12_04_19_00_3.webm;Shinzo ABE.jpg;3357;3469;6925;111;115;4
/net/per920a/export/das14a/satoh-lab/haolin/nhk/excerpts/2012_12_04_19_00_3.webm;Shinzo ABE.jpg;3481;3501;6925;116;116;0
/net/per920a/export/das14a/satoh-lab/haolin/nhk/excerpts/2012_12_04_19_00_3.webm;Shinzo ABE.jpg;3513;3521;6925;117;117;0
/net/per920a/export/das14a/satoh-lab/haolin/nhk/excerpts/2012_12_04_19_00_3.webm;Shinzo ABE.jpg;3545;3593;6925;118;119;1
/net/per920a/export/das14a/satoh-lab/haolin/nhk/excerpts/2012_12_04_19_00_3.webm;Shinzo ABE.jpg;3617;3629;6925;120;121;1
/net/per920a/export/das14a/satoh-lab/haolin/nhk/excerpts/2012_12_04_19_00_3.webm;Shinzo ABE.jpg;3641;3689;6925;121;123;2
/net/per920a/export/das14a/satoh-lab/haolin/nhk/excerpts/2012_12_04_19_00_3.webm;Shinzo ABE.jpg;3717;4145;6925;123;138;15
/net/per920a/export/das14a/satoh-lab/haolin/nhk/excerpts/2012_12_04_19_00_3.webm;Shinzo ABE.jpg;4161;4241;6925;138;141;3
/net/per920a/export/das14a/satoh-lab/haolin/nhk/excerpts/2012_12_04_19_00_3.webm;Shinzo ABE.jpg;4257;4285;6925;142;142;0
/net/per920a/export/das14a/satoh-lab/haolin/nhk/excerpts/2012_12_04_19_00_3.webm;Natsuo YAMAGUCHI.jpg;5857;5865;6925;195;195;0
/net/per920a/export/das14a/satoh-lab/haolin/nhk/excerpts/2012_12_04_19_00_3.webm;Natsuo YAMAGUCHI.jpg;5973;5977;6925;199;199;0
/net/per920a/export/das14a/satoh-lab/haolin/nhk/excerpts/2012_12_04_19_00_3.webm;Natsuo YAMAGUCHI.jpg;6077;6077;6925;202;202;0
/net/per920a/export/das14a/satoh-lab/haolin/nhk/excerpts/2012_12_04_19_00_3.webm;Natsuo YAMAGUCHI.jpg;6121;6121;6925;204;204;0
/net/per920a/export/das14a/satoh-lab/haolin/nhk/excerpts/2012_12_04_19_00_3.webm;Natsuo YAMAGUCHI.jpg;6213;6289;6925;207;209;2
/net/per920a/export/das14a/satoh-lab/haolin/nhk/excerpts/2012_12_04_19_00_3.webm;Natsuo YAMAGUCHI.jpg;6305;6525;6925;210;217;7
/net/per920a/export/das14a/satoh-lab/haolin/nhk/excerpts/2012_12_04_19_00_3.webm;Natsuo YAMAGUCHI.jpg;6541;6701;6925;218;223;5
/net/per920a/export/das14a/satoh-lab/haolin/nhk/excerpts/2012_12_04_19_00_3.webm;Natsuo YAMAGUCHI.jpg;6717;6921;6925;224;230;6
/net/per920a/export/das14a/satoh-lab/haolin/nhk/excerpts/2012_12_20_19_00_3.webm;Mizuho FUKUSHIMA.jpg;1961;2705;3037;65;89;24
/net/per920a/export/das14a/satoh-lab/haolin/nhk/excerpts/2012_12_20_19_00_3.webm;Mizuho FUKUSHIMA.jpg;2881;3033;3037;95;100;5
